Url,Tkl_Tackles,TklW_Tackles,Def 3rd_Tackles,Mid 3rd_Tackles,Att 3rd_Tackles,Tkl_Challenges,Att_Challenges,Lost_Challenges,Blocks_Blocks,Sh_Blocks,Pass_Blocks,Int,Tkl+Int,Clr,Err
https://fbref.com/en/players/0a63446f/Mickael-Alphonse,35,23,20,11,4,20,33,13,17,5,12,35,70,44,1
https://fbref.com/en/players/a94d93be/Cedric-Avinel,13,7,8,5,0,8,12,4,20,13,7,15,28,91,1
https://fbref.com/en/players/e3844ecb/Mickael-Barreto,32,20,12,17,3,8,45,37,17,0,17,18,50,11,0
https://fbref.com/en/players/20e0dd86/Cyrille-Bayala,53,37,16,20,17,23,47,24,20,3,17,25,78,21,0
https://fbref.com/en/players/1a248246/Youcef-Belaili,18,10,3,9,6,8,20,12,10,1,9,5,23,4,0
https://fbref.com/en/players/65fcf987/Kouame-Botue,4,2,2,1,1,0,2,2,1,0,1,0,4,1,0
https://fbref.com/en/players/5d9577aa/Florian-Chabrolle,6,4,1,5,0,2,4,2,3,0,3,7,13,2,0
https://fbref.com/en/players/1237c049/Ivane-Chegra,8,3,6,1,1,4,11,7,0,0,0,1,9,0,0
https://fbref.com/en/players/7495aba7/Yanis-Cimignani,11,5,3,7,1,4,5,1,5,1,4,2,13,2,0
https://fbref.com/en/players/ef8ae23b/Mathieu-Coutadeur,23,13,13,10,0,8,28,20,19,3,16,19,42,21,0
https://fbref.com/en/players/b3244eeb/Ismael-Diallo,46,33,35,9,2,35,63,28,26,12,14,30,76,46,1
https://fbref.com/en/players/627b570a/Moussa-Djitte,1,0,0,0,1,1,2,1,0,0,0,0,1,1,0
https://fbref.com/en/players/a9d4c241/Oumar-Gonzalez,51,28,34,13,4,23,37,14,32,11,21,52,103,82,0
https://fbref.com/en/players/c7eebddf/Ben-Hamed-Toure,4,4,2,2,0,1,5,4,2,0,2,1,5,4,0
https://fbref.com/en/players/0b4d8274/Romain-Hamouma,8,3,3,3,2,3,6,3,8,0,8,2,10,2,0
https://fbref.com/en/players/fb0ee44e/Mounaim-El-Idrissy,32,19,5,20,7,10,36,26,22,0,22,13,45,20,0
https://fbref.com/en/players/3670aa71/Anthony-Khelifa,0,0,0,0,0,0,0,0,0,0,0,0,0,0,0
https://fbref.com/en/players/e6eadfb8/Youssouf-Kone,28,19,24,4,0,18,25,7,9,2,7,12,40,32,1
https://fbref.com/en/players/eb0db257/Qazim-Laci,6,3,2,3,1,4,9,5,5,0,5,2,8,3,0
https://fbref.com/en/players/5bf26efc/Paolo-Lebas,0,0,0,0,0,0,0,0,0,0,0,0,0,0,0
https://fbref.com/en/players/1e7aea56/Benjamin-Leroy,0,0,0,0,0,0,2,2,0,0,0,1,1,16,2
https://fbref.com/en/players/17e25e72/Ruan-Levine,2,2,1,1,0,0,0,0,1,0,1,2,4,0,0
https://fbref.com/en/players/c801616a/Thomas-Mangani,32,17,14,15,3,18,47,29,22,3,19,24,56,22,1
https://fbref.com/en/players/740f00ac/Vincent-Marchetti,55,26,29,19,7,25,68,43,23,3,20,19,74,31,0
https://fbref.com/en/players/b20cc590/Fernand-Mayembo,8,5,6,2,0,4,9,5,2,0,2,11,19,36,0
https://fbref.com/en/players/71d10572/Bevic-Moussiti-Oko,3,1,1,1,1,1,2,1,5,3,2,2,5,8,0
https://fbref.com/en/players/374fbf7d/Riad-Nouri,21,12,7,10,4,12,29,17,8,1,7,15,36,11,0
https://fbref.com/en/players/7be7c08b/Mehdi-Puch-Herrantz,2,2,0,1,1,1,2,1,1,0,1,3,5,0,0
https://fbref.com/en/players/1b729a98/Ghjuvanni-Quilichini,0,0,0,0,0,0,0,0,0,0,0,0,0,1,0
https://fbref.com/en/players/f19f32b1/Francois-Joseph-Sollacaro,0,0,0,0,0,0,0,0,0,0,0,0,0,2,2
https://fbref.com/en/players/86a49468/Moussa-Soumano,2,2,0,1,1,0,6,6,2,0,2,0,2,0,0
https://fbref.com/en/players/a45a5d95/Kevin-Spadanuda,29,18,15,9,5,12,33,21,18,0,18,11,40,5,0
https://fbref.com/en/players/4ca4f263/Tony-Strata,4,3,4,0,0,4,5,1,2,0,2,1,5,7,0
https://fbref.com/en/players/4e47507a/Yoann-Touzghar,3,2,0,2,1,0,1,1,0,0,0,0,3,1,0
https://fbref.com/en/players/b2791a55/Clement-Vidal,25,15,14,11,0,18,38,20,27,16,11,27,52,73,1
https://fbref.com/en/players/1a85bcdb/Mohamed-Youssouf,72,44,41,24,7,38,61,23,32,8,24,65,137,70,0
https://fbref.com/en/players/06efa9dc/Sergio-Akieme,27,16,19,6,2,12,22,10,22,6,16,14,41,41,0
https://fbref.com/en/players/075fe5a3/Srdjan-Babic,28,18,20,8,0,15,32,17,34,22,12,29,57,124,1
https://fbref.com/en/players/35f6db55/Leo-Baptistao,32,20,13,16,3,13,33,20,17,2,15,19,51,12,0
https://fbref.com/en/players/47c609d5/El-Bilal-Toure,4,3,2,1,1,0,3,3,6,1,5,1,5,23,0
https://fbref.com/en/players/2475cf9b/Juan-Brandariz,29,16,18,9,2,14,23,9,20,7,13,15,44,53,0
https://fbref.com/en/players/5b93209a/Jose-Carlos-Lazo,0,0,0,0,0,0,0,0,0,0,0,0,0,0,0
https://fbref.com/en/players/ae852b7d/Alex-Centelles,22,14,16,3,3,16,22,6,13,2,11,11,33,40,0
https://fbref.com/en/players/76c2a023/Samu-Costa,61,31,35,20,6,29,61,32,29,7,22,37,98,64,4
https://fbref.com/en/players/f9a225f5/Curro,2,0,1,1,0,1,2,1,0,0,0,0,2,0,0
https://fbref.com/en/players/3e93f8cf/Inigo-Eguaras,11,8,4,6,1,5,18,13,9,3,6,6,17,15,0
https://fbref.com/en/players/fd47b4f2/Rodrigo-Ely,30,21,26,4,0,18,25,7,46,33,13,31,61,203,1
https://fbref.com/en/players/db8f0eba/Adri-Embarba,50,27,21,26,3,22,46,24,23,0,23,9,59,9,0
https://fbref.com/en/players/dabb2827/Fernando,0,0,0,0,0,0,2,2,2,0,2,1,1,20,3
https://fbref.com/en/players/eeba07f8/Luis-Javier-Suarez,17,11,5,6,6,6,26,20,13,3,10,3,20,10,0
https://fbref.com/en/players/55634fb8/Kaiky,5,5,5,0,0,3,7,4,18,10,8,11,16,28,0
https://fbref.com/en/players/60abea75/Cesar-de-la-Hoz,37,20,17,18,2,19,37,18,26,6,20,13,50,37,0
https://fbref.com/en/players/86ff856b/Lazaro,4,3,3,0,1,3,15,12,16,1,15,2,6,1,0
https://fbref.com/en/players/d9235a45/Diego-Marino,0,0,0,0,0,0,0,0,0,0,0,0,0,0,0
https://fbref.com/en/players/3902e91b/Gonzalo-Melero,32,16,9,18,5,11,39,28,23,2,21,7,39,19,1
https://fbref.com/en/players/1545cf15/Houboulang-Mendes,19,11,16,3,0,11,27,16,12,2,10,7,26,23,1
https://fbref.com/en/players/1fda2b14/Marko-Milovanovic,0,0,0,0,0,0,0,0,0,0,0,0,0,0,0
https://fbref.com/en/players/97852360/Fernando-Pacheco,0,0,0,0,0,0,0,0,0,0,0,0,0,1,0
https://fbref.com/en/players/8e010ff4/Francisco-Portillo,13,6,4,5,4,3,16,13,7,1,6,7,20,8,0
https://fbref.com/en/players/3c16d927/Alejandro-Pozo-Pozo,37,19,17,17,3,27,53,26,30,5,25,26,63,45,1
https://fbref.com/en/players/39352da2/Arnau-Puigmal,22,14,10,7,5,12,17,5,7,0,7,11,33,6,0
https://fbref.com/en/players/cc9256ef/Largie-Ramazani,15,9,6,3,6,8,27,19,11,0,11,15,30,10,0
https://fbref.com/en/players/a8981944/Lucas-Robertone,50,28,20,21,9,28,64,36,45,7,38,46,96,46,1
https://fbref.com/en/players/686cbe7d/Umar-Sadiq,0,0,0,0,0,0,1,1,2,0,2,0,0,3,0
https://fbref.com/en/players/e4738e91/Dyego-Sousa,10,6,5,4,1,4,5,1,4,2,2,1,11,14,0
https://fbref.com/en/players/7978cbf0/Himad-Abdelli,64,38,22,32,10,31,67,36,30,1,29,28,92,15,0
https://fbref.com/en/players/9260926b/Ibrahim-Amadou,10,7,6,3,1,7,11,4,7,3,4,10,20,20,0
https://fbref.com/en/players/7fecbcdb/Abdoulaye-Bamba,22,12,15,5,2,16,19,3,7,3,4,18,40,38,0
https://fbref.com/en/players/3189f61a/Nabil-Bentaleb,74,40,31,35,8,36,61,25,33,11,22,44,118,29,3
https://fbref.com/en/players/28dabd43/Paul-Bernardoni,2,0,2,0,0,2,3,1,1,0,1,1,3,12,1
https://fbref.com/en/players/3cdfc63e/Miha-Blazic,8,6,8,0,0,7,15,8,25,19,6,22,30,80,1
https://fbref.com/en/players/7d937aa1/Antonin-Bobichon,0,0,0,0,0,0,0,0,1,0,1,0,0,0,0
https://fbref.com/en/players/b0c71810/Sofiane-Boufal,14,9,7,4,3,3,14,11,6,0,6,5,19,1,0
https://fbref.com/en/players/7d3dfdfd/Ousmane-Camara,10,6,5,5,0,5,12,7,4,2,2,11,21,15,0
https://fbref.com/en/players/79b2399c/Pierrick-Capelle,36,21,17,15,4,22,55,33,24,3,21,15,51,24,0
https://fbref.com/en/players/9d498560/Ilyes-Cheti,6,4,4,0,2,5,8,3,5,1,4,4,10,7,0
https://fbref.com/en/players/4be0b467/Lois-Diony,1,0,0,1,0,1,3,2,2,0,2,0,1,1,0
https://fbref.com/en/players/9daeac61/Souleyman-Doumbia,45,31,31,13,1,17,31,14,20,3,17,27,72,27,1
https://fbref.com/en/players/9d420dad/Yahia-Fofana,0,0,0,0,0,0,0,0,0,0,0,1,1,4,1
https://fbref.com/en/players/c5adc293/Faouzi-Ghoulam,3,3,1,1,1,3,5,2,4,2,2,4,7,12,1
https://fbref.com/en/players/00891164/Cedric-Hountondji,50,36,31,17,2,19,29,10,44,22,22,59,109,132,1
https://fbref.com/en/players/d14229f3/Adrien-Hunou,39,20,17,16,6,16,45,29,35,0,35,7,46,7,0
https://fbref.com/en/players/96f4ebc0/Marin-Jakolis,1,1,0,0,1,0,0,0,0,0,0,0,1,0,0
https://fbref.com/en/players/32e2163d/Justin-Noel-Kalumba,9,5,5,2,2,5,16,11,4,1,3,4,13,5,0
https://fbref.com/en/players/70d4c949/Jean-Matteo-Bahoya,7,3,1,3,3,4,7,3,4,0,4,0,7,0,0
https://fbref.com/en/players/890bc029/Jason-Mbock,0,0,0,0,0,0,0,0,0,0,0,0,0,0,0
https://fbref.com/en/players/d21e361a/Farid-El-Melali,21,12,7,12,2,11,22,11,16,0,16,8,29,7,0
https://fbref.com/en/players/e472a6f6/Batista-Mendy,70,30,34,28,8,37,53,16,38,6,32,21,91,29,2
https://fbref.com/en/players/46faabfa/Ibrahima-Niane,6,2,1,4,1,1,6,5,8,2,6,1,7,9,0
https://fbref.com/en/players/6b4436ba/Zinedine-Ould-Khaled,1,1,0,1,0,0,1,1,0,0,0,2,3,0,0
https://fbref.com/en/players/83299cc0/Azzedine-Ounahi,19,8,5,13,1,10,20,10,8,0,8,15,34,4,1
https://fbref.com/en/players/79a793b7/Lilian-Raolisoa,11,9,6,3,2,7,10,3,3,1,2,3,14,5,0
https://fbref.com/en/players/8299e363/Halid-Sabanovic,8,6,7,1,0,6,8,2,8,2,6,8,16,12,0
https://fbref.com/en/players/bc7cc472/Amine-Salama,11,9,3,7,1,2,12,10,8,2,6,10,21,2,0
https://fbref.com/en/players/fdbde523/Abdallah-Sima,22,13,4,15,3,7,19,12,8,0,8,4,26,19,0
https://fbref.com/en/players/95192fe4/Waniss-Taibi,9,5,4,4,1,2,4,2,1,0,1,2,11,2,0
https://fbref.com/en/players/f4bc42b1/Sada-Thioub,19,10,9,8,2,8,17,9,13,0,13,7,26,5,1
https://fbref.com/en/players/531a4aa8/Yan-Valery,54,39,28,20,6,20,37,17,35,15,20,34,88,82,0
https://fbref.com/en/players/67ac5bb8/Gabriel-Dos-Santos,48,30,29,15,4,18,27,9,49,26,23,32,80,125,2
https://fbref.com/en/players/47a34c4f/Mohamed-Elneny,1,1,1,0,0,1,1,0,0,0,0,0,1,0,0
https://fbref.com/en/players/d79a8c87/Rob-Holding,8,5,4,4,0,3,6,3,6,5,1,3,11,27,1
https://fbref.com/en/players/b66315ae/Gabriel-Jesus,33,25,16,8,9,15,31,16,27,3,24,11,44,15,1
https://fbref.com/en/players/45db685d/Jorginho,18,13,6,10,2,5,24,19,7,2,5,9,27,8,0
https://fbref.com/en/players/dc3e663e/Jakub-Kiwior,7,5,6,1,0,5,8,3,5,3,2,6,13,10,0
https://fbref.com/en/players/59878425/Marquinhos,0,0,0,0,0,0,0,0,0,0,0,0,0,0,0
https://fbref.com/en/players/48a5a5d6/Martinelli,31,18,13,12,6,9,22,13,24,1,23,9,40,14,0
https://fbref.com/en/players/c5bdb6e3/Reiss-Nelson,4,1,2,1,1,2,4,2,3,0,3,0,4,4,0
https://fbref.com/en/players/a53649b7/Eddie-Nketiah,13,9,6,2,5,2,8,6,7,1,6,1,14,7,0
https://fbref.com/en/players/7f94982c/Ethan-Nwaneri,0,0,0,0,0,0,0,0,1,0,1,0,0,0,0
https://fbref.com/en/players/529f49ab/Thomas-Partey,70,40,20,35,15,25,52,27,26,5,21,28,98,41,1
https://fbref.com/en/players/466fb2c5/Aaron-Ramsdale,1,1,1,0,0,1,1,0,0,0,0,0,1,20,6
https://fbref.com/en/players/bc7dc64d/Bukayo-Saka,63,34,22,15,26,20,44,24,38,0,38,14,77,19,0
https://fbref.com/en/players/972aeb2a/William-Saliba,34,20,23,9,2,15,18,3,13,10,3,19,53,85,4
https://fbref.com/en/players/1b4f1169/Albert-Sambi-Lokonga,1,1,0,0,1,0,2,2,1,0,1,5,6,2,0
https://fbref.com/en/players/17695062/Emile-Smith-Rowe,1,1,1,0,0,1,3,2,1,0,1,0,1,2,0
https://fbref.com/en/players/839c14e1/Cedric-Soares,0,0,0,0,0,0,1,1,1,0,1,0,0,1,0
https://fbref.com/en/players/fce2302c/Kieran-Tierney,20,11,9,9,2,12,16,4,8,2,6,11,31,25,0
https://fbref.com/en/players/b3af9be1/Takehiro-Tomiyasu,27,18,12,10,5,13,18,5,7,0,7,14,41,15,1
https://fbref.com/en/players/38ceb24a/Leandro-Trossard,12,7,4,2,6,6,18,12,18,0,18,6,18,3,1
https://fbref.com/en/players/6412cc03/Fabio-Vieira,6,4,3,0,3,3,5,2,5,0,5,4,10,2,0
https://fbref.com/en/players/35e413f1/Ben-White,60,31,23,30,7,42,70,28,47,11,36,22,82,79,1
https://fbref.com/en/players/e61b8aee/Granit-Xhaka,34,27,11,18,5,16,41,25,28,10,18,15,49,45,1
https://fbref.com/en/players/51cf8561/Oleksandr-Zinchenko,40,18,14,17,9,21,39,18,20,2,18,22,62,38,2
https://fbref.com/en/players/79300479/Martin-Odegaard,36,23,12,14,10,14,47,33,20,5,15,6,42,12,1
https://fbref.com/en/players/05e8ca6d/Cameron-Archer,0,0,0,0,0,0,0,0,0,0,0,0,0,0,0
https://fbref.com/en/players/9fec8860/Ludwig-Augustinsson,1,1,1,0,0,0,0,0,0,0,0,0,1,1,0
https://fbref.com/en/players/3a233281/Leon-Bailey,14,6,6,7,1,5,20,15,13,0,13,6,20,12,0
https://fbref.com/en/players/4115ce4e/Jan-Bednarek,3,3,0,3,0,1,1,0,3,1,2,2,5,5,0
https://fbref.com/en/players/66b76d44/Emi-Buendia,52,23,20,20,12,21,74,53,20,2,18,20,72,17,0
https://fbref.com/en/players/b4a014b1/Diego-Carlos,1,0,0,1,0,0,1,1,2,2,0,1,2,2,0
https://fbref.com/en/players/2389cdc2/Matty-Cash,55,32,36,15,4,26,37,11,20,5,15,26,81,43,0
https://fbref.com/en/players/dc6f5bdd/Calum-Chambers,9,6,7,2,0,6,8,2,5,4,1,7,16,10,1
https://fbref.com/en/players/0ef89a37/Philippe-Coutinho,19,14,8,8,3,9,15,6,11,1,10,4,23,2,0
https://fbref.com/en/players/5a7301ae/Leander-Dendoncker,19,9,11,6,2,11,21,10,19,4,15,10,29,12,0
https://fbref.com/en/players/1b84dbe1/Lucas-Digne,30,12,20,9,1,20,33,13,18,5,13,18,48,45,0
https://fbref.com/en/players/414184f7/Jhon-Duran,2,2,0,1,1,1,4,3,0,0,0,2,4,2,0
https://fbref.com/en/players/07802f7f/Danny-Ings,10,5,1,6,3,1,6,5,12,1,11,1,11,11,0
https://fbref.com/en/players/cc77354e/Boubacar-Kamara,58,25,25,23,10,27,56,29,38,12,26,19,77,24,2
https://fbref.com/en/players/0313a347/Ezri-Konsa,42,20,25,15,2,18,26,8,41,23,18,26,68,120,3
https://fbref.com/en/players/6f7d826d/Douglas-Luiz,73,42,31,32,10,30,63,33,36,7,29,40,113,27,2
https://fbref.com/en/players/7956236f/Emiliano-Martinez,0,0,0,0,0,0,2,2,0,0,0,1,1,23,1
https://fbref.com/en/players/90f91999/John-McGinn,66,36,27,29,10,34,71,37,43,4,39,24,90,19,0
https://fbref.com/en/players/8397a50c/Tyrone-Mings,15,7,10,5,0,9,20,11,40,21,19,54,69,163,2
https://fbref.com/en/players/16e9d0ea/Alex-Moreno,23,14,15,5,3,13,36,23,18,3,15,7,30,37,2
https://fbref.com/en/players/e7ee38c3/Robin-Olsen,0,0,0,0,0,0,2,2,0,0,0,0,0,1,0
https://fbref.com/en/players/1544f145/Jacob-Ramsey,69,39,23,35,11,32,69,37,48,8,40,23,92,34,0
https://fbref.com/en/players/6e7f1353/Morgan-Sanson,2,1,1,1,0,1,1,0,0,0,0,0,2,0,0
https://fbref.com/en/players/c47541e0/Bertrand-Traore,1,1,1,0,0,1,4,3,5,0,5,2,3,0,0
https://fbref.com/en/players/aed3a70f/Ollie-Watkins,19,13,3,13,3,10,27,17,21,4,17,10,29,39,0
https://fbref.com/en/players/be927d03/Ashley-Young,50,27,34,15,1,37,49,12,25,11,14,21,71,65,0
https://fbref.com/en/players/fe012aca/Jeremie-Boga,9,5,3,2,4,2,5,3,6,0,6,1,10,1,0
https://fbref.com/en/players/7f9d956a/Tommaso-De-Nipoti,1,0,0,1,0,0,0,0,0,0,0,0,1,0,0
https://fbref.com/en/players/e3cceee6/Merih-Demiral,41,29,30,11,0,26,36,10,24,7,17,24,65,57,1
https://fbref.com/en/players/6eee05f1/Berat-Djimsiti,34,19,21,13,0,17,25,8,17,7,10,36,70,74,1
https://fbref.com/en/players/a9202def/Ederson,67,34,18,42,7,29,66,37,56,7,49,36,103,31,0
https://fbref.com/en/players/3b333ac3/Hans-Hateboer,21,13,11,8,2,11,27,16,23,4,19,12,33,25,0
https://fbref.com/en/players/491a433d/Rasmus-Hojlund,4,3,0,2,2,1,6,5,9,1,8,1,5,5,0
https://fbref.com/en/players/a26fb8aa/Teun-Koopmeiners,46,26,15,24,7,28,55,27,41,5,36,19,65,36,2
https://fbref.com/en/players/7c104bb7/Ademola-Lookman,13,5,2,6,5,3,15,12,18,0,18,4,17,1,0
https://fbref.com/en/players/921f6058/Jose-Luis-Palomino,23,14,16,7,0,11,19,8,11,4,7,28,51,20,0
https://fbref.com/en/players/48d5bd33/Ruslan-Malinovskyi,14,8,5,6,3,6,17,11,8,1,7,5,19,2,0
https://fbref.com/en/players/eb2fe5b6/Luis-Muriel,9,6,2,3,4,5,16,11,9,0,9,2,11,2,0
https://fbref.com/en/players/a111cf41/Juan-Musso,1,1,1,0,0,1,1,0,0,0,0,0,1,11,1
https://fbref.com/en/players/c459a650/Joakim-Maehle,32,18,12,7,13,22,39,17,29,6,23,24,56,26,0
https://fbref.com/en/players/8ec109e6/Caleb-Okoli,21,17,14,6,1,10,25,15,10,5,5,30,51,44,3
https://fbref.com/en/players/e599253a/Mario-Pasalic,22,10,6,14,2,6,23,17,22,4,18,21,43,13,0
https://fbref.com/en/players/2a1beb34/Marten-de-Roon,77,39,37,35,5,37,81,44,37,4,33,36,113,58,0
https://fbref.com/en/players/7b5f516f/Francesco-Rossi,0,0,0,0,0,0,0,0,0,0,0,0,0,0,0
https://fbref.com/en/players/ae9898c5/Matteo-Ruggeri,17,12,5,9,3,8,16,8,14,3,11,12,29,16,0
https://fbref.com/en/players/1e9aa637/Giorgio-Scalvini,54,29,30,18,6,29,55,26,36,13,23,56,110,57,2
https://fbref.com/en/players/28f66c2e/Brandon-Soppy,8,5,4,4,0,3,9,6,10,0,10,3,11,7,0
https://fbref.com/en/players/ac4003af/Marco-Sportiello,1,0,1,0,0,1,3,2,0,0,0,0,1,2,0
https://fbref.com/en/players/c56dc39e/Rafael-Toloi,69,44,37,32,0,35,64,29,42,18,24,57,126,88,1
https://fbref.com/en/players/f052fb01/Lukas-Vorlicky,0,0,0,0,0,0,0,0,0,0,0,1,1,0,0
https://fbref.com/en/players/d3de9af0/Duvan-Zapata,8,4,1,3,4,3,5,2,6,2,4,4,12,17,1
https://fbref.com/en/players/7fe90ccd/Davide-Zappacosta,34,18,17,12,5,15,22,7,23,2,21,9,43,16,0
https://fbref.com/en/players/82598b71/Nadir-Zortea,10,5,3,7,0,3,4,1,4,0,4,0,10,4,0
https://fbref.com/en/players/a2c1a8d3/Julen-Agirrezabala,0,0,0,0,0,0,0,0,0,0,0,0,0,2,0
https://fbref.com/en/players/3ecc11d8/Yeray-Alvarez,34,23,26,7,1,24,31,7,23,13,10,48,82,101,0
https://fbref.com/en/players/1fe67e86/Mikel-Balenziaga,4,4,1,2,1,4,4,0,0,0,0,1,5,2,0
https://fbref.com/en/players/b6e50615/Yuri-Berchiche,56,32,28,20,8,35,59,24,37,12,25,40,96,59,1
https://fbref.com/en/players/dc1c2fce/Alex-Berenguer,58,37,17,25,16,23,60,37,37,4,33,10,68,6,0
https://fbref.com/en/players/37f1cf47/Ander-Capa,1,1,1,0,0,1,5,4,5,0,5,0,1,2,0
https://fbref.com/en/players/a461f098/Malcom-Abdulai-Ares-Djalo,4,2,2,1,1,4,4,0,1,0,1,2,6,1,0
https://fbref.com/en/players/240d3a0b/Dani-Garcia,46,27,17,25,4,29,47,18,21,6,15,19,65,21,1
https://fbref.com/en/players/b418dbd4/Raul-Garcia,12,8,3,4,5,5,15,10,13,1,12,6,18,9,0
https://fbref.com/en/players/6b5ea2f4/Gorka-Guruzeta,24,20,6,12,6,11,24,13,23,2,21,4,28,8,0
https://fbref.com/en/players/436a9dd0/Ander-Herrera,18,10,8,7,3,6,18,12,12,3,9,11,29,12,0
https://fbref.com/en/players/59b7d823/Inigo-Lekue,24,17,20,4,0,12,19,7,16,2,14,13,37,31,1
https://fbref.com/en/players/9f323c71/Oscar-de-Marcos,67,33,34,22,11,40,76,36,42,6,36,29,96,59,0
https://fbref.com/en/players/3fc45c73/Inigo-Martinez,18,8,11,7,0,6,9,3,17,11,6,18,36,55,0
https://fbref.com/en/players/b7d7f3bf/Jon-Morcillo,1,0,1,0,0,0,1,1,0,0,0,1,2,0,0
https://fbref.com/en/players/c05dfb74/Iker-Muniain,21,16,7,11,3,6,17,11,10,1,9,4,25,2,0
https://fbref.com/en/players/b906757a/Aitor-Paredes,7,6,4,2,1,6,11,5,11,7,4,14,21,26,0
https://fbref.com/en/players/bdb624a3/Oihan-Sancet,27,16,2,19,6,11,37,26,10,0,10,4,31,9,1
https://fbref.com/en/players/5dcf3e90/Unai-Simon,2,0,2,0,0,1,1,0,1,0,1,0,2,9,3
https://fbref.com/en/players/4112ace5/Unai-Vencedor-Paris,3,1,0,3,0,1,6,5,5,0,5,1,4,1,0
https://fbref.com/en/players/b0fce72c/Mikel-Vesga,57,35,21,31,5,25,68,43,39,8,31,36,93,39,3
https://fbref.com/en/players/57be54ec/Asier-Villalibre,0,0,0,0,0,0,0,0,0,0,0,0,0,1,0
https://fbref.com/en/players/ab7bf91d/Daniel-Vivian,57,32,36,16,5,36,45,9,27,14,13,24,81,90,3
https://fbref.com/en/players/6a99e0b1/Inaki-Williams,22,16,5,14,3,9,24,15,18,3,15,7,29,34,0
https://fbref.com/en/players/afdc14d7/Nico-Williams,31,16,10,15,6,19,41,22,40,2,38,8,39,14,1
https://fbref.com/en/players/968a1c2f/Oier-Zarraga,14,9,5,7,2,8,20,12,7,0,7,10,24,5,0
https://fbref.com/en/players/45736cec/Pablo-Barrios,19,10,3,10,6,8,15,7,12,2,10,9,28,6,1
https://fbref.com/en/players/de39485a/Yannick-Carrasco,35,14,21,10,4,23,54,31,23,1,22,12,47,19,0
https://fbref.com/en/players/01eb744d/Angel-Correa,12,6,6,3,3,5,16,11,17,0,17,10,22,6,1
https://fbref.com/en/players/dc62b55d/Matheus-Cunha,4,1,1,3,0,0,3,3,4,1,3,2,6,3,0
https://fbref.com/en/players/162efffd/Rodrigo-De-Paul,35,21,11,18,6,18,35,17,20,3,17,8,43,7,0
https://fbref.com/en/players/d557d734/Matt-Doherty,0,0,0,0,0,0,0,0,2,0,2,0,0,0,0
https://fbref.com/en/players/51a3c4c8/Felipe,3,2,1,2,0,2,4,2,2,2,0,0,3,7,0
https://fbref.com/en/players/8aafd64f/Joao-Felix,10,7,2,3,5,1,6,5,1,0,1,3,13,2,0
https://fbref.com/en/players/f0f4671c/Antonio-Gomis,0,0,0,0,0,0,0,0,0,0,0,0,0,0,0
https://fbref.com/en/players/3f034750/Ivo-Grbic,0,0,0,0,0,0,0,0,0,0,0,0,0,9,1
https://fbref.com/en/players/df69b544/Antoine-Griezmann,49,34,15,23,11,20,66,46,34,3,31,24,73,31,0
https://fbref.com/en/players/555f3a0b/Mario-Hermoso,22,15,14,6,2,9,30,21,19,9,10,19,41,85,1
https://fbref.com/en/players/55126f3b/Koke,55,38,23,25,7,28,72,44,35,13,22,20,75,19,0
https://fbref.com/en/players/cce181df/Geoffrey-Kondogbia,40,23,19,20,1,17,25,8,9,1,8,26,66,12,1
https://fbref.com/en/players/4dbd0916/Thomas-Lemar,30,18,10,13,7,10,28,18,12,3,9,7,37,12,0
https://fbref.com/en/players/02c15616/Marcos-Llorente,32,15,16,10,6,17,30,13,26,2,24,17,49,19,0
https://fbref.com/en/players/c20bdcd7/Reinildo-Mandava,66,43,46,19,1,38,49,11,27,12,15,30,96,59,0
https://fbref.com/en/players/f0da930c/Jose-Maria-Gimenez,43,25,28,14,1,24,35,11,37,17,20,24,67,138,1
https://fbref.com/en/players/64035864/Carlos-Martin,2,2,0,2,0,2,3,1,0,0,0,1,3,0,0
https://fbref.com/en/players/8f696594/Memphis,1,0,0,0,1,0,1,1,0,0,0,0,1,0,0
https://fbref.com/en/players/23610943/Nahuel-Molina,69,43,38,18,13,39,91,52,38,7,31,18,87,63,1
https://fbref.com/en/players/129af0db/Alvaro-Morata,16,11,4,8,4,3,8,5,11,3,8,0,16,23,0
https://fbref.com/en/players/c14bc029/Saul-Niguez,42,27,18,18,6,22,37,15,27,5,22,15,57,29,0
https://fbref.com/en/players/ee8508c0/Jan-Oblak,0,0,0,0,0,0,0,0,0,0,0,1,1,8,0
https://fbref.com/en/players/3353737a/Sergio-Reguilon,7,5,5,2,0,5,7,2,3,0,3,2,9,4,0
https://fbref.com/en/players/f6ac68c1/Stefan-Savic,39,26,29,7,3,26,39,13,17,8,9,33,72,67,2
https://fbref.com/en/players/5dfc6ad5/Axel-Witsel,36,22,22,11,3,17,31,14,20,11,9,23,59,76,0
https://fbref.com/en/players/44a20f0c/Maximilian-Bauer,31,17,18,12,1,17,34,17,25,9,16,23,54,79,1
https://fbref.com/en/players/69374ff5/Julian-Baumgartlinger,15,4,5,6,4,6,19,13,4,2,2,4,19,15,0
https://fbref.com/en/players/fbbc8e15/Noah-Joel-Sarenren-Bazee,0,0,0,0,0,0,1,1,1,0,1,0,0,0,0
https://fbref.com/en/players/eb6e14be/Mergim-Berisha,11,6,4,3,4,4,14,10,16,1,15,0,11,19,0
https://fbref.com/en/players/d1273f09/Daniel-Caligiuri,8,5,5,3,0,4,5,1,3,2,1,3,11,2,0
https://fbref.com/en/players/5e080f73/Irvin-Cardona,1,1,1,0,0,1,5,4,3,0,3,4,5,8,0
https://fbref.com/en/players/dd5bbe0d/David-Colina,4,1,1,1,2,2,2,0,8,0,8,4,8,3,0
https://fbref.com/en/players/ed79b7d3/Ermedin-Demirovic,31,14,9,12,10,9,22,13,31,4,27,14,45,37,0
https://fbref.com/en/players/7f73bdf4/Niklas-Dorsch,21,12,8,11,2,9,16,7,9,3,6,6,27,9,0
https://fbref.com/en/players/9a2e3a23/Dion-Drena-Beljo,7,6,3,2,2,2,13,11,15,2,13,1,8,14,0
https://fbref.com/en/players/554bcc91/Arne-Engels,20,9,9,10,1,8,19,11,17,5,12,15,35,12,1
https://fbref.com/en/players/677da306/Ohis-Felix-Uduokhai,30,20,14,13,3,15,29,14,27,14,13,29,59,61,1
https://fbref.com/en/players/626fab5f/Raphael-Framberger,10,6,6,4,0,3,5,2,2,1,1,2,12,5,0
https://fbref.com/en/players/17376543/Rafal-Gikiewicz,2,2,2,0,0,2,3,1,0,0,0,0,2,15,5
https://fbref.com/en/players/1025db8e/Jeffrey-Gouweleeuw,42,27,19,17,6,24,49,25,41,23,18,50,92,141,2
https://fbref.com/en/players/f2dd9a21/Carlos-Gruezo,21,12,12,9,0,9,16,7,13,4,9,10,31,15,0
https://fbref.com/en/players/1df0c0b9/Robert-Gumny,34,24,13,15,6,11,27,16,21,7,14,26,60,62,1
https://fbref.com/en/players/cd82452e/Andre-Hahn,9,5,4,4,1,8,12,4,9,2,7,4,13,14,0
https://fbref.com/en/players/054849d2/Iago,34,16,20,10,4,11,29,18,18,5,13,17,51,53,0
https://fbref.com/en/players/3eeb80e0/Fredrik-Jensen,15,10,8,3,4,5,10,5,12,5,7,4,19,12,0
https://fbref.com/en/players/dc366c36/Tomas-Koubek,0,0,0,0,0,0,0,0,0,0,0,0,0,7,0
https://fbref.com/en/players/ab700320/Arne-Maier,31,22,17,11,3,10,18,8,21,0,21,15,46,22,0
https://fbref.com/en/players/46750e9c/Nathanael-Mbuku,1,0,0,1,0,0,0,0,0,0,0,0,1,0,0
https://fbref.com/en/players/d6862409/Florian-Niederlechner,10,5,5,4,1,4,7,3,16,2,14,1,11,9,0
https://fbref.com/en/players/8b6e0db2/Reece-Oxford,1,1,1,0,0,0,0,0,4,3,1,1,2,5,0
https://fbref.com/en/players/582a5247/Mads-Pedersen,44,23,31,11,2,22,33,11,32,9,23,20,64,41,1
https://fbref.com/en/players/a2b1ed42/Ricardo-Pepi,1,1,1,0,0,1,1,0,1,0,1,0,1,1,0
https://fbref.com/en/players/f503ef6e/Lukas-Petkov,5,1,4,1,0,2,3,1,4,1,3,1,6,0,0
https://fbref.com/en/players/1ae836b1/Elvis-Rexhbecaj,51,30,18,24,9,29,59,30,40,13,27,17,68,40,0
https://fbref.com/en/players/6ecbddf6/Ruben-Vargas,15,7,6,7,2,5,11,6,8,2,6,6,21,16,1
https://fbref.com/en/players/fc8fcbd1/Renato-Veiga,9,6,4,3,2,7,9,2,20,6,14,7,16,29,1
https://fbref.com/en/players/a1257b5e/Frederik-Winther,2,2,1,1,0,0,2,2,1,1,0,0,2,7,0
https://fbref.com/en/players/ea0893d6/Kelvin-Yeboah,6,4,2,4,0,2,5,3,7,0,7,1,7,2,0
https://fbref.com/en/players/65bf7e2b/Aaron-Zehnter,0,0,0,0,0,0,1,1,0,0,0,1,1,0,0
https://fbref.com/en/players/0e46fa2f/Matthis-Abline,4,2,0,3,1,0,5,5,6,1,5,1,5,1,0
https://fbref.com/en/players/7dfbba27/Mathias-Autret,22,10,10,10,2,7,16,9,14,2,12,12,34,13,0
https://fbref.com/en/players/5065d67d/Denys-Bain,4,3,3,1,0,1,2,1,2,1,1,2,6,4,0
https://fbref.com/en/players/3916b09c/Quentin-Bernard,9,7,4,2,3,7,15,8,9,1,8,15,24,17,0
https://fbref.com/en/players/c03b7266/Kenji-Van-Boto,3,2,2,0,1,2,4,2,0,0,0,1,4,3,0
https://fbref.com/en/players/5a6b06cd/Ousmane-Camara,1,1,0,0,1,0,0,0,0,0,0,0,1,0,0
https://fbref.com/en/players/18ebca4b/Gaetan-Charbonnier,2,1,0,2,0,0,4,4,2,0,2,0,2,5,0
https://fbref.com/en/players/c4065f40/Alexandre-Coeff,10,5,6,4,0,4,9,5,9,4,5,8,18,35,1
https://fbref.com/en/players/909222de/Nuno-da-Costa,45,23,14,23,8,11,46,35,21,1,20,20,65,15,0
https://fbref.com/en/players/2434f24a/Benoit-Costil,2,0,2,0,0,2,4,2,0,0,0,0,2,5,0
https://fbref.com/en/players/e76f6fbe/Kevin-Danois,1,1,0,1,0,0,0,0,0,0,0,1,2,0,0
https://fbref.com/en/players/11f54bd5/Siriki-Dembele,10,6,4,3,3,4,12,8,2,0,2,1,11,2,0
https://fbref.com/en/players/6d7ede84/Remy-Dugimont,2,1,0,1,1,1,2,1,3,0,3,0,2,5,0
https://fbref.com/en/players/563fcd6b/Gauthier-Hein,27,20,13,11,3,18,48,30,10,0,10,6,33,10,0
https://fbref.com/en/players/5cb215fc/Julian-Jeanvier,32,17,24,8,0,13,22,9,24,17,7,27,59,96,1
https://fbref.com/en/players/5b4bc323/Paul-Joly,33,21,21,10,2,19,35,16,13,2,11,24,57,29,2
https://fbref.com/en/players/56ae428b/Jubal,41,26,29,11,1,19,38,19,57,34,23,53,94,193,0
https://fbref.com/en/players/51c83a90/Donovan-Leon,0,0,0,0,0,0,0,0,0,0,0,0,0,1,0
https://fbref.com/en/players/e05082d1/Youssouf-MChangama,22,11,7,12,3,7,13,6,6,0,6,15,37,6,1
https://fbref.com/en/players/eba1e557/Han-Noah-Massengo,27,15,10,15,2,7,16,9,12,3,9,14,41,7,0
https://fbref.com/en/players/9bdd8118/Gideon-Mensah,80,44,43,32,5,44,77,33,33,10,23,38,118,41,0
https://fbref.com/en/players/2054d037/MBaye-Niang,13,7,1,8,4,3,13,10,22,1,21,1,14,20,0
https://fbref.com/en/players/97fb4608/Theo-Pellenard,1,0,1,0,0,1,1,0,3,1,2,2,3,2,0
https://fbref.com/en/players/5c42e7ce/Brayann-Pereira,6,5,5,1,0,1,5,4,2,2,0,2,8,8,1
https://fbref.com/en/players/10dd88f9/Gaetan-Perrin,17,8,5,6,6,8,30,22,15,0,15,10,27,9,0
https://fbref.com/en/players/67f649be/Ionut-Radu,0,0,0,0,0,0,0,0,0,0,0,0,0,3,2
https://fbref.com/en/players/fb3236a7/Rayan-Raveloson,38,23,21,16,1,23,33,10,43,12,31,39,77,70,0
https://fbref.com/en/players/90a9cc01/Kays-Ruiz,1,1,1,0,0,0,1,1,2,1,1,3,4,0,0
https://fbref.com/en/players/c9151d66/Hamza-Sakhi,44,22,22,17,5,22,42,20,16,1,15,25,69,9,0
https://fbref.com/en/players/5e5249c8/Lassine-Sinayoko,33,15,14,12,7,21,40,19,12,0,12,18,51,17,0
https://fbref.com/en/players/a4b798a9/Birama-Toure,80,47,35,35,10,34,93,59,54,9,45,67,147,49,0
https://fbref.com/en/players/01fd01e8/Souleymane-Toure,29,13,19,9,1,16,20,4,32,12,20,26,55,56,1
https://fbref.com/en/players/0ff630d0/Akim-Zedadka,35,21,21,10,4,18,32,14,17,3,14,23,58,51,1
https://fbref.com/en/players/455c26a4/Angel-Alarcon,NA,0,NA,NA,NA,NA,NA,NA,NA,NA,NA,0,NA,NA,NA
https://fbref.com/en/players/4601e194/Jordi-Alba,25,18,13,11,1,12,28,16,12,5,7,11,36,23,0
https://fbref.com/en/players/f4290206/Marcos-Alonso,15,10,10,5,0,9,12,3,14,10,4,11,26,32,0
https://fbref.com/en/players/2bef2bca/Ronald-Araujo,26,18,12,13,1,6,9,3,15,7,8,12,38,41,1
https://fbref.com/en/players/d5dd5f1f/Pierre-Emerick-Aubameyang,0,0,0,0,0,0,0,0,0,0,0,0,0,0,0
https://fbref.com/en/players/5ccc9672/Alejandro-Balde,42,30,22,16,4,24,41,17,25,3,22,12,54,17,1
https://fbref.com/en/players/f874dd44/Hector-Bellerin,2,0,0,2,0,2,3,1,2,0,2,3,5,2,0
https://fbref.com/en/players/5ab0ea87/Sergio-Busquets,58,26,24,26,8,29,51,22,32,6,26,27,85,36,2
https://fbref.com/en/players/1cb49278/Andreas-Christensen,20,15,9,11,0,10,16,6,14,12,2,21,41,47,0
https://fbref.com/en/players/b19db005/Ousmane-Dembele,19,12,4,8,7,4,15,11,10,1,9,0,19,2,0
https://fbref.com/en/players/0ba976e4/Ansu-Fati,16,9,8,4,4,5,18,13,19,0,19,5,21,6,0
https://fbref.com/en/players/2bed3eab/Eric-Garcia,24,16,16,5,3,9,20,11,23,10,13,19,43,36,1
https://fbref.com/en/players/5757adc3/Aleix-Garrido,2,1,1,0,1,1,1,0,1,0,1,0,2,0,0
https://fbref.com/en/players/19cae58d/Gavi,47,31,7,30,10,21,55,34,32,5,27,18,65,22,0
https://fbref.com/en/players/1bacc518/Frenkie-de-Jong,46,26,16,21,9,17,41,24,11,1,10,35,81,22,1
https://fbref.com/en/players/05e19d6a/Franck-Kessie,15,9,6,6,3,8,18,10,10,2,8,12,27,11,2
https://fbref.com/en/players/4d1666ff/Jules-Kounde,37,23,18,13,6,21,31,10,24,9,15,19,56,61,3
https://fbref.com/en/players/8d78e732/Robert-Lewandowski,17,11,2,5,10,7,14,7,20,0,20,2,19,14,0
https://fbref.com/en/players/8f696594/Memphis,1,1,1,0,0,0,1,1,0,0,0,0,1,0,0
https://fbref.com/en/players/0d9b2d31/Pedri,39,22,15,17,7,13,45,32,27,0,27,13,52,8,1
https://fbref.com/en/players/cc1c5035/Inaki-Pena,0,0,0,0,0,0,0,0,0,0,0,0,0,0,1
https://fbref.com/en/players/adfc9123/Gerard-Pique,5,4,1,4,0,4,4,0,2,1,1,2,7,19,0
https://fbref.com/en/players/3423f250/Raphinha,29,19,10,7,12,11,31,20,33,1,32,14,43,11,1
https://fbref.com/en/players/b3b9b8b8/Chadi-Riad,0,0,0,0,0,0,0,0,0,0,0,0,0,0,0
https://fbref.com/en/players/335fa267/Sergi-Roberto,22,15,12,6,4,7,18,11,15,7,8,11,33,16,0
https://fbref.com/en/players/6f51e382/Marc-Andre-ter-Stegen,0,0,0,0,0,0,0,0,0,0,0,1,1,7,3
https://fbref.com/en/players/04e531b6/Pablo-Torre,2,1,0,1,1,2,4,2,1,0,1,2,4,1,0
https://fbref.com/en/players/9e1035f8/Ferran-Torres,13,7,4,5,4,5,20,15,11,2,9,3,16,5,0
https://fbref.com/en/players/82ec26c1/Lamine-Yamal,0,0,0,0,0,0,0,0,0,0,0,0,0,0,0
https://fbref.com/en/players/691bef82/Daley-Blind,2,0,2,0,0,0,1,1,4,2,2,2,4,6,0
https://fbref.com/en/players/bd6351cd/Joao-Cancelo,23,14,9,10,4,10,23,13,14,2,12,15,38,22,0
https://fbref.com/en/players/042e8a49/Kingsley-Coman,11,8,3,5,3,7,17,10,19,1,18,2,13,7,0
https://fbref.com/en/players/d781d855/Alphonso-Davies,45,28,25,13,7,18,39,21,28,4,24,24,69,24,4
https://fbref.com/en/players/88e357ef/Serge-Gnabry,35,23,11,14,10,17,43,26,24,1,23,11,46,5,1
https://fbref.com/en/players/cc86b9a3/Leon-Goretzka,43,24,21,16,6,27,48,21,40,3,37,30,73,32,0
https://fbref.com/en/players/b8e740fb/Ryan-Gravenberch,17,8,4,10,3,7,13,6,9,1,8,9,26,10,0
https://fbref.com/en/players/c3ee18ef/Lucas-Hernandez,6,4,3,3,0,5,6,1,2,1,1,5,11,7,0
https://fbref.com/en/players/f5c4fd91/Arijon-Ibrahimovic,1,1,1,0,0,0,0,0,0,0,0,0,1,0,0
https://fbref.com/en/players/49296448/Joshua-Kimmich,78,49,24,46,8,38,72,34,36,7,29,41,119,39,2
https://fbref.com/en/players/d6e53a3a/Matthijs-de-Ligt,32,23,15,16,1,15,24,9,31,20,11,23,55,85,0
https://fbref.com/en/players/c691bfe2/Sadio-Mane,11,5,3,3,5,1,9,8,15,2,13,0,11,4,0
https://fbref.com/en/players/0e6bc38c/Eric-Maxim-Choupo-Moting,10,7,2,6,2,1,2,1,8,0,8,0,10,5,0
https://fbref.com/en/players/b74277a0/Noussair-Mazraoui,29,21,9,9,11,15,24,9,13,2,11,10,39,25,0
https://fbref.com/en/players/3c6089ab/Thomas-Muller,21,12,5,9,7,6,16,10,19,3,16,4,25,16,0
https://fbref.com/en/players/2c0558b8/Jamal-Musiala,34,23,9,16,9,13,35,22,30,3,27,19,53,3,0
https://fbref.com/en/players/8778c910/Manuel-Neuer,0,0,0,0,0,0,0,0,0,0,0,0,0,4,1
https://fbref.com/en/players/45a03961/Benjamin-Pavard,70,41,36,26,8,36,48,12,35,16,19,44,114,83,0
https://fbref.com/en/players/e280527c/Marcel-Sabitzer,27,14,11,10,6,10,17,7,3,0,3,10,37,9,0
https://fbref.com/en/players/2b114be3/Leroy-Sane,38,30,11,19,8,18,36,18,11,1,10,3,41,1,2
https://fbref.com/en/players/1a4b9094/Bouna-Sarr,0,0,0,0,0,0,0,0,0,0,0,0,0,0,0
https://fbref.com/en/players/420c18a1/Yann-Sommer,0,0,0,0,0,0,0,0,0,0,0,1,1,5,1
https://fbref.com/en/players/7ed08d5c/Josip-Stanisic,19,11,14,2,3,12,17,5,9,1,8,7,26,11,3
https://fbref.com/en/players/829aa60c/Mathys-Tel,2,2,0,1,1,1,1,0,5,1,4,0,2,2,0
https://fbref.com/en/players/7d3e7da6/Sven-Ulreich,1,1,1,0,0,1,1,0,0,0,0,0,1,0,1
https://fbref.com/en/players/d248cd8f/Dayot-Upamecano,65,37,43,22,0,28,45,17,26,6,20,27,92,71,4
https://fbref.com/en/players/5360a956/Gabriel-Vidovic,0,0,0,0,0,0,0,0,0,0,0,0,0,0,0
https://fbref.com/en/players/cb64672e/Paul-Wanner,3,1,1,2,0,1,1,0,0,0,0,0,3,1,0
https://fbref.com/en/players/7f9c5d2d/Abner,12,9,9,2,1,7,16,9,8,2,6,8,20,24,0
https://fbref.com/en/players/31f5b89b/Paul-Akouokou,16,9,13,3,0,13,20,7,2,2,0,12,28,17,1
https://fbref.com/en/players/10072610/Claudio-Bravo,0,0,0,0,0,0,0,0,0,0,0,2,2,1,1
https://fbref.com/en/players/a6de370d/Sergio-Canales,25,14,10,8,7,14,33,19,18,0,18,14,39,8,0
https://fbref.com/en/players/dee86451/William-Carvalho,43,27,18,23,2,17,44,27,27,6,21,16,59,22,0
https://fbref.com/en/players/cc2dd8a5/Juan-Cruz,1,0,0,1,0,1,3,2,1,0,1,0,1,0,0
https://fbref.com/en/players/e7d2a50b/Fran-Delgado,0,0,0,0,0,0,0,0,0,0,0,0,0,0,0
https://fbref.com/en/players/bece776f/Nabil-Fekir,11,5,3,3,5,2,9,7,6,2,4,1,12,0,0
https://fbref.com/en/players/15d0c248/Luiz-Felipe,34,23,23,11,0,18,34,16,43,24,19,28,62,106,0
https://fbref.com/en/players/9a26fa06/Felix-Garreta,1,0,0,1,0,0,0,0,1,1,0,1,2,4,0
https://fbref.com/en/players/49d028db/Edgar-Gonzalez,28,19,18,7,3,14,27,13,12,9,3,21,49,120,0
https://fbref.com/en/players/56545648/Roberto-Gonzalez,0,0,0,0,0,0,1,1,0,0,0,1,1,0,0
https://fbref.com/en/players/ef322658/Andres-Guardado,41,25,17,20,4,18,43,25,14,5,9,23,64,29,0
https://fbref.com/en/players/8059806f/Luiz-Henrique,48,34,27,15,6,20,44,24,22,0,22,14,62,17,0
https://fbref.com/en/players/75645f0e/Borja-Iglesias,8,4,3,3,2,2,13,11,9,1,8,1,9,17,0
https://fbref.com/en/players/4c5b14d2/Joaquin,3,3,2,1,0,1,3,2,7,2,5,4,7,5,0
https://fbref.com/en/players/d87e2cae/Willian-Jose,9,6,6,3,0,4,9,5,4,0,4,1,10,15,0
https://fbref.com/en/players/84399660/Juanmi,14,10,4,7,3,7,31,24,10,0,10,4,18,4,0
https://fbref.com/en/players/ead61f73/Juan-Miranda,23,16,16,6,1,14,29,15,20,7,13,20,43,63,0
https://fbref.com/en/players/5cec2487/Martin-Montoya,13,8,9,4,0,10,12,2,6,1,5,9,22,14,1
https://fbref.com/en/players/16e9d0ea/Alex-Moreno,29,22,19,10,0,18,36,18,17,4,13,17,46,39,0
https://fbref.com/en/players/3aa4a3be/Loren-Moron,2,2,0,1,1,0,0,0,0,0,0,0,2,1,0
https://fbref.com/en/players/819aa8e7/Ayoze-Perez,31,15,9,16,6,10,40,30,22,0,22,13,44,5,0
https://fbref.com/en/players/8c725b43/German-Pezzella,41,28,32,9,0,26,38,12,32,15,17,50,91,129,1
https://fbref.com/en/players/85bed4ee/Rodri,16,11,5,9,2,8,17,9,10,0,10,13,29,2,0
https://fbref.com/en/players/34e393f2/Guido-Rodriguez,115,75,59,50,6,54,101,47,58,14,44,42,157,76,1
https://fbref.com/en/players/a55d8df5/Aitor-Ruibal,47,29,35,9,3,31,58,27,17,2,15,24,71,41,0
https://fbref.com/en/players/b3dc6eca/Victor-Ruiz,5,3,3,2,0,3,3,0,10,7,3,6,11,34,0
https://fbref.com/en/players/fbbb9269/Youssouf-Sabaly,45,23,29,14,2,22,33,11,35,8,27,19,64,52,1
https://fbref.com/en/players/ea83bfa6/Rui-Silva,4,1,4,0,0,4,4,0,0,0,0,0,4,12,1
https://fbref.com/en/players/0a3f6cde/Christopher-Antwi-Adjei,23,15,7,8,8,10,29,19,17,0,17,5,28,16,0
https://fbref.com/en/players/13ddc856/Takuma-Asano,14,9,4,4,6,7,16,9,17,1,16,8,22,8,0
https://fbref.com/en/players/bbd79358/Moritz-Broschinski,0,0,0,0,0,0,5,5,1,0,1,0,0,6,0
https://fbref.com/en/players/76fa965f/Philipp-Forster,31,19,11,15,5,12,40,28,22,0,22,6,37,6,0
https://fbref.com/en/players/f27680d9/Cristian-Gamboa,42,24,27,14,1,21,31,10,20,7,13,16,58,34,1
https://fbref.com/en/players/6c731625/Silvere-Ganvoula-MBoussy,2,2,0,1,1,0,0,0,0,0,0,0,2,3,0
https://fbref.com/en/players/83b9c48f/Jacek-Goralski,6,3,3,3,0,4,6,2,4,0,4,3,9,5,0
https://fbref.com/en/players/699fb8db/Dominique-Heintz,13,9,5,7,1,6,17,11,11,7,4,12,25,34,0
https://fbref.com/en/players/877bc844/Philipp-Hofmann,18,11,0,13,5,5,12,7,20,8,12,6,24,48,0
https://fbref.com/en/players/2979c05a/Gerrit-Holtmann,14,7,6,7,1,12,21,9,15,1,14,2,16,4,0
https://fbref.com/en/players/2b83fa49/Jannes-Horn,2,1,1,1,0,1,1,0,1,0,1,3,5,2,0
https://fbref.com/en/players/689c9cf4/Saidy-Janko,23,15,13,8,2,12,20,8,24,10,14,11,34,33,1
https://fbref.com/en/players/9ceb7642/Pierre-Kunde,12,6,3,8,1,6,14,8,7,1,6,7,19,9,0
https://fbref.com/en/players/591477c9/Vassilis-Lambropoulos,10,8,7,3,0,6,9,3,5,3,2,13,23,41,0
https://fbref.com/en/players/07c7eb0c/Anthony-Losilla,76,49,32,34,10,38,77,39,39,12,27,37,113,67,0
https://fbref.com/en/players/a396fb61/Erhan-Masovic,50,31,28,21,1,30,51,21,30,14,16,27,77,79,0
https://fbref.com/en/players/57ec75bf/Tim-Oermann,2,1,2,0,0,1,1,0,3,2,1,1,3,8,1
https://fbref.com/en/players/86c75897/Ivan-Ordets,31,19,21,9,1,16,28,12,34,17,17,57,88,139,0
https://fbref.com/en/players/0a16eb36/Jordi-Osei-Tutu,23,18,13,5,5,12,23,11,12,5,7,10,33,8,0
https://fbref.com/en/players/9662c9ec/Patrick-Osterhage,20,17,8,10,2,11,16,5,17,6,11,12,32,25,0
https://fbref.com/en/players/9f941969/Manuel-Riemann,3,2,3,0,0,3,5,2,1,0,1,5,8,23,7
https://fbref.com/en/players/f6bdc830/Keven-Schlotterbeck,17,9,12,5,0,9,11,2,11,5,6,14,31,49,0
https://fbref.com/en/players/c05f2f8c/Danilo-Soares,72,46,42,23,7,43,72,29,29,6,23,30,102,56,1
https://fbref.com/en/players/861e0116/Kostas-Stafylidis,27,16,13,8,6,10,24,14,21,8,13,20,47,31,1
https://fbref.com/en/players/e5649a78/Kevin-Stoger,84,45,38,32,14,31,94,63,27,4,23,26,110,21,1
https://fbref.com/en/players/29f7cfd9/Simon-Zoller,11,4,2,8,1,4,12,8,14,1,13,6,17,21,0
https://fbref.com/en/players/f9c927de/Michel-Aebischer,12,6,3,6,3,2,18,16,14,2,12,7,19,9,0
https://fbref.com/en/players/00459419/Marko-Arnautovic,9,6,2,5,2,1,6,5,11,1,10,2,11,10,0
https://fbref.com/en/players/0acda699/Francesco-Bardi,0,0,0,0,0,0,0,0,0,0,0,0,0,0,0
https://fbref.com/en/players/e5bf73f3/Musa-Barrow,21,4,10,6,5,8,14,6,25,1,24,1,22,7,0
https://fbref.com/en/players/fb77bfef/Kevin-Bonifazi,13,8,7,6,0,6,12,6,11,8,3,12,25,39,0
https://fbref.com/en/players/247ed022/Andrea-Cambiaso,57,34,34,20,3,28,65,37,26,2,24,26,83,33,1
https://fbref.com/en/players/e74f0e59/Lorenzo-De-Silvestri,3,2,2,0,1,3,7,4,6,5,1,3,6,20,0
https://fbref.com/en/players/20b3a502/Nicolas-Dominguez,79,49,34,33,12,39,76,37,29,3,26,21,100,29,1
https://fbref.com/en/players/ee64a822/Lewis-Ferguson,44,25,16,20,8,20,40,20,22,7,15,19,63,25,0
https://fbref.com/en/players/7ae36711/Denso-Kasius,12,6,7,4,1,8,10,2,6,3,3,3,15,6,0
https://fbref.com/en/players/0a483542/Giorgos-Kyriakopoulos,13,6,4,5,4,10,23,13,14,2,12,4,17,10,0
https://fbref.com/en/players/80490d7f/Jhon-Lucumi,53,37,39,13,1,24,43,19,43,26,17,35,88,100,1
https://fbref.com/en/players/5efc5389/Charalambos-Lykogiannis,16,8,5,6,5,5,13,8,9,4,5,15,31,30,0
https://fbref.com/en/players/563a68ad/Gary-Medel,25,15,16,7,2,9,16,7,17,10,7,28,53,34,0
https://fbref.com/en/players/ff579c7e/Nikola-Moro,32,21,11,15,6,14,36,22,15,2,13,8,40,18,0
https://fbref.com/en/players/e14ec482/Riccardo-Orsolini,30,19,15,10,5,17,41,24,29,3,26,8,38,18,0
https://fbref.com/en/players/7f609bfc/Stefan-Posch,81,43,41,29,11,44,75,31,44,15,29,35,116,69,0
https://fbref.com/en/players/88f53b75/Niklas-Pyyhtia,1,0,0,1,0,0,1,1,1,1,0,1,2,4,0
https://fbref.com/en/players/ce1a6c7e/Antonio-Raimondo,0,0,0,0,0,0,0,0,0,0,0,0,0,1,0
https://fbref.com/en/players/7eb97a8e/Nicola-Sansone,12,4,6,4,2,5,10,5,0,0,0,0,12,4,0
https://fbref.com/en/players/2cfae697/Jerdy-Schouten,63,38,28,33,2,27,49,22,40,17,23,40,103,43,1
https://fbref.com/en/players/ab4449d6/Lukasz-Skorupski,2,1,2,0,0,1,2,1,0,0,0,0,2,19,2
https://fbref.com/en/players/9d4c45d6/Roberto-Soriano,31,16,9,16,6,13,25,12,23,2,21,6,37,14,0
https://fbref.com/en/players/50841bef/Joaquin-Sosa,6,2,5,1,0,4,18,14,5,3,2,6,12,31,0
https://fbref.com/en/players/7b075c75/Adama-Soumaoro,25,17,11,12,2,5,7,2,18,13,5,15,40,75,1
https://fbref.com/en/players/ec5dae45/Emanuel-Vignato,4,4,2,2,0,2,4,2,2,0,2,3,7,0,0
https://fbref.com/en/players/028e70b9/Joshua-Zirkzee,4,2,1,1,2,2,7,5,4,1,3,4,8,4,0
https://fbref.com/en/players/e4238fb1/Jaidon-Anthony,30,17,15,9,6,8,24,16,30,3,27,10,40,19,0
https://fbref.com/en/players/87966294/Owen-Bevan,0,0,0,0,0,0,0,0,0,0,0,0,0,0,0
https://fbref.com/en/players/d328a254/Philip-Billing,63,36,21,33,9,11,40,29,48,8,40,31,94,58,1
https://fbref.com/en/players/dc4cae05/David-Brooks,1,0,1,0,0,0,1,1,2,0,2,2,3,5,0
https://fbref.com/en/players/26ce2263/Ryan-Christie,34,22,10,23,1,14,49,35,16,4,12,26,60,20,0
https://fbref.com/en/players/2afc7272/Lewis-Cook,37,22,10,22,5,18,42,24,29,10,19,23,60,31,0
https://fbref.com/en/players/11f54bd5/Siriki-Dembele,3,1,2,1,0,0,1,1,1,0,1,1,4,1,0
https://fbref.com/en/players/c067631c/Ryan-Fredericks,3,2,2,0,1,1,4,3,7,2,5,1,4,27,0
https://fbref.com/en/players/570bb4b9/Hamed-Junior-Traore,17,11,5,9,3,6,18,12,9,0,9,2,19,1,0
https://fbref.com/en/players/f31def1e/Lloyd-Kelly,33,18,23,9,1,13,19,6,26,15,11,26,59,101,1
https://fbref.com/en/players/9b5ce51a/Jefferson-Lerma,50,30,23,23,4,20,45,25,32,15,17,47,97,91,1
https://fbref.com/en/players/b2856bc0/Jamal-Lowe,0,0,0,0,0,0,0,0,0,0,0,0,0,0,0
https://fbref.com/en/players/4d960fc3/Emiliano-Marcondes,0,0,0,0,0,0,0,0,0,0,0,0,0,1,0
https://fbref.com/en/players/fed96827/Chris-Mepham,45,22,37,8,0,19,30,11,40,27,13,30,75,152,0
https://fbref.com/en/players/01ce9e70/Kieffer-Moore,14,11,2,9,3,5,16,11,12,5,7,1,15,26,0
https://fbref.com/en/players/a9dc785c/Neto,3,1,3,0,0,3,3,0,0,0,0,0,3,10,3
https://fbref.com/en/players/2f9e4435/Dango-Ouattara,28,15,20,6,2,13,32,19,20,3,17,13,41,29,1
https://fbref.com/en/players/a6b461e7/Ben-Pearson,7,3,3,3,1,1,3,2,4,0,4,2,9,6,0
https://fbref.com/en/players/10a10454/Joe-Rothwell,20,13,7,12,1,7,21,14,14,3,11,9,29,7,0
https://fbref.com/en/players/efd2ec23/Antoine-Semenyo,1,0,0,0,1,1,6,5,10,1,9,2,3,4,0
https://fbref.com/en/players/35141f4c/Marcos-Senesi,50,35,28,22,0,23,43,20,38,20,18,43,93,146,2
https://fbref.com/en/players/20b104bc/Adam-Smith,49,29,27,19,3,29,60,31,30,13,17,25,74,81,1
https://fbref.com/en/players/e77dc3b2/Dominic-Solanke,15,9,8,3,4,5,22,17,26,7,19,6,21,46,0
https://fbref.com/en/players/558807c0/Jack-Stacey,5,4,3,1,1,2,5,3,3,1,2,5,10,15,0
https://fbref.com/en/players/6992791d/Junior-Stanislas,0,0,0,0,0,0,0,0,2,1,1,0,0,0,0
https://fbref.com/en/players/6adbc307/Jack-Stephens,15,11,10,4,1,6,10,4,23,16,7,16,31,53,0
https://fbref.com/en/players/5c0da4a4/Marcus-Tavernier,33,22,19,11,3,11,32,21,25,4,21,9,42,23,0
https://fbref.com/en/players/fe558029/Mark-Travers,0,0,0,0,0,0,0,0,1,0,1,0,0,6,0
https://fbref.com/en/players/08eb3b58/Matias-Vina,19,11,9,8,2,14,30,16,13,1,12,4,23,22,0
https://fbref.com/en/players/88968486/Illia-Zabarnyi,4,2,4,0,0,3,7,4,7,2,5,3,7,14,0
https://fbref.com/en/players/e8271ad9/Jordan-Zemura,39,24,24,14,1,23,43,20,31,9,22,16,55,32,0
https://fbref.com/en/players/a8c0acb7/Kristoffer-Ajer,11,8,5,4,2,9,16,7,6,5,1,7,18,22,0
https://fbref.com/en/players/2886c9b5/Shandon-Baptiste,15,9,6,6,3,7,17,10,10,2,8,7,22,10,0
https://fbref.com/en/players/30db8574/Mads-Bech-Sorensen,0,0,0,0,0,0,0,0,0,0,0,1,1,1,0
https://fbref.com/en/players/1137759d/Sergi-Canos,0,0,0,0,0,0,2,2,3,1,2,0,0,1,0
https://fbref.com/en/players/215f3907/Mikkel-Damsgaard,31,21,13,13,5,15,42,27,20,2,18,10,41,14,0
https://fbref.com/en/players/60344e4f/Josh-Dasilva,18,9,6,6,6,6,16,10,22,6,16,5,23,7,1
https://fbref.com/en/players/9d8cf204/Halil-Dervisoglu,0,0,0,0,0,0,1,1,0,0,0,0,0,0,0
https://fbref.com/en/players/f7b1d4e0/Saman-Ghoddos,2,1,0,1,1,1,3,2,5,1,4,4,6,2,0
https://fbref.com/en/players/8a3c1dc7/Rico-Henry,57,31,20,28,9,22,41,19,29,8,21,30,87,84,1
https://fbref.com/en/players/1780bb4a/Aaron-Hickey,38,26,27,11,0,18,32,14,18,7,11,17,55,32,1
https://fbref.com/en/players/8449d35e/Vitaly-Janelt,54,27,20,24,10,21,49,28,29,9,20,29,83,26,0
https://fbref.com/en/players/172e52d8/Pontus-Jansson,5,3,4,1,0,3,5,2,13,9,4,9,14,38,0
https://fbref.com/en/players/0f134faf/Mathias-Jensen,70,35,28,30,12,34,97,63,54,5,49,32,102,24,1
https://fbref.com/en/players/0db5d2c8/Mathias-Jorgensen,17,8,9,8,0,9,21,12,19,12,7,16,33,39,1
https://fbref.com/en/players/41f08ac8/Keane-Lewis-Potter,1,0,0,1,0,0,0,0,5,1,4,0,1,2,0
https://fbref.com/en/players/6afaebf2/Bryan-Mbeumo,26,18,5,13,8,8,42,34,24,1,23,13,39,21,0
https://fbref.com/en/players/8df7a2fb/Ben-Mee,45,24,28,13,4,20,37,17,54,42,12,48,93,122,1
https://fbref.com/en/players/df0a4c90/Christian-Norgaard,52,30,21,29,2,18,48,30,32,9,23,34,86,41,2
https://fbref.com/en/players/2944f86f/Frank-Onyeka,19,14,11,7,1,10,25,15,16,3,13,10,29,16,0
https://fbref.com/en/players/e541326e/Ethan-Pinnock,52,28,33,12,7,18,24,6,41,31,10,35,87,215,2
https://fbref.com/en/players/98ea5115/David-Raya,0,0,0,0,0,0,2,2,1,0,1,1,1,10,2
https://fbref.com/en/players/57c94db2/Mads-Roerslev,22,12,19,3,0,16,33,17,14,5,9,9,31,38,0
https://fbref.com/en/players/52afb588/Kevin-Schade,12,8,7,2,3,5,10,5,7,0,7,4,16,6,0
https://fbref.com/en/players/e09f279b/Ivan-Toney,23,13,4,9,10,7,23,16,24,9,15,14,37,36,0
https://fbref.com/en/players/2500cef9/Yoane-Wissa,17,12,4,7,6,6,13,7,10,0,10,6,23,15,0
https://fbref.com/en/players/c5e6c017/Tairyk-Arconte,1,1,0,0,1,0,3,3,1,0,1,0,1,2,0
https://fbref.com/en/players/1a248246/Youcef-Belaili,5,2,3,2,0,2,7,5,2,0,2,1,6,1,0
https://fbref.com/en/players/2b1bed19/Haris-Belkebla,80,48,35,40,5,44,85,41,32,6,26,52,132,21,3
https://fbref.com/en/players/3d214e5f/Marco-Bizot,0,0,0,0,0,0,1,1,1,0,1,0,0,24,4
https://fbref.com/en/players/6a9e4913/Joaquin-Blazquez,0,0,0,0,0,0,0,0,0,0,0,0,0,2,0
https://fbref.com/en/players/5b146df3/Lilian-Brassier,42,30,31,8,3,23,32,9,42,19,23,53,95,132,1
https://fbref.com/en/players/8577e60a/Mahdi-Camara,63,36,18,38,7,25,43,18,35,4,31,40,103,16,0
https://fbref.com/en/players/9f4a940f/Axel-Camblan,2,2,1,1,0,0,1,1,0,0,0,0,2,0,0
https://fbref.com/en/players/5e080f73/Irvin-Cardona,2,0,1,1,0,0,3,3,3,0,3,2,4,2,0
https://fbref.com/en/players/16aa7d4c/Brendan-Chardonnet,45,27,27,18,0,20,38,18,40,19,21,63,108,86,1
https://fbref.com/en/players/5069b796/Achraf-Dari,21,14,15,5,1,14,20,6,16,10,6,19,40,65,2
https://fbref.com/en/players/0be95d34/Romain-Del-Castillo,39,24,13,17,9,16,36,20,14,1,13,11,50,5,0
https://fbref.com/en/players/7304f3b1/Karamoko-Dembele,2,0,1,1,0,2,2,0,1,0,1,1,3,0,0
https://fbref.com/en/players/0cbc8baa/Jean-Kevin-Duverne,72,38,44,24,4,42,73,31,33,5,28,28,100,65,1
https://fbref.com/en/players/104b4ad3/Alberth-Elis,4,3,1,2,1,1,7,6,1,0,1,1,5,2,0
https://fbref.com/en/players/83f03b07/Noah-Fadiga,30,21,18,9,3,14,26,12,17,7,10,26,56,18,0
https://fbref.com/en/players/3681cfff/Christophe-Herelle,10,4,7,2,1,4,13,9,16,11,5,20,30,48,0
https://fbref.com/en/players/db7849ca/Franck-Honorat,41,29,20,8,13,19,34,15,22,2,20,21,62,18,0
https://fbref.com/en/players/770d7eb8/Kenny-Lala,36,19,19,15,2,22,38,16,15,5,10,21,57,28,0
https://fbref.com/en/players/88c4d190/Jeremy-Le-Douaron,15,9,5,9,1,3,27,24,29,2,27,11,26,30,0
https://fbref.com/en/players/f5044e54/Pierre-Lees-Melou,97,55,55,37,5,57,123,66,48,13,35,52,149,46,1
https://fbref.com/en/players/8ca9415f/Felix-Lemarechal,5,5,2,1,2,0,3,3,6,0,6,1,6,2,0
https://fbref.com/en/players/40221fa7/Banzouzi-Locko,4,3,2,1,1,2,3,1,4,0,4,2,6,13,0
https://fbref.com/en/players/d4d35152/Hugo-Magnetti,43,27,18,23,2,23,63,40,21,1,20,25,68,12,0
https://fbref.com/en/players/0f86995c/Hianga-Mananga-Mbock,0,0,0,0,0,0,1,1,0,0,0,0,0,0,0
https://fbref.com/en/players/19ba6c6d/Steve-Mounie,13,5,1,7,5,5,14,9,18,7,11,3,16,20,0
https://fbref.com/en/players/8846a40f/Mathias-Pereira-Lage,20,7,5,14,1,11,29,18,10,1,9,14,34,12,0
https://fbref.com/en/players/ffec9769/Islam-Slimani,5,3,2,2,1,0,3,3,2,0,2,1,6,11,0
https://fbref.com/en/players/d75f3980/Jere-Uronen,8,5,4,4,0,7,12,5,6,2,4,7,15,5,0
https://fbref.com/en/players/f173303a/Yasin-Ayari,2,2,1,1,0,0,4,4,1,0,1,0,2,0,0
https://fbref.com/en/players/468a7a91/Facundo-Buonanotte,2,1,1,1,0,1,22,21,5,2,3,4,6,3,0
https://fbref.com/en/players/16264a81/Moises-Caicedo,100,50,41,47,12,40,68,28,43,7,36,56,156,31,3
https://fbref.com/en/players/9cfbad36/Julio-Cesar-Enciso,13,4,3,6,4,8,13,5,9,0,9,4,17,2,0
https://fbref.com/en/players/700783e7/Levi-Colwill,8,7,4,4,0,4,9,5,5,3,2,15,23,37,1
https://fbref.com/en/players/282f75f3/Lewis-Dunk,30,19,19,9,2,18,41,23,37,27,10,34,64,81,1
https://fbref.com/en/players/d38fdf53/Pervis-Estupinan,61,31,36,19,6,35,60,25,30,8,22,37,98,37,1
https://fbref.com/en/players/4596da74/Evan-Ferguson,6,3,1,3,2,1,7,6,11,1,10,2,8,6,0
https://fbref.com/en/players/df10e27c/Billy-Gilmour,5,2,2,2,1,2,8,6,5,2,3,6,11,5,0
https://fbref.com/en/players/8aec0537/Pascal-Gross,59,38,23,27,9,25,55,30,32,10,22,13,72,21,1
https://fbref.com/en/players/4fd08daa/Jan-Paul-van-Hecke,8,6,3,4,1,5,5,0,8,5,3,6,14,9,0
https://fbref.com/en/players/e98211e7/Jack-Hinshelwood,1,0,1,0,0,0,0,0,0,0,0,0,1,0,0
https://fbref.com/en/players/99813635/Adam-Lallana,9,4,6,2,1,0,7,7,6,0,6,2,11,1,0
https://fbref.com/en/players/f4e433d4/Tariq-Lamptey,11,6,6,4,1,5,7,2,7,3,4,7,18,2,0
https://fbref.com/en/players/83d074ff/Alexis-Mac-Allister,70,39,22,40,8,34,70,36,26,2,24,22,92,10,1
https://fbref.com/en/players/bb5fbd2b/Solly-March,53,31,16,17,20,8,28,20,34,3,31,24,77,32,0
https://fbref.com/en/players/74618572/Kaoru-Mitoma,44,27,15,16,13,20,41,21,25,0,25,17,61,10,0
https://fbref.com/en/players/c4720845/Andrew-Moran,0,0,0,0,0,0,0,0,1,0,1,0,0,0,0
https://fbref.com/en/players/1d5cab82/Enock-Mwepu,10,5,1,6,3,3,4,1,3,1,2,1,11,1,0
https://fbref.com/en/players/65c3efa2/Odeluga-Offiah,1,1,1,0,0,0,2,2,0,0,0,0,1,1,0
https://fbref.com/en/players/0bdeb013/Cameron-Peupion,0,0,0,0,0,0,0,0,0,0,0,0,0,0,0
https://fbref.com/en/players/6a713852/Robert-Sanchez,1,0,1,0,0,0,0,0,0,0,0,3,4,9,2
https://fbref.com/en/players/ac0d576d/Jeremy-Sarmiento,6,3,4,1,1,2,5,3,2,0,2,1,7,0,0
https://fbref.com/en/players/28300a16/Jason-Steele,0,0,0,0,0,0,1,1,0,0,0,0,0,6,1
https://fbref.com/en/players/38ceb24a/Leandro-Trossard,10,6,7,1,2,1,8,7,17,0,17,6,16,1,0
https://fbref.com/en/players/dd549382/Deniz-Undav,7,4,2,2,3,2,8,6,4,1,3,0,7,1,0
https://fbref.com/en/players/dad4b285/Joel-Veltman,62,32,44,14,4,37,57,20,27,8,19,19,81,51,0
https://fbref.com/en/players/c40b6180/Adam-Webster,22,12,10,9,3,11,19,8,30,19,11,19,41,55,4
https://fbref.com/en/players/ce5143da/Danny-Welbeck,15,7,0,7,8,4,11,7,24,2,22,5,20,20,0
https://fbref.com/en/players/18abe173/Joseph-Aidoo,51,36,33,17,1,16,28,12,26,14,12,31,82,150,0
https://fbref.com/en/players/7dcf86f6/Iago-Aspas,8,4,0,4,4,3,22,19,10,1,9,7,15,23,0
https://fbref.com/en/players/ed5c5fa3/Fran-Beltran,34,22,15,14,5,14,55,41,29,5,24,53,87,35,2
https://fbref.com/en/players/5e1028e5/Franco-Cervi,76,46,29,36,11,33,66,33,33,1,32,36,112,16,0
https://fbref.com/en/players/3521abfe/Carlos-Dominguez,1,1,0,1,0,1,2,1,1,1,0,0,1,7,0
https://fbref.com/en/players/6db116ec/Pablo-Duran,0,0,0,0,0,0,0,0,2,1,1,1,1,2,0
https://fbref.com/en/players/a4b00319/Javi-Galan,104,72,60,40,4,48,98,50,54,5,49,41,145,63,1
https://fbref.com/en/players/e9241b40/Luca-de-la-Torre,28,19,11,14,3,12,32,20,22,1,21,9,37,6,0
https://fbref.com/en/players/cb574619/Hugo-Mallo,53,29,34,14,5,28,42,14,28,7,21,24,77,73,0
https://fbref.com/en/players/853b7c48/Agustin-Marchesin,0,0,0,0,0,0,1,1,0,0,0,0,0,7,0
https://fbref.com/en/players/d854c9d0/Fernando-Medrano,2,1,2,0,0,1,1,0,0,0,0,1,3,1,0
https://fbref.com/en/players/056269d7/Oscar-Mingueza,37,21,27,9,1,25,32,7,10,4,6,12,49,25,0
https://fbref.com/en/players/be170419/Unai-Nunez,47,35,29,15,3,18,34,16,27,17,10,72,119,135,1
https://fbref.com/en/players/962e54cb/Goncalo-Paciencia,8,5,0,5,3,2,7,5,9,1,8,0,8,4,0
https://fbref.com/en/players/a8f21b9f/Carles-Perez,39,23,12,17,10,22,66,44,29,3,26,6,45,9,0
https://fbref.com/en/players/19709006/Oscar-Rodriguez-Arnaiz,32,25,12,15,5,13,28,15,16,2,14,24,56,15,0
https://fbref.com/en/players/958d67bb/Miguel-Rodriguez,7,5,4,3,0,4,11,7,6,0,6,1,8,3,0
https://fbref.com/en/players/a45eac1f/Haris-Seferovic,6,3,1,4,1,3,8,5,7,1,6,1,7,6,1
https://fbref.com/en/players/3ca6106c/Augusto-Solari,10,6,6,3,1,3,11,8,5,0,5,4,14,3,0
https://fbref.com/en/players/3aa74860/Hugo-Sotelo,0,0,0,0,0,0,0,0,0,0,0,0,0,0,0
https://fbref.com/en/players/f553b2b3/Jorgen-Strand-Larsen,15,7,3,5,7,7,30,23,14,5,9,3,18,24,0
https://fbref.com/en/players/184fe4b2/Williot-Swedberg,3,1,1,0,2,0,0,0,2,0,2,0,3,1,0
https://fbref.com/en/players/34269bdf/Renato-Tapia,47,25,21,21,5,18,37,19,29,11,18,19,66,37,0
https://fbref.com/en/players/ee923664/Kevin-Vazquez,13,8,5,7,1,8,12,4,4,1,3,2,15,8,0
https://fbref.com/en/players/35a6e5c7/Gabriel-Veiga,43,19,14,25,4,16,52,36,30,3,27,21,64,6,0
https://fbref.com/en/players/cde52ef5/Ivan-Villar,0,0,0,0,0,0,1,1,0,0,0,0,0,7,0
https://fbref.com/en/players/28d596a0/Kepa-Arrizabalaga,2,2,2,0,0,2,3,1,0,0,0,1,3,16,2
https://fbref.com/en/players/d5dd5f1f/Pierre-Emerick-Aubameyang,1,0,1,0,0,0,1,1,2,0,2,2,3,4,2
https://fbref.com/en/players/53cad200/Cesar-Azpilicueta,43,25,23,15,5,22,37,15,26,5,21,19,62,54,1
https://fbref.com/en/players/06df8256/Benoit-Badiashile,14,8,10,4,0,9,14,5,5,2,3,16,30,34,1
https://fbref.com/en/players/97220da2/Armando-Broja,4,1,0,3,1,1,1,0,10,1,9,1,5,1,0
https://fbref.com/en/players/5515376c/Trevoh-Chalobah,31,20,22,6,3,24,34,10,17,7,10,24,55,56,1
https://fbref.com/en/players/d2424d1b/Ben-Chilwell,21,17,12,8,1,13,25,12,21,2,19,18,39,26,0
https://fbref.com/en/players/b2f9c73e/Carney-Chukwuemeka,13,7,7,6,0,3,5,2,7,0,7,6,19,1,0
https://fbref.com/en/players/1daec722/Marc-Cucurella,66,33,40,15,11,30,60,30,28,8,20,16,82,48,1
https://fbref.com/en/players/e82900ef/David-Datro-Fofana,3,1,1,1,1,1,1,0,1,0,1,0,3,0,0
https://fbref.com/en/players/8aafd64f/Joao-Felix,14,7,5,6,3,4,12,8,3,0,3,1,15,1,1
https://fbref.com/en/players/5ff4ab71/Enzo-Fernandez,45,27,25,17,3,21,56,35,32,2,30,16,61,12,1
https://fbref.com/en/players/132a82f1/Wesley-Fofana,30,18,19,7,4,13,26,13,17,10,7,20,50,33,2
https://fbref.com/en/players/c2731c10/Conor-Gallagher,46,33,17,19,10,10,37,27,41,10,31,23,69,18,1
https://fbref.com/en/players/da011f18/Lewis-Hall,23,12,19,4,0,15,22,7,8,0,8,11,34,11,1
https://fbref.com/en/players/fed7cb61/Kai-Havertz,34,16,4,20,10,10,30,20,28,0,28,7,41,41,0
https://fbref.com/en/players/bd9553e6/Omari-Hutchinson,0,0,0,0,0,0,0,0,0,0,0,1,1,0,0
https://fbref.com/en/players/1265a93a/Reece-James,31,20,10,18,3,15,19,4,17,2,15,12,43,23,0
https://fbref.com/en/players/45db685d/Jorginho,42,23,22,14,6,22,46,24,18,3,15,21,63,7,0
https://fbref.com/en/players/b9fbae28/NGolo-Kante,16,10,4,10,2,4,8,4,11,0,11,6,22,2,0
https://fbref.com/en/players/da974c7b/Kalidou-Koulibaly,45,31,34,8,3,26,40,14,30,13,17,29,74,77,0
https://fbref.com/en/players/79c0821a/Mateo-Kovacic,36,24,16,14,6,14,36,22,10,1,9,19,55,16,0
https://fbref.com/en/players/e97fd090/Ruben-Loftus-Cheek,25,14,8,14,3,12,21,9,15,2,13,12,37,23,0
https://fbref.com/en/players/bf34eebd/Noni-Madueke,12,8,5,4,3,6,13,7,13,2,11,4,16,7,0
https://fbref.com/en/players/33887998/Edouard-Mendy,0,0,0,0,0,0,0,0,0,0,0,0,0,3,3
https://fbref.com/en/players/9674002f/Mason-Mount,33,19,6,16,11,14,27,13,24,6,18,8,41,9,0
https://fbref.com/en/players/049a888d/Mykhailo-Mudryk,11,9,2,4,5,4,13,9,7,1,6,0,11,3,0
https://fbref.com/en/players/1bf33a9a/Christian-Pulisic,11,6,3,6,2,3,5,2,8,1,7,4,15,4,0
https://fbref.com/en/players/86e7deaf/Thiago-Silva,41,27,24,17,0,21,31,10,38,29,9,34,75,111,2
https://fbref.com/en/players/b400bde0/Raheem-Sterling,18,10,5,4,9,8,14,6,17,0,17,2,20,5,0
https://fbref.com/en/players/384d58d9/Denis-Zakaria,9,5,5,2,2,2,8,6,4,1,3,3,12,10,0
https://fbref.com/en/players/6622454d/Hakim-Ziyech,20,12,12,5,3,4,9,5,8,0,8,5,25,5,1
https://fbref.com/en/players/1956b948/Jim-Allevinah,39,24,24,11,4,19,62,43,24,2,22,24,63,26,1
https://fbref.com/en/players/af3ddb2e/Komnen-Andric,13,5,2,7,4,2,15,13,8,1,7,8,21,13,0
https://fbref.com/en/players/7e3e825e/Brandon-Baiye,3,2,2,1,0,2,3,1,1,0,1,1,4,3,0
https://fbref.com/en/players/5680bf3f/Jeremie-Bela,6,4,2,1,3,3,4,1,10,1,9,9,15,8,0
https://fbref.com/en/players/03e91055/Jason-Berthomier,0,0,0,0,0,0,0,0,0,0,0,0,0,0,0
https://fbref.com/en/players/a3e1d20d/Jean-Claude-Billong,0,0,0,0,0,0,0,0,1,1,0,1,1,0,0
https://fbref.com/en/players/9f936061/Neto-Borges,75,45,45,20,10,46,75,29,45,11,34,41,116,62,1
https://fbref.com/en/players/c92c24f0/Maximiliano-Caufriez,40,24,31,8,1,20,28,8,33,18,15,34,74,70,0
https://fbref.com/en/players/ff4d0258/Souleymane-Cisse,1,1,1,0,0,1,1,0,1,1,0,1,2,2,0
https://fbref.com/en/players/fb55f63a/Baila-Diallo,1,0,1,0,0,0,0,0,1,1,0,0,1,1,0
https://fbref.com/en/players/f41a69e6/Mory-Diaw,0,0,0,0,0,0,4,4,0,0,0,2,2,13,5
https://fbref.com/en/players/62124972/Ouparine-Djoco,0,0,0,0,0,0,0,0,0,0,0,0,0,1,0
https://fbref.com/en/players/a1dbfcb1/Jodel-Dossou,7,4,3,2,2,4,4,0,2,1,1,1,8,0,0
https://fbref.com/en/players/868eaba0/Johan-Gastien,62,34,30,23,9,38,111,73,37,7,30,36,98,25,1
https://fbref.com/en/players/b8c1de25/Maxime-Gonalons,52,32,25,21,6,25,53,28,21,1,20,20,72,7,1
https://fbref.com/en/players/796b1c41/Saif-Eddine-Khaoui,47,28,14,25,8,15,47,32,17,2,15,33,80,8,0
https://fbref.com/en/players/1361e5bc/Cheick-Konate,19,12,10,7,2,13,22,9,7,1,6,13,32,8,1
https://fbref.com/en/players/397ba086/Grejohn-Kyei,16,7,2,9,5,4,13,9,14,3,11,6,22,22,0
https://fbref.com/en/players/caa7aaea/Yohann-Magnin,89,54,37,45,7,54,106,52,50,12,38,25,114,46,0
https://fbref.com/en/players/6ea05ca7/Yanis-Massolin,2,1,1,0,1,0,1,1,1,0,1,2,4,0,0
https://fbref.com/en/players/87d31635/Aiman-Maurer,2,1,1,1,0,1,10,9,1,0,1,3,5,5,0
https://fbref.com/en/players/9f0f4b49/Arial-Mendy,4,2,3,0,1,2,2,0,2,0,2,4,8,4,0
https://fbref.com/en/players/6993927b/Florent-Ogier,33,16,20,12,1,22,39,17,22,13,9,18,51,64,1
https://fbref.com/en/players/25749008/Elba-Rashani,39,26,13,19,7,13,39,26,27,2,25,21,60,19,0
https://fbref.com/en/players/f527a32c/Muhammed-Saracevic-Cham,30,15,15,4,11,13,35,22,13,0,13,7,37,5,0
https://fbref.com/en/players/cea59f02/Alidu-Seidu,52,31,35,14,3,31,51,20,28,14,14,52,104,50,2
https://fbref.com/en/players/3ecc8c5f/Mateusz-Wieteska,41,23,28,13,0,19,33,14,44,28,16,56,97,97,4
https://fbref.com/en/players/c8c02ac7/Mehdi-Zeffane,12,7,5,7,0,4,21,17,14,6,8,22,34,12,0
https://fbref.com/en/players/771a2cfe/Christian-Acella,1,0,1,0,0,0,2,2,0,0,0,0,1,0,0
https://fbref.com/en/players/0154d290/Felix-Afena-Gyan,7,3,4,1,2,2,10,8,5,1,4,1,8,6,0
https://fbref.com/en/players/d810c13b/Emanuel-Aiwum,55,34,36,17,2,33,47,14,28,16,12,25,80,52,3
https://fbref.com/en/players/e26fcca3/Santiago-Ascacibar,29,14,17,10,2,14,35,21,14,2,12,13,42,11,0
https://fbref.com/en/players/dfd24c07/Jaime-Baez,4,2,3,0,1,3,6,3,0,0,0,0,4,2,1
https://fbref.com/en/players/2ce215f2/Alberto-Basso,0,0,0,0,0,0,0,0,0,0,0,0,0,0,0
https://fbref.com/en/players/0000acda/Marco-Benassi,26,15,9,11,6,15,24,9,13,1,12,12,38,19,0
https://fbref.com/en/players/b3a20f18/Matteo-Bianchetti,32,19,21,9,2,20,32,12,31,17,14,20,52,111,0
https://fbref.com/en/players/f3a9fa26/Cristian-Buonaiuto,25,16,8,11,6,12,26,14,11,0,11,14,39,7,0
https://fbref.com/en/players/8ec56e62/Marco-Carnesecchi,1,1,1,0,0,1,2,1,0,0,0,0,1,11,2
https://fbref.com/en/players/ad92526f/Michele-Castagnetti,46,21,20,24,2,18,54,36,14,4,10,15,61,22,0
https://fbref.com/en/players/c316607a/Vlad-Chiriches,35,20,27,7,1,16,24,8,36,23,13,22,57,44,0
https://fbref.com/en/players/b09a3ecc/Daniel-Ciofani,6,3,1,2,3,4,7,3,7,1,6,2,8,10,0
https://fbref.com/en/players/dcb38abe/Cyriel-Dessers,11,4,4,4,3,2,6,4,14,2,12,3,14,5,0
https://fbref.com/en/players/ef94dc2f/Samuel-Di-Carmine,0,0,0,0,0,0,0,0,0,0,0,0,0,0,0
https://fbref.com/en/players/3f79a1c8/Gonzalo-Escalante,16,8,8,8,0,10,13,3,7,1,6,10,26,4,0
https://fbref.com/en/players/d0dbca9f/Alex-Ferrari,40,23,32,7,1,28,42,14,19,4,15,25,65,45,1
https://fbref.com/en/players/dd403465/Pablo-Galdames-Millan,14,10,8,3,3,5,33,28,13,2,11,10,24,13,0
https://fbref.com/en/players/71dc23da/Paolo-Ghiglione,16,11,10,3,3,10,23,13,9,4,5,4,20,12,0
https://fbref.com/en/players/ffed43e3/Jack-Hendry,0,0,0,0,0,0,1,1,2,1,1,1,1,7,0
https://fbref.com/en/players/c8ad0857/Luka-Lochoshvili,45,19,30,11,4,22,31,9,31,10,21,22,67,89,0
https://fbref.com/en/players/5cec2c74/Soualiho-Meite,47,31,25,15,7,22,46,24,27,6,21,27,74,36,0
https://fbref.com/en/players/b2561711/Tommaso-Milanese,0,0,0,0,0,0,0,0,1,1,0,0,0,0,0
https://fbref.com/en/players/d125f22f/David-Okereke,12,8,4,5,3,3,16,13,23,3,20,10,22,12,0
https://fbref.com/en/players/f71ad8cb/Charles-Pickel,55,23,25,26,4,32,57,25,37,5,32,24,79,36,1
https://fbref.com/en/players/1b9c7401/Giacomo-Quagliata,10,8,7,1,2,5,11,6,7,2,5,11,21,8,0
https://fbref.com/en/players/67f649be/Ionut-Radu,0,0,0,0,0,0,0,0,0,0,0,0,0,1,3
https://fbref.com/en/players/b959a0d1/Mouhamadou-Sarr,0,0,0,0,0,0,0,0,0,0,0,0,0,2,0
https://fbref.com/en/players/dd7febd8/Leonardo-Sernicola,45,33,25,13,7,29,43,14,23,6,17,38,83,55,0
https://fbref.com/en/players/0588a092/Frank-Tsadjout,10,8,3,6,1,3,9,6,7,1,6,8,18,9,0
https://fbref.com/en/players/ec52b661/Emanuele-Valeri,54,27,29,21,4,29,69,40,17,3,14,22,76,44,1
https://fbref.com/en/players/5eaed77a/Johan-Vasquez,41,26,34,7,0,18,39,21,27,20,7,45,86,93,1
https://fbref.com/en/players/5e834dce/Luca-Zanimacchia,21,13,11,6,4,8,21,13,9,0,9,9,30,5,0
https://fbref.com/en/players/a6c58494/Naouirou-Ahamada,3,2,3,0,0,1,3,2,2,0,2,0,3,0,0
https://fbref.com/en/players/e34fc66d/Joachim-Andersen,42,22,30,12,0,16,32,16,28,13,15,24,66,188,0
https://fbref.com/en/players/da052c14/Jordan-Ayew,66,41,23,20,23,21,53,32,35,4,31,15,81,31,0
https://fbref.com/en/players/0442183b/Nathaniel-Clyne,27,16,13,9,5,14,23,9,22,4,18,19,46,34,0
https://fbref.com/en/players/ce4f40c7/Cheick-Doucoure,77,46,40,33,4,29,52,23,47,13,34,56,133,48,0
https://fbref.com/en/players/fa9fa773/Malcolm-Ebiowei,1,1,1,0,0,0,1,1,2,0,2,0,1,0,0
https://fbref.com/en/players/0562b7f1/Odsonne-Edouard,25,13,7,12,6,7,13,6,17,5,12,3,28,22,0
https://fbref.com/en/players/ae4fc6a4/Eberechi-Eze,42,24,17,18,7,18,38,20,22,0,22,13,55,10,0
https://fbref.com/en/players/ab13a5aa/Vicente-Guaita,0,0,0,0,0,0,0,0,0,0,0,0,0,9,1
https://fbref.com/en/players/d0706b27/Marc-Guehi,52,27,39,11,2,26,42,16,45,24,21,45,97,134,3
https://fbref.com/en/players/a0666d3e/Will-Hughes,29,16,11,16,2,11,20,9,16,7,9,16,45,9,0
https://fbref.com/en/players/9e5708be/Sam-Johnstone,0,0,0,0,0,0,0,0,0,0,0,0,0,5,0
https://fbref.com/en/players/50e6dc35/Jean-Philippe-Mateta,7,1,2,4,1,1,3,2,3,1,2,3,10,18,0
https://fbref.com/en/players/cee31595/James-McArthur,1,1,1,0,0,1,1,0,2,1,1,1,2,2,0
https://fbref.com/en/players/2ce2508a/Luka-Milivojevic,13,7,7,4,2,7,10,3,13,4,9,12,25,10,0
https://fbref.com/en/players/5cbd1eb0/Tyrick-Mitchell,71,49,43,23,5,30,53,23,48,11,37,42,113,78,0
https://fbref.com/en/players/c4486bac/Michael-Olise,58,34,28,26,4,25,60,35,46,1,45,26,84,17,0
https://fbref.com/en/players/d00d45ab/David-Ozoh,0,0,0,0,0,0,0,0,0,0,0,0,0,0,0
https://fbref.com/en/players/0a3d6d2b/Chris-Richards,9,6,8,1,0,5,7,2,10,1,9,8,17,31,0
https://fbref.com/en/players/7a1f2c08/Jairo-Riedewald,2,1,2,0,0,0,1,1,2,0,2,0,2,4,0
https://fbref.com/en/players/1b4f1169/Albert-Sambi-Lokonga,13,10,7,4,2,8,12,4,8,3,5,7,20,10,0
https://fbref.com/en/players/3312f911/Jeffrey-Schlupp,66,46,28,29,9,22,43,21,39,8,31,23,89,38,0
https://fbref.com/en/players/e7ca0439/James-Tomkins,4,2,2,1,1,1,3,2,3,2,1,5,9,19,0
https://fbref.com/en/players/8a7ff278/Joel-Ward,50,36,30,11,9,30,41,11,32,16,16,25,75,80,1
https://fbref.com/en/players/3f847d95/Joseph-Whitworth,0,0,0,0,0,0,0,0,0,0,0,0,0,1,0
https://fbref.com/en/players/b2bc3b1f/Wilfried-Zaha,32,20,12,12,8,8,21,13,21,1,20,16,48,9,0
https://fbref.com/en/players/99ea2ddd/Tomas-Alarcon,3,2,0,2,1,1,2,1,1,0,1,2,5,2,0
https://fbref.com/en/players/036bba5f/Ruben-Alcaraz,43,31,24,18,1,19,54,35,23,8,15,19,62,37,0
https://fbref.com/en/players/3d7e48ce/Ivan-Alejo,32,21,19,9,4,17,37,20,18,3,15,5,37,12,1
https://fbref.com/en/players/62a583ee/Jose-Antonio,2,1,0,0,2,0,0,0,0,0,0,0,2,0,0
https://fbref.com/en/players/759d8dd7/Santiago-Arzamendia,9,8,7,1,1,6,21,15,11,1,10,2,11,15,1
https://fbref.com/en/players/506daeac/Blanco,6,4,5,1,0,4,6,2,5,0,5,1,7,3,0
https://fbref.com/en/players/0da6a13e/Theo-Bongonda,28,20,11,14,3,17,40,23,21,2,19,6,34,14,0
https://fbref.com/en/players/fe05804b/Cala,2,1,1,1,0,1,2,1,2,1,1,1,3,12,0
https://fbref.com/en/players/c4b888df/Isaac-Carcelen,69,51,41,22,6,41,63,22,35,11,24,19,88,80,1
https://fbref.com/en/players/ec1a731e/Victor-Chust,9,6,7,2,0,4,7,3,8,3,5,10,19,53,0
https://fbref.com/en/players/80211dc5/Mamady-Diarra,2,1,2,0,0,1,2,1,2,0,2,0,2,0,0
https://fbref.com/en/players/d61759ec/Youba-Diarra,3,0,2,1,0,1,5,4,7,1,6,2,5,3,0
https://fbref.com/en/players/3f79a1c8/Gonzalo-Escalante,36,24,15,20,1,15,29,14,18,4,14,17,53,26,1
https://fbref.com/en/players/db001fa9/Alfonso-Espino,87,56,55,20,12,48,96,48,52,11,41,48,135,99,3
https://fbref.com/en/players/72a84002/Fali,27,19,19,8,0,18,29,11,24,15,9,13,40,70,1
https://fbref.com/en/players/aa677a35/Alex-Fernandez,13,7,6,4,3,4,14,10,14,1,13,8,21,19,0
https://fbref.com/en/players/661e2822/Carlos-Garcia,0,0,0,0,0,0,0,0,0,0,0,0,0,2,0
https://fbref.com/en/players/fea23125/David-Gil,0,0,0,0,0,0,0,0,0,0,0,0,0,3,0
https://fbref.com/en/players/18017beb/Alvaro-Gimenez,0,0,0,0,0,0,1,1,0,0,0,0,0,0,0
https://fbref.com/en/players/32974271/Sergi-Guardiola,9,7,0,6,3,3,12,9,5,0,5,3,12,7,0
https://fbref.com/en/players/02d2c436/Luis-Hernandez,33,21,25,7,1,22,36,14,31,24,7,31,64,145,0
https://fbref.com/en/players/6c4776b1/Jeremias-Ledesma,3,2,3,0,0,3,7,4,1,0,1,2,5,23,3
https://fbref.com/en/players/38699c72/Anthony-Lozano,6,4,1,4,1,1,7,6,12,1,11,3,9,17,0
https://fbref.com/en/players/922da988/Awer-Mabil,2,0,0,1,1,1,3,2,1,1,0,0,2,1,0
https://fbref.com/en/players/6f4c734d/Jose-Mari,16,7,12,3,1,10,16,6,3,1,2,5,21,9,0
https://fbref.com/en/players/0ae4e09a/Roger-Marti,6,4,2,3,1,1,8,7,7,0,7,2,8,7,0
https://fbref.com/en/players/8aae94b9/Mamadou-Mbaye,10,7,7,3,0,6,8,2,10,8,2,7,17,50,1
https://fbref.com/en/players/9f979eb2/Jorge-Mere,11,7,9,2,0,5,8,3,9,6,3,6,17,32,0
https://fbref.com/en/players/dfe5caa2/Francisco-Mwepu,1,0,0,1,0,0,0,0,0,0,0,0,1,0,0
https://fbref.com/en/players/63b0ca6b/Alvaro-Negredo,5,4,1,2,2,2,2,0,4,1,3,0,5,8,0
https://fbref.com/en/players/2e3995cd/Brian-Ocampo,18,15,12,5,1,8,21,13,13,0,13,3,21,3,0
https://fbref.com/en/players/647d39d2/Raul-Parra,4,2,4,0,0,4,9,5,5,3,2,1,5,9,0
https://fbref.com/en/players/5496cc91/Alberto-Perea,2,0,2,0,0,0,0,0,2,0,2,0,2,0,0
https://fbref.com/en/players/a300ac7e/Lucas-Perez,3,2,2,1,0,1,3,2,2,0,2,1,4,3,0
https://fbref.com/en/players/44e07fac/Chris-Ramos,12,9,2,7,3,4,11,7,8,3,5,1,13,19,0
https://fbref.com/en/players/efecd633/Fede-San-Emeterio,41,22,23,16,2,22,46,24,34,14,20,17,58,28,0
https://fbref.com/en/players/19b776e9/Ruben-Sobrino,55,37,29,17,9,23,56,33,33,3,30,24,79,20,1
https://fbref.com/en/players/5ca20b7a/Joseba-Zaldua,15,8,10,4,1,7,10,3,4,2,2,11,26,22,0
https://fbref.com/en/players/501055d8/Karim-Adeyemi,16,11,6,6,4,8,30,22,18,1,17,7,23,3,0
https://fbref.com/en/players/57d88cf9/Jude-Bellingham,76,42,28,34,14,34,51,17,51,4,47,35,111,30,0
https://fbref.com/en/players/a167537f/Julian-Brandt,29,20,6,14,9,12,43,31,23,0,23,15,44,9,1
https://fbref.com/en/players/10745192/Jamie-Bynoe-Gittens,8,4,2,5,1,2,7,5,1,0,1,1,9,2,0
https://fbref.com/en/players/a65ce836/Emre-Can,57,28,25,27,5,22,43,21,16,6,10,25,82,39,1
https://fbref.com/en/players/9dff291c/Soumaila-Coulibaly,0,0,0,0,0,0,0,0,0,0,0,0,0,0,1
https://fbref.com/en/players/db4ed67b/Mahmoud-Dahoud,11,9,3,4,4,7,7,0,6,2,4,7,18,3,0
https://fbref.com/en/players/b06a7ae9/Julien-Duranville,1,1,0,1,0,1,1,0,0,0,0,0,1,0,0
https://fbref.com/en/players/048a1cbc/Raphael-Guerreiro,36,20,13,15,8,21,34,13,21,2,19,36,72,23,0
https://fbref.com/en/players/ba115a40/Sebastien-Haller,5,4,2,1,2,0,4,4,8,0,8,1,6,10,0
https://fbref.com/en/players/50871bcc/Thorgan-Hazard,17,6,5,11,1,12,17,5,6,0,6,5,22,5,0
https://fbref.com/en/players/05d548d8/Mats-Hummels,62,34,38,22,2,32,55,23,30,16,14,33,95,100,1
https://fbref.com/en/players/cd59b9df/Gregor-Kobel,0,0,0,0,0,0,1,1,1,0,1,0,0,7,2
https://fbref.com/en/players/864163f3/Donyell-Malen,13,5,3,4,6,5,12,7,14,1,13,4,17,11,0
https://fbref.com/en/players/e162b013/Thomas-Meunier,16,7,8,5,3,10,17,7,7,2,5,9,25,16,0
https://fbref.com/en/players/b56dd813/Alexander-Meyer,0,0,0,0,0,0,1,1,0,0,0,0,0,1,0
https://fbref.com/en/players/34e4343c/Anthony-Modeste,4,4,2,0,2,2,5,3,7,0,7,2,6,22,0
https://fbref.com/en/players/6ce43701/Youssoufa-Moukoko,13,7,3,6,4,3,6,3,9,0,9,2,15,1,0
https://fbref.com/en/players/a45241d5/Justin-Njinmah,0,0,0,0,0,0,0,0,0,0,0,0,0,0,0
https://fbref.com/en/players/15413fa5/Salih-Ozcan,31,18,10,16,5,16,39,23,24,2,22,28,59,19,1
https://fbref.com/en/players/13d23b29/Antonios-Papadopoulos,0,0,0,0,0,0,0,0,0,0,0,1,1,0,0
https://fbref.com/en/players/1866b0f1/Marco-Pasalic,0,0,0,0,0,0,0,0,0,0,0,0,0,0,0
https://fbref.com/en/players/5c899683/Felix-Passlack,4,3,0,4,0,1,1,0,1,1,0,0,4,1,0
https://fbref.com/en/players/36a3ff67/Marco-Reus,30,17,12,14,4,7,24,17,12,4,8,8,38,8,0
https://fbref.com/en/players/7fa4e703/Gio-Reyna,14,7,2,5,7,5,10,5,8,2,6,3,17,5,0
https://fbref.com/en/players/90c1f9a4/Tom-Rothe,1,1,0,1,0,1,1,0,0,0,0,1,2,2,0
https://fbref.com/en/players/009a4f60/Julian-Ryerson,27,15,17,7,3,19,37,18,13,2,11,8,35,28,0
https://fbref.com/en/players/34e12499/Nico-Schlotterbeck,59,34,34,24,1,37,53,16,38,21,17,32,91,71,1
https://fbref.com/en/players/e33c06cf/Niklas-Sule,25,19,18,3,4,14,23,9,28,19,9,17,42,53,0
https://fbref.com/en/players/fa661778/Marius-Wolf,25,18,9,12,4,16,29,13,40,10,30,18,43,22,1
https://fbref.com/en/players/4cd41883/Paxten-Aaronson,6,5,2,2,2,2,3,1,2,1,1,0,6,2,0
https://fbref.com/en/players/834d0be5/Lucas-Alario,3,2,1,0,2,0,1,1,0,0,0,2,5,13,0
https://fbref.com/en/players/00f518d8/Faride-Alidou,8,5,3,4,1,3,9,6,3,0,3,1,9,3,0
https://fbref.com/en/players/c68da769/Rafael-Borre,25,15,4,13,8,4,17,13,10,2,8,2,27,9,0
https://fbref.com/en/players/b4705807/Aurelio-Buta,33,19,15,13,5,15,27,12,18,1,17,9,42,34,0
https://fbref.com/en/players/b3b7f5a6/Timothy-Chandler,2,2,2,0,0,2,2,0,1,0,1,0,2,3,0
https://fbref.com/en/players/95bb6ddc/Junior-Dina-Ebimbe,30,19,16,14,0,16,33,17,18,5,13,11,41,20,0
https://fbref.com/en/players/277be51d/Dario-Gebuhr,0,0,0,0,0,0,1,1,0,0,0,0,0,0,0
https://fbref.com/en/players/9efa1d25/Mario-Gotze,42,25,13,22,7,14,47,33,25,0,25,13,55,12,0
https://fbref.com/en/players/9ab16552/Makoto-Hasebe,18,12,16,2,0,7,22,15,22,9,13,17,35,45,0
https://fbref.com/en/players/a8ee54ad/Kristijan-Jakic,33,21,19,12,2,22,41,19,32,10,22,14,47,49,1
https://fbref.com/en/players/15b287da/Daichi-Kamada,51,31,10,37,4,31,57,26,31,2,29,16,67,17,1
https://fbref.com/en/players/19a967ab/Ansgar-Knauff,36,25,22,11,3,15,34,19,19,1,18,15,51,26,0
https://fbref.com/en/players/c0b3669f/Randal-Kolo-Muani,14,10,3,3,8,1,9,8,19,2,17,3,17,13,0
https://fbref.com/en/players/b1cd37e6/Filip-Kostic,2,0,1,1,0,0,0,0,0,0,0,1,3,0,0
https://fbref.com/en/players/bbd86530/Christopher-Lenz,29,21,17,7,5,16,37,21,16,3,13,21,50,34,0
https://fbref.com/en/players/37dc1a48/Jesper-Lindstrom,26,11,15,7,4,7,22,15,25,3,22,9,35,9,0
https://fbref.com/en/players/826e8b63/Philipp-Max,12,9,4,7,1,5,16,11,10,2,8,3,15,11,0
https://fbref.com/en/players/441197b8/Obite-NDicka,25,18,10,11,4,18,32,14,47,19,28,31,56,150,0
https://fbref.com/en/players/3b61c9ec/Luca-Pellegrini,13,8,10,3,0,8,8,0,8,2,6,7,20,11,1
https://fbref.com/en/players/b90c4a43/Diant-Ramaj,0,0,0,0,0,0,0,0,0,0,0,0,0,1,0
https://fbref.com/en/players/e12b0b5b/Sebastian-Rode,38,24,7,28,3,14,45,31,18,2,16,16,54,12,0
https://fbref.com/en/players/c967f6b8/Hrvoje-Smolcic,8,7,6,2,0,5,10,5,11,4,7,6,14,38,0
https://fbref.com/en/players/4c6facae/Djibril-Sow,41,25,13,25,3,22,44,22,22,4,18,28,69,23,0
https://fbref.com/en/players/c8c60119/Almamy-Toure,13,7,7,5,1,5,9,4,9,2,7,10,23,8,0
https://fbref.com/en/players/ce17b5eb/Kevin-Trapp,1,1,1,0,0,0,2,2,2,0,2,0,1,10,0
https://fbref.com/en/players/35d64857/Tuta,53,35,27,19,7,33,57,24,47,14,33,49,102,134,2
https://fbref.com/en/players/1c86aa16/Marcel-Wenig,0,0,0,0,0,0,0,0,0,0,0,0,0,0,0
https://fbref.com/en/players/b907d169/Alejandro-Alfaro,0,0,0,0,0,0,0,0,0,0,0,0,0,0,0
https://fbref.com/en/players/e4346678/Edgar-Badia,1,0,1,0,0,1,2,1,0,0,0,0,1,19,3
https://fbref.com/en/players/697295b1/Pedro-Bigas,37,20,30,7,0,18,29,11,25,14,11,33,70,95,0
https://fbref.com/en/players/1657f448/Lautaro-Blanco,16,9,10,4,2,9,26,17,8,1,7,2,18,10,1
https://fbref.com/en/players/d49f3e6b/Lucas-Boye,36,16,12,16,8,17,35,18,33,5,28,15,51,46,0
https://fbref.com/en/players/2dce876a/Carmona,16,9,7,6,3,6,16,10,14,2,12,8,24,9,0
https://fbref.com/en/players/873ce3a2/Pape-Cheikh-Diop,0,0,0,0,0,0,1,1,0,0,0,0,0,0,0
https://fbref.com/en/players/33a61a52/Carlos-Clerc,75,51,55,16,4,31,50,19,29,7,22,28,103,94,1
https://fbref.com/en/players/85dace26/Alex-Collado,26,14,13,11,2,8,13,5,12,1,11,2,28,4,0
https://fbref.com/en/players/5e95c000/John-Donald,20,11,9,9,2,7,14,7,14,7,7,14,34,23,1
https://fbref.com/en/players/3409de86/Nicolas-Ezequiel-Fernandez,23,12,10,7,6,9,17,8,7,0,7,5,28,2,1
https://fbref.com/en/players/f25b010f/Federico-Fernandez,1,1,1,0,0,1,1,0,0,0,0,2,3,12,0
https://fbref.com/en/players/eb82b6f1/Fidel,15,10,8,5,2,4,38,34,9,0,9,5,20,8,0
https://fbref.com/en/players/4ac7608e/Diego-Gonzalez,12,7,9,3,0,7,11,4,14,12,2,7,19,50,1
https://fbref.com/en/players/ac454a4f/Gerard-Gumbau,44,25,17,23,4,18,51,33,32,8,24,28,72,40,0
https://fbref.com/en/players/0b2c8585/Raul-Guti,18,12,8,9,1,8,18,10,10,3,7,8,26,6,0
https://fbref.com/en/players/5b28b2f6/Josan,25,20,20,5,0,14,27,13,8,0,8,7,32,15,1
https://fbref.com/en/players/ff800ed8/Pol-Lirola,13,6,9,3,1,8,13,5,3,2,1,7,20,16,0
https://fbref.com/en/players/01a49bd2/Lisandro-Magallan,19,11,11,5,3,10,12,2,14,5,9,13,32,30,1
https://fbref.com/en/players/0ae4e09a/Roger-Marti,5,2,3,2,0,1,5,4,4,0,4,1,6,7,0
https://fbref.com/en/players/11fd2b75/Omar-Mascarell,53,26,32,19,2,31,64,33,51,19,32,45,98,54,1
https://fbref.com/en/players/335039a2/Pere-Milla,31,20,18,8,5,14,41,27,18,3,15,9,40,19,1
https://fbref.com/en/players/608f2092/Johan-Mojica,6,3,5,1,0,2,3,1,3,2,1,4,10,5,0
https://fbref.com/en/players/004d185e/Tete-Morente,33,21,18,13,2,15,36,21,23,3,20,25,58,28,0
https://fbref.com/en/players/a6103274/Randy-Ntekja,15,10,7,6,2,2,11,9,15,3,12,4,19,9,0
https://fbref.com/en/players/ac8b2421/Helibelton-Palacios,38,20,21,15,2,19,26,7,26,12,14,20,58,55,0
https://fbref.com/en/players/881ef58c/Javier-Pastore,0,0,0,0,0,0,0,0,0,0,0,0,0,0,0
https://fbref.com/en/players/ccbbe661/Ezequiel-Ponce,9,7,0,6,3,0,7,7,6,1,5,1,10,13,0
https://fbref.com/en/players/41fb0f4e/Domingos-Quina,3,2,2,1,0,1,3,2,5,0,5,3,6,1,0
https://fbref.com/en/players/37f827ec/Enzo-Roco,33,13,23,10,0,15,24,9,22,15,7,17,50,63,1
https://fbref.com/en/players/1c2c55fc/Gonzalo-Verdu,10,5,8,2,0,4,8,4,8,6,2,10,20,33,0
https://fbref.com/en/players/c0b1a6da/Axel-Werner,0,0,0,0,0,0,1,1,0,0,0,0,0,0,0
https://fbref.com/en/players/fdf4b948/Jean-Daniel-Akpa-Akpro,53,37,25,19,9,23,42,19,35,4,31,13,66,27,0
https://fbref.com/en/players/f42d6c13/Nedim-Bajrami,8,4,3,3,2,4,6,2,5,0,5,7,15,4,0
https://fbref.com/en/players/102e2599/Tommaso-Baldanzi,25,12,9,13,3,7,32,25,21,1,20,2,27,5,0
https://fbref.com/en/players/d44360be/Filippo-Bandinelli,55,34,19,26,10,17,45,28,20,7,13,18,73,40,0
https://fbref.com/en/players/dd86e8e4/Liberato-Cacace,25,10,12,8,5,9,15,6,15,7,8,4,29,16,0
https://fbref.com/en/players/91ff775f/Nicolo-Cambiaghi,30,22,11,12,7,8,27,19,19,1,18,9,39,8,0
https://fbref.com/en/players/5bd72174/Francesco-Caputo,2,2,0,1,1,0,1,1,7,2,5,2,4,8,0
https://fbref.com/en/players/f4797849/Koni-De-Winter,14,9,11,3,0,5,13,8,14,12,2,6,20,65,0
https://fbref.com/en/players/0e0d6c53/Duccio-DeglInnocenti,0,0,0,0,0,0,0,0,0,0,0,1,1,0,0
https://fbref.com/en/players/d7d32194/Mattia-Destro,1,1,0,1,0,0,0,0,2,0,2,1,2,5,0
https://fbref.com/en/players/6af30900/Tyronne-Ebuehi,22,14,11,7,4,9,13,4,23,12,11,12,34,79,1
https://fbref.com/en/players/c20892ee/Emmanuel-Ekong,0,0,0,0,0,0,0,0,0,0,0,0,0,0,0
https://fbref.com/en/players/06b08c45/Jacopo-Fazzini,31,17,20,8,3,18,34,16,15,3,12,7,38,19,0
https://fbref.com/en/players/6cc97b6a/Alberto-Grassi,26,21,13,13,0,15,24,9,23,12,11,27,53,45,0
https://fbref.com/en/players/fa449bba/Nicolas-Haas,27,13,16,6,5,12,24,12,16,4,12,8,35,27,0
https://fbref.com/en/players/d7918b13/Liam-Henderson,13,10,6,5,2,4,21,17,10,2,8,10,23,10,0
https://fbref.com/en/players/6b635f5c/Ardian-Ismajli,40,32,25,15,0,18,24,6,47,31,16,27,67,120,0
https://fbref.com/en/players/c283ddef/Sam-Lammers,20,10,5,9,6,7,11,4,4,1,3,3,23,8,0
https://fbref.com/en/players/997fff07/Sebastiano-Luperto,33,18,24,8,1,9,20,11,54,42,12,43,76,163,1
https://fbref.com/en/players/7fac99d4/Razvan-Marin,44,22,22,21,1,19,40,21,29,11,18,14,58,33,0
https://fbref.com/en/players/c39babc1/Herculano-Nabian,0,0,0,0,0,0,0,0,0,0,0,0,0,0,0
https://fbref.com/en/players/0967845b/Fabiano-Parisi,65,35,37,21,7,30,72,42,51,16,35,41,106,91,0
https://fbref.com/en/players/00a17eba/Samuele-Perisan,0,0,0,0,0,0,0,0,0,0,0,0,0,2,0
https://fbref.com/en/players/1cadaf34/Roberto-Piccoli,1,1,1,0,0,0,3,3,4,1,3,1,2,9,0
https://fbref.com/en/players/2c38b327/Marko-Pjaca,4,3,3,1,0,3,5,2,3,0,3,3,7,3,0
https://fbref.com/en/players/86383d0e/Martin-Satriano,13,8,5,6,2,6,14,8,5,0,5,3,16,22,0
https://fbref.com/en/players/13b44b02/Petar-Stojanovic,42,22,28,10,4,26,43,17,17,5,12,11,53,55,0
https://fbref.com/en/players/8cc29864/Lorenzo-Tonelli,0,0,0,0,0,0,1,1,0,0,0,0,0,0,0
https://fbref.com/en/players/96640846/Samir-Ujkani,0,0,0,0,0,0,0,0,0,0,0,0,0,0,0
https://fbref.com/en/players/77d6fd4d/Guglielmo-Vicario,1,1,1,0,0,1,2,1,0,0,0,0,1,15,2
https://fbref.com/en/players/ec5dae45/Emanuel-Vignato,2,0,2,0,0,0,0,0,0,0,0,0,2,1,0
https://fbref.com/en/players/217875a4/Sebastian-Walukiewicz,9,6,7,2,0,4,6,2,10,9,1,7,16,30,0
https://fbref.com/en/players/03049c8c/Keidi-Bare,15,8,7,5,3,7,13,6,8,2,6,11,26,8,0
https://fbref.com/en/players/7f271d74/Wassim-Boullif,3,1,3,0,0,2,3,1,5,4,1,0,3,3,0
https://fbref.com/en/players/fd771f95/Martin-Braithwaite,12,2,2,4,6,5,14,9,10,0,10,5,17,11,0
https://fbref.com/en/players/69cbc8b6/Leandro-Cabrera,46,24,34,12,0,28,43,15,37,23,14,43,89,114,2
https://fbref.com/en/players/41b3069f/Fernando-Calero,46,29,27,15,4,21,34,13,31,13,18,13,59,52,0
https://fbref.com/en/players/5b93209a/Jose-Carlos-Lazo,5,3,2,2,1,3,3,0,2,0,2,3,8,5,0
https://fbref.com/en/players/070a3904/Sergi-Darder,69,38,12,43,14,29,73,44,34,2,32,24,93,23,0
https://fbref.com/en/players/db8f0eba/Adri-Embarba,1,0,0,1,0,1,1,0,1,0,1,0,1,0,0
https://fbref.com/en/players/283c7121/Edu-Exposito,34,20,16,15,3,13,23,10,7,0,7,12,46,20,0
https://fbref.com/en/players/f127d782/Alvaro-Fernandez,0,0,0,0,0,0,0,0,0,0,0,0,0,7,2
https://fbref.com/en/players/87b498b0/Joan-Garcia,0,0,0,0,0,0,0,0,0,0,0,0,0,0,0
https://fbref.com/en/players/6652cf96/Oscar-Gil,63,37,38,16,9,32,61,29,51,18,33,31,94,55,1
https://fbref.com/en/players/0e5ddc7c/Dani-Gomez,2,1,1,1,0,1,2,1,0,0,0,1,3,0,0
https://fbref.com/en/players/bc6f5f06/Sergi-Gomez,29,16,20,9,0,18,22,4,33,19,14,27,56,125,1
https://fbref.com/en/players/ee45d138/Jose-Gragera,19,9,11,6,2,6,11,5,10,4,6,7,26,18,0
https://fbref.com/en/players/139560df/Omar-El-Hilali,3,2,3,0,0,1,2,1,1,0,1,1,4,6,0
https://fbref.com/en/players/6265208f/Joselu,13,11,3,4,6,4,17,13,25,4,21,8,21,43,0
https://fbref.com/en/players/fc076f78/Luca-Koleosho,2,2,0,0,2,1,2,1,1,0,1,0,2,0,0
https://fbref.com/en/players/2fa2a875/Benjamin-Lecomte,0,0,0,0,0,0,0,0,0,0,0,0,0,3,2
https://fbref.com/en/players/ea610f00/Pol-Lozano,0,0,0,0,0,0,0,0,1,0,1,0,0,1,0
https://fbref.com/en/players/937c6ae6/Roger-Martinez,0,0,0,0,0,0,0,0,0,0,0,0,0,0,0
https://fbref.com/en/players/28e957d7/Cesar-Montes,17,9,10,7,0,10,18,8,19,12,7,14,31,101,0
https://fbref.com/en/players/a3e4bf46/Brian-Olivan,47,27,30,12,5,17,26,9,26,6,20,22,69,67,0
https://fbref.com/en/players/97852360/Fernando-Pacheco,0,0,0,0,0,0,1,1,0,0,0,1,1,11,0
https://fbref.com/en/players/112521d1/Pedrosa,5,1,5,0,0,4,7,3,1,1,0,5,10,3,0
https://fbref.com/en/players/64ba07c0/Ronael-Pierre-Gabriel,17,9,12,4,1,5,11,6,5,2,3,9,26,11,0
https://fbref.com/en/players/2683eda7/Javi-Puado,20,11,12,5,3,12,28,16,12,2,10,10,30,14,0
https://fbref.com/en/players/ce8039aa/Nico-Ribaudo,18,13,5,9,4,11,30,19,19,1,18,5,23,1,0
https://fbref.com/en/players/35d4f151/Ruben,30,15,18,9,3,20,29,9,14,4,10,18,48,18,0
https://fbref.com/en/players/6a8a7af8/Vinicius-Souza,99,66,41,45,13,33,59,26,31,14,17,48,147,50,1
https://fbref.com/en/players/12c50af5/Denis-Suarez,26,20,12,12,2,13,45,32,11,1,10,5,31,4,0
https://fbref.com/en/players/e96b2583/Nabil-Touaizi,0,0,0,0,0,0,0,0,0,0,0,0,0,0,0
https://fbref.com/en/players/04965583/Aleix-Vidal,11,5,6,3,2,4,22,18,21,2,19,15,26,14,0
https://fbref.com/en/players/cea4ee8f/Dele-Alli,0,0,0,0,0,0,0,0,0,0,0,0,0,0,0
https://fbref.com/en/players/7b4de647/Asmir-Begovic,0,0,0,0,0,0,0,0,0,0,0,0,0,1,0
https://fbref.com/en/players/59e6e5bf/Dominic-Calvert-Lewin,4,2,1,0,3,1,5,4,5,1,4,3,7,18,0
https://fbref.com/en/players/4506aec5/Thomas-Cannon,0,0,0,0,0,0,0,0,0,0,0,0,0,0,0
https://fbref.com/en/players/2928dca2/Conor-Coady,14,9,8,6,0,7,15,8,21,17,4,14,28,88,3
https://fbref.com/en/players/0420d84f/Seamus-Coleman,35,26,21,10,4,19,29,10,14,7,7,22,57,58,2
https://fbref.com/en/players/9228b07c/Tom-Davies,15,9,5,9,1,7,14,7,10,1,9,4,19,7,1
https://fbref.com/en/players/02b29014/Abdoulaye-Doucoure,31,20,9,15,7,12,37,25,26,3,23,13,44,11,0
https://fbref.com/en/players/72c812f3/Idrissa-Gana-Gueye,97,57,49,35,13,31,60,29,50,12,38,56,153,34,3
https://fbref.com/en/players/4e015693/James-Garner,16,13,4,8,4,9,19,10,9,1,8,12,28,13,0
https://fbref.com/en/players/9f7c837d/Ben-Godfrey,20,11,13,5,2,11,29,18,12,6,6,8,28,33,1
https://fbref.com/en/players/2bd83368/Anthony-Gordon,34,22,17,10,7,8,23,15,19,0,19,4,38,11,0
https://fbref.com/en/players/4468ec10/Demarai-Gray,33,24,9,14,10,17,31,14,23,3,20,13,46,18,0
https://fbref.com/en/players/d0042ab9/Mason-Holgate,11,7,8,3,0,3,11,8,7,3,4,7,18,28,0
https://fbref.com/en/players/6ca5ec4b/Alex-Iwobi,69,37,37,28,4,33,65,32,41,2,39,25,94,29,0
https://fbref.com/en/players/c5b7c315/Michael-Keane,7,4,5,2,0,5,8,3,12,7,5,14,21,55,1
https://fbref.com/en/players/4bcf39f6/Neal-Maupay,11,5,3,4,4,2,4,2,8,0,8,5,16,0,0
https://fbref.com/en/players/fc15fb84/Dwight-McNeil,64,41,35,14,15,27,62,35,46,7,39,31,95,41,0
https://fbref.com/en/players/6d5701f2/Yerry-Mina,15,8,9,6,0,9,11,2,7,4,3,6,21,28,0
https://fbref.com/en/players/30d4a2e5/Vitaliy-Mykolenko,58,34,36,19,3,28,51,23,50,16,34,46,104,99,0
https://fbref.com/en/players/828657ff/Amadou-Onana,72,43,24,42,6,30,42,12,25,6,19,37,109,39,0
https://fbref.com/en/players/230f0471/Nathan-Patterson,49,24,32,13,4,29,53,24,24,4,20,15,64,45,0
https://fbref.com/en/players/4806ec67/Jordan-Pickford,0,0,0,0,0,0,1,1,0,0,0,4,4,15,3
https://fbref.com/en/players/b9403c99/Isaac-Price,0,0,0,0,0,0,1,1,1,1,0,0,0,0,0
https://fbref.com/en/players/b318a643/Salomon-Rondon,0,0,0,0,0,0,0,0,1,1,0,0,0,0,0
https://fbref.com/en/players/26d3b5be/Ellis-Simms,0,0,0,0,0,0,0,0,0,0,0,0,0,1,0
https://fbref.com/en/players/15ea812b/James-Tarkowski,51,26,36,13,2,20,38,18,99,78,21,51,102,201,3
https://fbref.com/en/players/b937e490/Ruben-Vinagre,2,2,1,1,0,1,2,1,0,0,0,0,2,1,0
https://fbref.com/en/players/5a2cb25d/Sofyan-Amrabat,39,24,15,17,7,16,29,13,23,5,18,21,60,18,2
https://fbref.com/en/players/a820e429/Arthur,9,2,1,4,4,4,8,4,10,1,9,1,10,12,0
https://fbref.com/en/players/01efac19/Antonin-Barak,21,9,5,7,9,6,16,10,16,2,14,3,24,13,0
https://fbref.com/en/players/0000acda/Marco-Benassi,3,3,2,0,1,3,4,1,0,0,0,1,4,1,0
https://fbref.com/en/players/d65cf468/Alessandro-Bianco,5,2,2,3,0,2,3,1,1,0,1,0,5,0,0
https://fbref.com/en/players/9e1577aa/Cristiano-Biraghi,65,38,29,29,7,32,65,33,32,7,25,14,79,42,1
https://fbref.com/en/players/d995ed27/Giacomo-Bonaventura,35,23,14,15,6,24,37,13,14,0,14,16,51,5,1
https://fbref.com/en/players/d4a2533d/Josip-Brekalo,2,1,0,1,1,1,4,3,1,0,1,1,3,1,0
https://fbref.com/en/players/0728bebe/Gaetano-Castrovilli,10,8,1,7,2,2,9,7,5,1,4,8,18,5,0
https://fbref.com/en/players/efdeaff3/Michele-Cerofolini,0,0,0,0,0,0,0,0,0,0,0,1,1,2,0
https://fbref.com/en/players/b5f7d10b/Dodo,40,22,20,14,6,22,46,24,26,2,24,25,65,37,0
https://fbref.com/en/players/528492ea/Alfred-Duncan,18,10,0,17,1,10,21,11,9,0,9,8,26,6,0
https://fbref.com/en/players/f0f7f62f/Pierluigi-Gollini,1,0,1,0,0,1,1,0,0,0,0,0,1,2,0
https://fbref.com/en/players/2374aaca/Nicolas-Gonzalez,17,10,3,10,4,5,16,11,14,0,14,4,21,6,0
https://fbref.com/en/players/a4e85758/Igor,43,29,21,18,4,20,27,7,33,14,19,25,68,56,2
https://fbref.com/en/players/42eaa028/Jonathan-Ikone,16,8,5,6,5,5,14,9,18,1,17,4,20,3,0
https://fbref.com/en/players/4d8cd038/Luka-Jovic,6,3,1,4,1,2,8,6,7,2,5,2,8,10,0
https://fbref.com/en/players/58e933d2/Christian-Kouame,27,18,8,10,9,7,14,7,15,3,12,12,39,8,0
https://fbref.com/en/players/4c8845f7/Youssef-Maleh,3,1,0,3,0,0,4,4,5,0,5,1,4,3,0
https://fbref.com/en/players/c7259b83/Rolando-Mandragora,42,24,12,22,8,23,52,29,25,3,22,16,58,21,0
https://fbref.com/en/players/3ec3c1c9/Lucas-Martinez-Quarta,80,48,44,32,4,42,61,19,41,19,22,48,128,78,1
https://fbref.com/en/players/bee704fc/Nikola-Milenkovic,40,25,20,17,3,18,27,9,27,14,13,22,62,72,0
https://fbref.com/en/players/8c63fae5/Luca-Ranieri,9,4,6,3,0,6,9,3,5,3,2,11,20,15,1
https://fbref.com/en/players/3bb7af3b/Riccardo-Saponara,10,5,3,6,1,5,9,4,7,1,6,5,15,9,1
https://fbref.com/en/players/10dc46f0/Salvatore-Sirigu,0,0,0,0,0,0,0,0,0,0,0,0,0,1,0
https://fbref.com/en/players/94816803/Riccardo-Sottil,4,3,2,0,2,2,5,3,2,0,2,0,4,0,0
https://fbref.com/en/players/e1b0a70d/Pietro-Terracciano,2,1,2,0,0,2,3,1,0,0,0,1,3,14,0
https://fbref.com/en/players/3ef0a2d7/Aleksa-Terzic,16,9,9,4,3,11,21,10,13,4,9,5,21,16,0
https://fbref.com/en/players/983ff2c7/Lorenzo-Venuti,18,7,6,11,1,11,18,7,7,2,5,5,23,17,2
https://fbref.com/en/players/4e1d5e59/Szymon-Zurkowski,0,0,0,0,0,0,0,0,0,0,0,0,0,0,0
https://fbref.com/en/players/d01bbb6f/Ritsu-Doan,61,29,19,29,13,25,54,29,40,1,39,14,75,12,0
https://fbref.com/en/players/beb882a8/Maximilian-Eggestein,51,29,21,24,6,17,35,18,37,8,29,36,87,27,0
https://fbref.com/en/players/56e6a1c9/Kimberly-Ezekwem,0,0,0,0,0,0,0,0,1,0,1,0,0,0,0
https://fbref.com/en/players/a92ab7be/Mark-Flekken,0,0,0,0,0,0,1,1,1,0,1,0,0,9,5
https://fbref.com/en/players/f521b80a/Matthias-Ginter,43,20,29,12,2,26,40,14,40,24,16,35,78,153,3
https://fbref.com/en/players/8e235926/Michael-Gregoritsch,19,12,6,9,4,3,21,18,23,4,19,5,24,10,0
https://fbref.com/en/players/54e4866f/Vincenzo-Grifo,29,16,6,15,8,13,31,18,18,1,17,19,48,19,0
https://fbref.com/en/players/25ab9c9c/Manuel-Gulde,14,8,10,4,0,2,4,2,5,1,4,19,33,25,0
https://fbref.com/en/players/8593f88c/Christian-Gunter,29,21,18,9,2,13,43,30,22,4,18,16,45,41,0
https://fbref.com/en/players/5d8e331f/Nicolas-Hofler,66,35,28,35,3,27,61,34,40,13,27,58,124,49,0
https://fbref.com/en/players/ca618d23/Lucas-Holer,19,14,5,7,7,6,22,16,22,5,17,10,29,17,0
https://fbref.com/en/players/d2c580ce/Yannik-Keitel,11,7,4,6,1,3,5,2,6,3,3,13,24,8,0
https://fbref.com/en/players/2a29eb9b/Lukas-Kubler,37,25,24,9,4,18,30,12,25,11,14,29,66,50,0
https://fbref.com/en/players/2770726a/Daniel-Kyereh,6,4,2,4,0,3,6,3,4,0,4,2,8,6,0
https://fbref.com/en/players/302527b2/Philipp-Lienhart,29,18,19,10,0,13,27,14,29,15,14,35,64,97,0
https://fbref.com/en/players/f93e6e94/Nils-Petersen,6,4,0,3,3,2,5,3,11,2,9,1,7,6,0
https://fbref.com/en/players/1f2c7b55/Merlin-Rohl,1,0,1,0,0,0,0,0,0,0,0,0,1,1,0
https://fbref.com/en/players/bf075f6b/Roland-Sallai,11,8,4,3,4,4,10,6,7,1,6,2,13,11,0
https://fbref.com/en/players/52afb588/Kevin-Schade,6,4,3,2,1,3,5,2,0,0,0,0,6,2,0
https://fbref.com/en/players/f6bdc830/Keven-Schlotterbeck,0,0,0,0,0,0,0,0,1,1,0,2,2,2,0
https://fbref.com/en/players/088ca1bd/Jonathan-Schmid,1,1,1,0,0,0,0,0,1,0,1,1,2,1,1
https://fbref.com/en/players/7d31f1cb/Kenneth-Schmidt,6,3,4,2,0,5,6,1,4,2,2,0,6,2,0
https://fbref.com/en/players/313254a3/Kiliann-Sildillia,33,20,10,19,4,18,30,12,24,9,15,21,54,47,1
https://fbref.com/en/players/c6cf860f/Hugo-Siquet,2,2,2,0,0,2,2,0,1,0,1,0,2,0,0
https://fbref.com/en/players/e3d3fbeb/Robert-Wagner,0,0,0,0,0,0,0,0,2,0,2,0,0,2,0
https://fbref.com/en/players/dd676a97/Noah-Weisshaupt,11,6,3,7,1,2,7,5,4,0,4,6,17,8,0
https://fbref.com/en/players/6190474d/Jeong-Woo-yeong,7,3,4,2,1,2,5,3,7,1,6,1,8,7,0
https://fbref.com/en/players/c81d773d/Tosin-Adarabioyo,30,13,22,6,2,16,23,7,20,15,5,26,56,140,1
https://fbref.com/en/players/a8748947/Tom-Cairney,17,6,4,8,5,7,10,3,18,3,15,5,22,3,0
https://fbref.com/en/players/422862ea/Nathaniel-Chalobah,1,1,1,0,0,1,1,0,0,0,0,0,1,2,0
https://fbref.com/en/players/a712ca2b/Issa-Diop,28,19,18,9,1,17,32,15,24,17,7,35,63,86,0
https://fbref.com/en/players/7314bba4/Shane-Duffy,0,0,0,0,0,0,0,0,0,0,0,0,0,0,1
https://fbref.com/en/players/6722d4f0/Tyrese-Francois,0,0,0,0,0,0,0,0,0,0,0,0,0,1,0
https://fbref.com/en/players/8c3078cd/Luke-Harris,0,0,0,0,0,0,0,0,0,0,0,0,0,0,0
https://fbref.com/en/players/c931d9f9/Daniel-James,9,5,4,4,1,4,8,4,5,1,4,1,10,5,0
https://fbref.com/en/players/18b999f4/Neeskens-Kebano,17,9,8,6,3,9,17,8,14,0,14,1,18,8,0
https://fbref.com/en/players/41e7ef1c/Layvin-Kurzawa,3,2,1,1,1,3,3,0,1,1,0,2,5,4,0
https://fbref.com/en/players/2628fd2b/Bernd-Leno,0,0,0,0,0,0,2,2,0,0,0,0,0,18,0
https://fbref.com/en/players/c6e8cf1f/Sasa-Lukic,8,3,1,4,3,3,7,4,6,2,4,5,13,3,0
https://fbref.com/en/players/493924a7/Kevin-Mbabu,3,2,2,1,0,1,3,2,2,0,2,3,6,3,0
https://fbref.com/en/players/3925dbd6/Aleksandar-Mitrovic,14,7,8,4,2,5,12,7,22,5,17,3,17,20,1
https://fbref.com/en/players/6612cd8c/Josh-Onomah,1,0,1,0,0,0,0,0,1,0,1,0,1,0,0
https://fbref.com/en/players/a78ff07f/Joao-Palhinha,147,83,58,65,24,71,134,63,48,5,43,46,193,61,2
https://fbref.com/en/players/6639e500/Andreas-Pereira,18,9,3,6,9,8,33,25,21,3,18,6,24,8,0
https://fbref.com/en/players/28b40c9c/Tim-Ream,30,16,15,12,3,13,26,13,45,24,21,41,71,116,2
https://fbref.com/en/players/803ae100/Harrison-Reed,44,27,17,21,6,16,50,34,54,12,42,19,63,36,0
https://fbref.com/en/players/0f7533cd/Bobby-Reid,42,24,14,14,14,16,34,18,25,3,22,20,62,28,1
https://fbref.com/en/players/289601e6/Antonee-Robinson,62,38,43,15,4,44,65,21,49,13,36,53,115,83,3
https://fbref.com/en/players/17acc2ed/Marek-Rodak,0,0,0,0,0,0,0,0,0,0,0,0,0,1,1
https://fbref.com/en/players/839c14e1/Cedric-Soares,8,5,4,3,1,3,3,0,3,1,2,1,9,5,0
https://fbref.com/en/players/886f9aac/Manor-Solomon,20,12,12,6,2,9,16,7,8,0,8,5,25,3,0
https://fbref.com/en/players/b2626673/Jay-Stansfield,0,0,0,0,0,0,2,2,4,1,3,1,1,1,0
https://fbref.com/en/players/77d7c96f/Kenny-Tete,83,46,41,29,13,38,50,12,48,17,31,52,135,81,1
https://fbref.com/en/players/8b529245/Carlos-Vinicius,4,1,0,2,2,0,4,4,7,0,7,0,4,10,0
https://fbref.com/en/players/8b9ebd03/Willian,13,8,8,3,2,7,25,18,13,0,13,9,22,9,0
https://fbref.com/en/players/c6dc9ecd/Harry-Wilson,21,13,9,9,3,8,18,10,17,2,15,6,27,14,0
https://fbref.com/en/players/bb08bce9/Omar-Alderete,35,20,21,14,0,28,40,12,23,16,7,26,61,85,0
https://fbref.com/en/players/6c811eb7/Carles-Alena,18,10,7,5,6,5,34,29,19,1,18,4,22,18,0
https://fbref.com/en/players/acc1aefa/Angel-Algobia,27,13,14,13,0,22,48,26,15,5,10,3,30,11,0
https://fbref.com/en/players/852ddfb8/Gaston-Alvarez,38,30,24,9,5,23,42,19,15,5,10,15,53,35,0
https://fbref.com/en/players/22721b88/Jordan-Amavi,3,2,3,0,0,1,3,2,3,0,3,4,7,7,0
https://fbref.com/en/players/fdd26d71/Fabrizio-Angileri,12,9,8,3,1,10,17,7,8,3,5,7,19,10,0
https://fbref.com/en/players/58afe001/Mauro-Arambarri,14,6,9,4,1,3,17,14,17,5,12,14,28,19,0
https://fbref.com/en/players/a4971d84/Djene,41,28,23,17,1,22,38,16,25,10,15,42,83,81,1
https://fbref.com/en/players/93090f69/Domingos-Duarte,26,18,21,5,0,19,26,7,29,23,6,39,65,145,0
https://fbref.com/en/players/8696bc90/Munir-El-Haddadi,12,7,3,7,2,2,10,8,23,2,21,9,21,7,0
https://fbref.com/en/players/974322dc/Iglesias,61,35,40,18,3,33,65,32,40,5,35,21,82,91,1
https://fbref.com/en/players/2bea832e/Latasa,5,4,2,0,3,1,1,0,3,1,2,1,6,8,0
https://fbref.com/en/players/00b28772/Nemanja-Maksimovic,41,30,17,18,6,19,32,13,36,14,22,34,75,27,0
https://fbref.com/en/players/02319ad7/Jaime-Mata,13,10,4,5,4,7,22,15,7,2,5,3,16,6,0
https://fbref.com/en/players/64e8ed6d/Borja-Mayoral,9,4,7,2,0,5,31,26,18,0,18,3,12,10,0
https://fbref.com/en/players/19c36442/Luis-Milla,48,30,21,18,9,19,44,25,13,1,12,32,80,25,1
https://fbref.com/en/players/e6777e6b/Stefan-Mitrovic,14,6,12,2,0,7,11,4,12,10,2,17,31,90,2
https://fbref.com/en/players/e2dcc60e/Moises-Parra-Gutierrez,1,0,0,1,0,0,0,0,0,0,0,0,1,0,0
https://fbref.com/en/players/1bda5842/Portu,28,21,14,10,4,18,42,24,23,3,20,17,45,20,1
https://fbref.com/en/players/14d5b7ac/Alejandro-Revuelta-Montero,0,0,0,0,0,0,0,0,0,0,0,0,0,1,0
https://fbref.com/en/players/a62b4888/Jaime-Seoane,10,4,3,4,3,2,8,6,7,3,4,1,11,2,0
https://fbref.com/en/players/8f8c6934/David-Soria,0,0,0,0,0,0,1,1,0,0,0,1,1,20,4
https://fbref.com/en/players/ba5004e1/Damian-Suarez,49,33,23,19,7,26,48,22,40,0,40,15,64,36,0
https://fbref.com/en/players/f8eca1b6/Enes-Unal,26,14,5,19,2,7,25,18,19,2,17,6,32,35,0
https://fbref.com/en/players/bdc74a8f/Gonzalo-Villar,10,5,1,6,3,6,14,8,9,2,7,6,16,5,0
https://fbref.com/en/players/5d133e96/Ricard-Artero,3,3,2,1,0,1,1,0,2,0,2,1,4,3,0
https://fbref.com/en/players/edc98fac/Santiago-Bueno,63,38,43,19,1,24,36,12,34,22,12,31,94,105,2
https://fbref.com/en/players/af34f10d/Alexander-Callens,3,3,2,1,0,3,4,1,3,1,2,1,4,9,0
https://fbref.com/en/players/688b96e3/Juan-Carlos,0,0,0,0,0,0,0,0,0,0,0,1,1,7,1
https://fbref.com/en/players/da76bab4/Valentin-Castellanos,12,5,2,7,3,0,18,18,22,2,20,6,18,26,0
https://fbref.com/en/players/1944818c/Yan-Couto,25,18,11,11,3,12,20,8,7,2,5,5,30,10,0
https://fbref.com/en/players/4242011c/Bernardo-Espinosa,6,2,2,4,0,3,9,6,17,10,7,12,18,70,2
https://fbref.com/en/players/a10361d2/Aleix-Garcia,37,20,9,18,10,15,33,18,24,8,16,31,68,35,1
https://fbref.com/en/players/e7f4603c/Borja-Garcia,10,4,7,2,1,2,9,7,3,1,2,5,15,6,1
https://fbref.com/en/players/63d17038/Paulo-Gazzaniga,0,0,0,0,0,0,1,1,0,0,0,1,1,9,5
https://fbref.com/en/players/7e98cff1/Miguel-Gutierrez,41,23,23,13,5,23,37,14,23,5,18,18,59,42,1
https://fbref.com/en/players/9a76c2e9/Javi-Hernandez,21,12,12,7,2,13,21,8,10,5,5,7,28,38,0
https://fbref.com/en/players/e778654a/Yangel-Herrera,26,9,9,14,3,6,15,9,14,1,13,4,30,12,0
https://fbref.com/en/players/1633fc8a/Juanpe,19,11,10,9,0,11,17,6,12,9,3,10,29,60,1
https://fbref.com/en/players/f03f284b/David-Lopez,31,18,17,13,1,19,27,8,29,19,10,14,45,64,1
https://fbref.com/en/players/ae48c5cb/Ivan-Martin,9,7,4,4,1,8,23,15,12,0,12,9,18,12,0
https://fbref.com/en/players/c3e66ffe/Arnau-Martinez,69,45,41,19,9,38,85,47,44,10,34,25,94,54,2
https://fbref.com/en/players/6b21b7b5/Reinier,12,10,7,3,2,2,8,6,6,0,6,5,17,4,0
https://fbref.com/en/players/65154df0/Rodrigo-Riquelme,20,8,8,8,4,9,35,26,16,0,16,11,31,5,0
https://fbref.com/en/players/5f21b94c/Joel-Roca,2,2,2,0,0,2,5,3,1,1,0,0,2,1,0
https://fbref.com/en/players/4b511457/Oriol-Romeu,70,38,36,26,8,26,51,25,48,10,38,37,107,54,0
https://fbref.com/en/players/13e0eb29/Samuel-Saiz,2,2,0,2,0,1,2,1,3,0,3,0,2,1,1
https://fbref.com/en/players/220c11f1/Cristhian-Stuani,13,6,2,7,4,5,14,9,10,0,10,2,15,5,0
https://fbref.com/en/players/f36016a5/Ramon-Terrats,4,2,1,3,0,2,6,4,6,2,4,3,7,3,1
https://fbref.com/en/players/f7e87032/Viktor-Tsyhankov,8,8,5,1,2,1,14,13,13,2,11,7,15,12,0
https://fbref.com/en/players/2dd7e29d/Oscar-Urena,4,2,2,2,0,2,3,1,2,0,2,1,5,0,0
https://fbref.com/en/players/4acd733a/Valery,12,6,4,6,2,5,9,4,8,1,7,10,22,9,1
https://fbref.com/en/players/0bc4e720/Manu-Vallejo,4,1,1,2,1,1,6,5,2,0,2,1,5,3,0
https://fbref.com/en/players/636eae97/Toni-Villa,25,18,9,11,5,10,23,13,8,0,8,8,33,3,0
https://fbref.com/en/players/8f5cdf66/Oliver-Abildgaard,10,6,6,3,1,7,16,9,7,1,6,5,15,17,0
https://fbref.com/en/players/2df7cc43/Bruno-Amione,1,1,1,0,0,1,2,1,1,0,1,0,1,4,0
https://fbref.com/en/players/01efac19/Antonin-Barak,0,0,0,0,0,0,0,0,0,0,0,0,0,0,0
https://fbref.com/en/players/c609e90e/Jayden-Braaf,5,3,2,3,0,0,0,0,1,0,1,2,7,1,0
https://fbref.com/en/players/ef6eef89/Juan-Cabal,10,6,7,3,0,7,12,5,8,5,3,13,23,12,0
https://fbref.com/en/players/d9624b51/Federico-Ceccherini,25,19,15,9,1,13,23,10,17,10,7,19,44,55,0
https://fbref.com/en/players/22ae86f9/Diego-Coppola,25,17,15,10,0,11,24,13,20,6,14,14,39,38,0
https://fbref.com/en/players/bfc359ed/Alessandro-Cortinovis,1,0,1,0,0,0,0,0,1,0,1,0,1,0,0
https://fbref.com/en/players/16bb656a/Pawel-Dawidowicz,48,31,28,17,3,22,31,9,14,9,5,23,71,71,0
https://fbref.com/en/players/d97f2e8d/Fabio-Depaoli,48,28,25,16,7,25,44,19,32,6,26,18,66,33,3
https://fbref.com/en/players/2f69d881/Josh-Doig,19,8,6,7,6,6,16,10,25,6,19,11,30,13,1
https://fbref.com/en/players/79ca3e23/Ondrej-Duda,22,14,7,12,3,9,16,7,11,0,11,13,35,8,0
https://fbref.com/en/players/aae9d04a/Davide-Faraoni,34,24,19,13,2,16,41,25,30,11,19,15,49,37,0
https://fbref.com/en/players/8dfed6e9/Adolfo-Gaich,5,3,0,3,2,1,6,5,7,2,5,3,8,7,1
https://fbref.com/en/players/f1f1f238/Koray-Gunter,10,6,1,8,1,4,7,3,24,15,9,30,40,46,0
https://fbref.com/en/players/9ef42479/Thomas-Henry,5,3,1,1,3,1,5,4,6,2,4,0,5,14,0
https://fbref.com/en/players/12806697/Isak-Hien,73,36,54,19,0,38,61,23,40,17,23,31,104,92,1
https://fbref.com/en/players/b85bf253/Martin-Hongla,8,5,4,4,0,5,5,0,7,1,6,6,14,9,0
https://fbref.com/en/players/1f2d714c/Ajdin-Hrustic,2,1,1,1,0,1,2,1,2,0,2,0,2,2,1
https://fbref.com/en/players/bb376bed/Ivan-Ilic,16,10,9,7,0,6,11,5,10,1,9,8,24,14,0
https://fbref.com/en/players/f95f49d2/Yayah-Kallon,14,10,5,4,5,7,12,5,10,0,10,8,22,5,0
https://fbref.com/en/players/09538fdb/Kevin-Lasagna,12,6,7,3,2,6,14,8,17,1,16,5,17,13,0
https://fbref.com/en/players/5128bde4/Darko-Lazovic,24,13,9,12,3,13,29,16,14,3,11,16,40,19,0
https://fbref.com/en/players/cce9f582/Giangiacomo-Magnani,33,22,20,11,2,19,25,6,20,15,5,21,54,76,0
https://fbref.com/en/players/c1d95617/Lorenzo-Montipo,1,0,1,0,0,0,3,3,1,0,1,0,1,26,3
https://fbref.com/en/players/2b8360f1/Cyril-Ngonge,7,3,2,2,3,3,11,8,7,0,7,6,13,4,0
https://fbref.com/en/players/b9e11c1d/Simone-Perilli,0,0,0,0,0,0,0,0,0,0,0,0,0,0,0
https://fbref.com/en/players/1cadaf34/Roberto-Piccoli,1,0,1,0,0,0,2,2,2,0,2,0,1,2,0
https://fbref.com/en/players/4bd00a50/Panagiotis-Retsos,5,4,2,2,1,3,3,0,4,1,3,2,7,3,0
https://fbref.com/en/players/230c3f3a/Ibrahim-Sulemana,19,13,10,7,2,6,12,6,8,2,6,14,33,15,0
https://fbref.com/en/players/8da74c05/Adrien-Tameze,51,30,21,26,4,28,63,35,51,14,37,37,88,55,2
https://fbref.com/en/players/5cbb5ad6/Filippo-Terracciano,20,13,11,7,2,15,20,5,7,4,3,10,30,14,0
https://fbref.com/en/players/ab1ca213/Miguel-Veloso,33,10,20,12,1,16,26,10,26,6,20,6,39,14,0
https://fbref.com/en/players/0375723e/Simone-Verdi,15,10,7,5,3,6,17,11,8,1,7,0,15,2,0
https://fbref.com/en/players/58a2e9f6/Deyovaisio-Zeefuik,1,1,0,1,0,0,0,0,0,0,0,0,1,0,0
https://fbref.com/en/players/405f6586/Milan-Djuric,2,1,1,0,1,1,3,2,7,4,3,1,3,24,0
https://fbref.com/en/players/f4ec4fd0/Kevin-Prince-Boateng,8,6,4,2,2,3,9,6,11,3,8,3,11,5,0
https://fbref.com/en/players/635f2732/Jean-Paul-Boetius,30,16,19,9,2,8,25,17,25,5,20,14,44,10,0
https://fbref.com/en/players/af104654/Oliver-Christensen,1,0,1,0,0,0,2,2,0,0,0,0,1,22,2
https://fbref.com/en/players/6e17c802/Tolga-Cigerci,16,13,6,9,1,10,16,6,6,2,4,8,24,5,0
https://fbref.com/en/players/41bff4fa/Marton-Dardai,17,8,9,8,0,9,18,9,14,9,5,11,28,45,1
https://fbref.com/en/players/3eb0f2df/Vladimir-Darida,1,1,0,1,0,0,0,0,1,0,1,0,1,0,0
https://fbref.com/en/players/943b9602/Julian-Eitschberger,0,0,0,0,0,0,0,0,0,0,0,0,0,0,0
https://fbref.com/en/players/e7f3e8a7/Chidera-Ejuke,5,4,1,4,0,1,5,4,4,0,4,4,9,1,0
https://fbref.com/en/players/3f6c3ae0/Tjark-Ernst,0,0,0,0,0,0,0,0,0,0,0,0,0,1,0
https://fbref.com/en/players/f36c432f/Stevan-Jovetic,3,2,2,1,0,1,11,10,2,1,1,2,5,10,0
https://fbref.com/en/players/b4c816a9/Wilfried-Kanga,5,4,2,1,2,2,4,2,14,3,11,2,7,13,0
https://fbref.com/en/players/815c314f/Marc-Oliver-Kempf,44,27,29,14,1,16,22,6,42,32,10,51,95,143,0
https://fbref.com/en/players/099e666f/Jonjoe-Kenny,46,34,27,16,3,24,42,18,38,9,29,46,92,74,0
https://fbref.com/en/players/90d88154/Pascal-Klemens,0,0,0,0,0,0,1,1,1,0,1,1,1,3,0
https://fbref.com/en/players/0c61c77c/Dodi-Lukebakio,18,11,7,8,3,6,27,21,23,5,18,13,31,17,0
https://fbref.com/en/players/706a60e1/Myziane-Maolida,1,1,1,0,0,1,2,1,0,0,0,0,1,1,0
https://fbref.com/en/players/89b3bc5e/Ibrahim-Maza,1,1,1,0,0,0,1,1,2,0,2,0,1,1,0
https://fbref.com/en/players/88d4144a/Maximilian-Mittelstadt,39,20,31,6,2,17,39,22,13,2,11,26,65,27,0
https://fbref.com/en/players/bc249af8/Jessic-Ngankam,14,9,7,4,3,6,14,8,6,1,5,1,15,4,0
https://fbref.com/en/players/d6862409/Florian-Niederlechner,9,7,2,4,3,2,8,6,7,0,7,3,12,10,0
https://fbref.com/en/players/c18d22f5/Peter-Pekarik,4,3,4,0,0,4,6,2,6,2,4,4,8,7,0
https://fbref.com/en/players/f7aa75bd/Marvin-Plattenhardt,43,33,24,15,4,29,47,18,25,11,14,15,58,82,0
https://fbref.com/en/players/f972644c/Marco-Richter,43,23,18,17,8,19,48,29,29,2,27,24,67,25,0
https://fbref.com/en/players/ea42c03f/Agustin-Rogel,18,9,13,5,0,11,17,6,15,8,7,11,29,74,1
https://fbref.com/en/players/779aa25c/Tony-Rolke,0,0,0,0,0,0,0,0,1,0,1,0,0,1,0
https://fbref.com/en/players/93cba339/Derry-Scherhant,7,6,3,3,1,4,8,4,3,0,3,0,7,5,0
https://fbref.com/en/players/1238a3f9/Davie-Selke,2,1,1,1,0,0,1,1,3,1,2,1,3,5,0
https://fbref.com/en/players/b3325a30/Suat-Serdar,51,23,14,30,7,20,41,21,48,12,36,29,80,24,0
https://fbref.com/en/players/e52d33d0/Veit-Stange,1,1,1,0,0,1,1,0,0,0,0,0,1,0,0
https://fbref.com/en/players/e18098de/Ivan-Sunjic,38,20,16,21,1,16,24,8,17,5,12,13,51,19,1
https://fbref.com/en/players/71ec39ef/Lucas-Tousart,73,38,35,28,10,27,60,33,42,6,36,48,121,75,1
https://fbref.com/en/players/af842091/Filip-Uremovic,38,23,29,8,1,14,22,8,18,13,5,36,74,88,2
https://fbref.com/en/players/6ec6fde0/Kevin-Akpoguma,75,44,45,27,3,32,45,13,45,16,29,24,99,70,1
https://fbref.com/en/players/30941e96/Angelino,40,24,19,18,3,23,37,14,32,6,26,25,65,67,0
https://fbref.com/en/players/35f67a30/Fisnik-Asllani,0,0,0,0,0,0,4,4,2,0,2,3,3,3,0
https://fbref.com/en/players/47064058/Oliver-Baumann,0,0,0,0,0,0,0,0,0,0,0,0,0,15,1
https://fbref.com/en/players/437f2b00/Christoph-Baumgartner,36,19,12,17,7,9,52,43,57,5,52,15,51,19,1
https://fbref.com/en/players/a53b661f/Ihlas-Bebou,19,16,8,7,4,11,17,6,9,2,7,7,26,15,0
https://fbref.com/en/players/7aac47fe/Ermin-Bicakcic,8,4,6,1,1,2,6,4,4,3,1,5,13,14,0
https://fbref.com/en/players/07d3bfec/Tom-Bischof,15,10,8,3,4,7,10,3,5,1,4,1,16,1,0
https://fbref.com/en/players/e27da244/John-Brooks,18,12,10,8,0,13,18,5,17,12,5,10,28,105,0
https://fbref.com/en/players/4e204552/Jacob-Bruun-Larsen,4,3,0,1,3,3,4,1,3,1,2,1,5,0,0
https://fbref.com/en/players/eac044ad/Moanes-Dabbur,11,8,4,5,2,3,9,6,8,0,8,5,16,0,0
https://fbref.com/en/players/d3d77413/Muhammed-Damar,6,3,1,2,3,1,2,1,3,0,3,0,6,0,0
https://fbref.com/en/players/fe641c1a/Thomas-Delaney,6,3,3,2,1,3,8,5,5,0,5,1,7,4,0
https://fbref.com/en/players/cc83b74d/Kasper-Dolberg,7,5,1,4,2,4,6,2,6,2,4,0,7,5,0
https://fbref.com/en/players/37f606f0/Dennis-Geiger,45,25,15,28,2,22,35,13,27,3,24,24,69,18,2
https://fbref.com/en/players/2d61d13a/Ozan-Kabak,51,34,27,21,3,17,30,13,35,23,12,45,96,83,0
https://fbref.com/en/players/79c90e45/Pavel-Kaderabek,26,20,10,9,7,15,23,8,12,2,10,14,40,37,1
https://fbref.com/en/players/603cb947/Andrej-Kramaric,5,2,2,1,2,1,11,10,14,2,12,6,11,13,0
https://fbref.com/en/players/61590953/Stanley-NSoki,22,13,14,7,1,12,22,10,22,5,17,24,46,34,0
https://fbref.com/en/players/dd2e62da/Finn-Ole-Becker,10,2,4,6,0,4,7,3,4,0,4,5,15,8,0
https://fbref.com/en/players/7f609bfc/Stefan-Posch,0,0,0,0,0,0,0,0,0,0,0,0,0,0,0
https://fbref.com/en/players/924f9191/Grischa-Promel,27,19,14,11,2,9,25,16,22,4,18,8,35,23,0
https://fbref.com/en/players/7ec723b7/Eduardo-Quaresma,5,3,3,2,0,1,3,2,3,2,1,0,5,3,0
https://fbref.com/en/players/3c200e05/Joshua-Quarshie,0,0,0,0,0,0,0,0,0,0,0,0,0,0,0
https://fbref.com/en/players/80f36c88/Sebastian-Rudy,26,12,10,16,0,13,27,14,27,7,20,11,37,13,0
https://fbref.com/en/players/c64c01fc/Georginio-Rutter,7,4,1,4,2,1,3,2,10,2,8,5,12,6,0
https://fbref.com/en/players/08593525/Diadie-Samassekou,1,0,0,1,0,0,1,1,0,0,0,0,1,0,0
https://fbref.com/en/players/ff98492b/Robert-Skov,22,11,14,7,1,10,26,16,22,8,14,8,30,20,2
https://fbref.com/en/players/3b1ed320/Angelo-Stiller,26,12,9,13,4,8,12,4,12,2,10,10,36,14,0
https://fbref.com/en/players/e547d3cf/Umut-Tohumcu,10,5,4,5,1,3,9,6,4,0,4,2,12,8,0
https://fbref.com/en/players/1d8e9add/Kevin-Vogt,15,10,10,5,0,9,22,13,18,11,7,26,41,67,0
https://fbref.com/en/players/b96b595c/Francesco-Acerbi,33,19,22,7,4,20,27,7,25,18,7,41,74,85,2
https://fbref.com/en/players/0fdcef0e/Kristjan-Asllani,11,5,1,8,2,7,10,3,3,1,2,6,17,4,0
https://fbref.com/en/players/6928979a/Nicolo-Barella,49,25,17,26,6,28,53,25,29,5,24,12,61,12,0
https://fbref.com/en/players/75b86fb3/Alessandro-Bastoni,41,20,20,14,7,11,27,16,27,13,14,24,65,45,0
https://fbref.com/en/players/e3756e72/Raoul-Bellanova,14,6,11,2,1,9,14,5,6,1,5,4,18,14,0
https://fbref.com/en/players/33b8d077/Marcelo-Brozovic,37,22,13,22,2,11,37,26,23,7,16,22,59,28,0
https://fbref.com/en/players/cd0fa27b/Hakan-Calhanoglu,48,27,17,26,5,16,43,27,30,5,25,25,73,13,1
https://fbref.com/en/players/707b98f1/Valentin-Carboni,1,1,0,1,0,1,3,2,1,0,1,0,1,0,0
https://fbref.com/en/players/e66ebabb/Alex-Cordaz,0,0,0,0,0,0,0,0,0,0,0,0,0,0,0
https://fbref.com/en/players/45b9b619/Joaquin-Correa,12,7,3,6,3,4,15,11,4,1,3,3,15,0,0
https://fbref.com/en/players/44eb9093/Danilo-DAmbrosio,25,17,17,7,1,15,27,12,12,4,8,10,35,17,0
https://fbref.com/en/players/96e0490d/Matteo-Darmian,56,30,29,15,12,31,47,16,33,5,28,21,77,36,0
https://fbref.com/en/players/970b8574/Federico-Dimarco,31,25,6,18,7,9,19,10,15,4,11,18,49,20,0
https://fbref.com/en/players/481c9ece/Denzel-Dumfries,35,18,17,13,5,22,34,12,33,9,24,12,47,26,0
https://fbref.com/en/players/3bb7f478/Edin-Dzeko,3,2,0,3,0,0,4,4,15,1,14,3,6,25,0
https://fbref.com/en/players/ce30bfc8/Roberto-Gagliardini,16,6,9,6,1,10,21,11,14,5,9,4,20,15,0
https://fbref.com/en/players/2d970560/Robin-Gosens,34,18,15,10,9,15,25,10,16,2,14,23,57,15,0
https://fbref.com/en/players/74419746/Samir-Handanovic,0,0,0,0,0,0,0,0,0,0,0,0,0,5,0
https://fbref.com/en/players/5eae500a/Romelu-Lukaku,3,1,1,0,2,2,5,3,3,1,2,0,3,16,0
https://fbref.com/en/players/f7036e1c/Lautaro-Martinez,25,14,3,15,7,7,23,16,31,1,30,13,38,16,1
https://fbref.com/en/players/dd0daf32/Henrikh-Mkhitaryan,41,26,13,22,6,14,41,27,27,4,23,21,62,18,0
https://fbref.com/en/players/e9c0c1b2/Andre-Onana,0,0,0,0,0,0,1,1,0,0,0,0,0,5,0
https://fbref.com/en/players/30f5ffa9/Milan-Skriniar,29,18,14,11,4,18,32,14,18,13,5,13,42,46,3
https://fbref.com/en/players/d0d8dd44/Stefan-de-Vrij,28,18,19,9,0,8,14,6,18,10,8,40,68,80,0
https://fbref.com/en/players/875d65d1/Mattia-Zanotti,0,0,0,0,0,0,1,1,2,0,2,0,0,0,0
https://fbref.com/en/players/6f1d7aa8/Tommaso-Barbieri,3,3,3,0,0,3,8,5,3,0,3,0,3,2,0
https://fbref.com/en/players/6caffe81/Enzo-Barrenechea,8,3,3,4,1,3,5,2,3,0,3,2,10,3,0
https://fbref.com/en/players/52ec54d0/Leonardo-Bonucci,5,4,1,4,0,2,4,2,12,8,4,13,18,29,0
https://fbref.com/en/players/5fd5ed86/Gleison-Bremer,29,20,23,5,1,19,26,7,44,22,22,42,71,120,2
https://fbref.com/en/players/b0f7e36c/Federico-Chiesa,22,11,6,6,10,5,14,9,13,1,12,0,22,1,0
https://fbref.com/en/players/0ab1f153/Juan-Cuadrado,50,34,34,13,3,27,65,38,15,2,13,24,74,32,0
https://fbref.com/en/players/94b2001f/Danilo,92,62,61,23,8,52,73,21,39,20,19,47,139,114,1
https://fbref.com/en/players/ae4e2852/Mattia-De-Sciglio,14,7,8,3,3,9,14,5,9,3,6,4,18,20,0
https://fbref.com/en/players/19cda00b/Angel-Di-Maria,10,5,3,5,2,3,19,16,15,0,15,7,17,0,0
https://fbref.com/en/players/366be751/Nicolo-Fagioli,29,19,12,15,2,8,27,19,16,2,14,8,37,7,1
https://fbref.com/en/players/18dd3219/Federico-Gatti,15,11,9,4,2,9,15,6,20,14,6,21,36,54,2
https://fbref.com/en/players/ba492306/Samuel-Iling-Junior,7,2,3,1,3,4,9,5,5,1,4,2,9,6,0
https://fbref.com/en/players/3d50bcdb/Moise-Kean,8,6,2,5,1,3,7,4,4,0,4,5,13,2,0
https://fbref.com/en/players/b1cd37e6/Filip-Kostic,41,26,17,20,4,21,47,26,30,4,26,16,57,32,0
https://fbref.com/en/players/a8a874f1/Manuel-Locatelli,59,33,26,23,10,30,53,23,50,22,28,27,86,59,0
https://fbref.com/en/players/01c3aff5/Weston-McKennie,14,5,3,9,2,5,8,3,15,4,11,11,25,15,1
https://fbref.com/en/players/85613cf0/Arkadiusz-Milik,12,8,2,8,2,2,8,6,10,1,9,1,13,14,0
https://fbref.com/en/players/34693494/Fabio-Miretti,24,11,15,6,3,12,29,17,20,1,19,4,28,11,0
https://fbref.com/en/players/dff153a4/Leandro-Paredes,19,13,7,11,1,10,22,12,8,0,8,17,36,22,0
https://fbref.com/en/players/4c62d0c8/Mattia-Perin,0,0,0,0,0,0,0,0,0,0,0,0,0,0,0
https://fbref.com/en/players/867239d3/Paul-Pogba,0,0,0,0,0,0,1,1,0,0,0,0,0,2,0
https://fbref.com/en/players/8794e251/Adrien-Rabiot,65,35,31,23,11,30,57,27,37,7,30,26,91,44,1
https://fbref.com/en/players/e58cbfd5/Nicolo-Rovella,1,1,0,1,0,1,1,0,0,0,0,0,1,0,0
https://fbref.com/en/players/14b8fcdf/Daniele-Rugani,7,0,6,1,0,4,4,0,7,5,2,7,14,32,0
https://fbref.com/en/players/0d82903c/Alex-Sandro,35,20,16,16,3,15,22,7,27,10,17,15,50,64,1
https://fbref.com/en/players/c13ddd3e/Matias-Soule,7,4,3,2,2,5,7,2,7,1,6,3,10,3,0
https://fbref.com/en/players/01b8a2b2/Wojciech-Szczesny,1,0,1,0,0,0,1,1,0,0,0,0,1,7,0
https://fbref.com/en/players/79443529/Dusan-Vlahovic,11,6,0,7,4,4,10,6,10,3,7,3,14,8,1
https://fbref.com/en/players/384d58d9/Denis-Zakaria,6,3,1,4,1,2,2,0,2,0,2,2,8,1,0
https://fbref.com/en/players/22919e97/Sargis-Adamyan,14,7,5,3,6,7,17,10,12,0,12,4,18,5,0
https://fbref.com/en/players/ae7058f9/Julian-Chabot,36,23,19,14,3,20,35,15,30,18,12,41,77,105,0
https://fbref.com/en/players/d82a310a/Justin-Diehl,0,0,0,0,0,0,0,0,0,0,0,0,0,0,0
https://fbref.com/en/players/8779ddf8/Florian-Dietz,2,1,0,2,0,1,4,3,4,1,3,0,2,2,0
https://fbref.com/en/players/79ca3e23/Ondrej-Duda,9,8,2,5,2,4,11,7,7,1,6,2,11,3,0
https://fbref.com/en/players/76b2817e/Kingsley-Ehizibue,0,0,0,0,0,0,0,0,1,0,1,2,2,1,0
https://fbref.com/en/players/c2009df3/Jonas-Hector,112,66,59,43,10,66,113,47,61,9,52,39,151,74,1
https://fbref.com/en/players/94302c52/Timo-Hubers,43,28,35,8,0,24,52,28,27,13,14,58,101,153,0
https://fbref.com/en/players/b116c6e3/Denis-Huseinbasic,23,9,8,11,4,10,25,15,16,2,14,4,27,5,0
https://fbref.com/en/players/94c18565/Florian-Kainz,21,10,7,12,2,8,26,18,27,6,21,32,53,30,1
https://fbref.com/en/players/610aa1e9/Luca-Kilian,22,16,14,7,1,12,21,9,16,8,8,11,33,48,0
https://fbref.com/en/players/792ffa71/Tim-Lemperle,6,4,3,1,2,3,5,2,5,0,5,1,7,4,0
https://fbref.com/en/players/62c7067a/Dimitris-Limnios,0,0,0,0,0,0,0,0,0,0,0,1,1,0,0
https://fbref.com/en/players/c455a2b2/Dejan-Ljubicic,25,14,7,14,4,13,40,27,20,1,19,8,33,8,1
https://fbref.com/en/players/e5d85da8/Linton-Maina,18,12,5,11,2,7,30,23,19,0,19,5,23,9,0
https://fbref.com/en/players/92a16062/Eric-Martel,66,41,29,30,7,30,60,30,29,9,20,33,99,49,0
https://fbref.com/en/players/86adbcc7/Mathias-Olesen,10,5,4,4,2,5,8,3,6,1,5,2,12,3,0
https://fbref.com/en/players/5154b2ba/Kristian-Pedersen,5,4,4,1,0,0,2,2,3,0,3,6,11,17,0
https://fbref.com/en/players/bd527260/Kingsley-Schindler,23,12,13,8,2,18,28,10,14,2,12,15,38,24,0
https://fbref.com/en/players/ad00b1a8/Benno-Schmitz,64,42,31,28,5,42,82,40,34,4,30,26,90,57,0
https://fbref.com/en/players/87436846/Marvin-Schwabe,1,0,1,0,0,1,1,0,0,0,0,2,3,8,2
https://fbref.com/en/players/1238a3f9/Davie-Selke,0,0,0,0,0,0,4,4,4,1,3,0,0,11,0
https://fbref.com/en/players/c2211709/Ellyes-Skhiri,79,44,29,42,8,26,66,40,52,12,40,56,135,48,0
https://fbref.com/en/players/4f627629/Nikola-Soldo,15,9,8,7,0,7,11,4,7,6,1,7,22,28,0
https://fbref.com/en/players/fd53759d/Jan-Thielmann,9,8,3,4,2,2,11,9,16,3,13,9,18,7,0
https://fbref.com/en/players/6b8887c2/Steffen-Tigges,12,7,1,8,3,4,14,10,13,2,11,8,20,17,0
https://fbref.com/en/players/a3ddb1b9/Mark-Uth,0,0,0,0,0,0,0,0,0,0,0,0,0,0,0
https://fbref.com/en/players/5294a83f/Luis-Alberto,49,29,18,20,11,23,72,49,35,6,29,9,58,4,0
https://fbref.com/en/players/9f1893b9/Felipe-Anderson,80,50,31,41,8,31,88,57,58,6,52,31,111,27,0
https://fbref.com/en/players/108fe016/Marcos-Antonio,9,6,4,5,0,9,20,11,7,2,5,11,20,18,0
https://fbref.com/en/players/80556f08/Toma-Basic,6,4,4,1,1,3,8,5,9,0,9,7,13,8,0
https://fbref.com/en/players/4b520f96/Marco-Bertini,0,0,0,0,0,0,0,0,0,0,0,0,0,0,0
https://fbref.com/en/players/b6a1cdf9/Matteo-Cancellieri,10,4,5,3,2,5,9,4,4,0,4,1,11,2,0
https://fbref.com/en/players/3f5f38fb/Nicolo-Casale,42,20,28,14,0,22,34,12,25,17,8,17,59,73,1
https://fbref.com/en/players/ba3d3bea/Danilo-Cataldi,25,16,7,15,3,14,40,26,23,9,14,24,49,33,0
https://fbref.com/en/players/9c435456/Mario-Gila,3,1,3,0,0,0,1,1,0,0,0,3,6,3,0
https://fbref.com/en/players/2f3452eb/Elseid-Hysaj,39,23,24,11,4,23,41,18,31,7,24,20,59,42,0
https://fbref.com/en/players/4431aed2/Ciro-Immobile,11,5,4,4,3,6,9,3,10,2,8,1,12,14,0
https://fbref.com/en/players/02caf6e0/Manuel-Lazzari,33,21,13,14,6,21,36,15,20,6,14,18,51,36,1
https://fbref.com/en/players/d4535821/Adam-Marusic,41,30,23,14,4,25,39,14,20,6,14,38,79,63,1
https://fbref.com/en/players/3318286e/Luis-Maximiano,0,0,0,0,0,0,0,0,0,0,0,0,0,0,0
https://fbref.com/en/players/4e6dbac4/Sergej-Milinkovic-Savic,58,35,22,23,13,24,67,43,50,12,38,28,86,49,0
https://fbref.com/en/players/f7223718/Patric,17,11,12,3,2,11,16,5,17,12,5,11,28,53,1
https://fbref.com/en/players/3ca7254a/Pedro,35,24,14,10,11,11,30,19,18,2,16,6,41,4,1
https://fbref.com/en/players/3b61c9ec/Luca-Pellegrini,1,0,0,1,0,1,4,3,3,0,3,7,8,4,0
https://fbref.com/en/players/277da414/Ivan-Provedel,1,0,1,0,0,0,0,0,0,0,0,0,1,15,1
https://fbref.com/en/players/53de807a/Stefan-Radu,0,0,0,0,0,0,0,0,0,0,0,0,0,0,0
https://fbref.com/en/players/3ead85f9/Alessio-Romagnoli,33,15,19,14,0,11,22,11,33,26,7,38,71,108,0
https://fbref.com/en/players/ca6edaa0/Luka-Romero,0,0,0,0,0,0,3,3,4,0,4,3,3,1,0
https://fbref.com/en/players/44ac04e9/Matias-Vecino,47,27,13,23,11,23,48,25,33,10,23,16,63,39,1
https://fbref.com/en/players/d85c238b/Mattia-Zaccagni,42,28,16,18,8,14,38,24,37,3,34,21,63,10,1
https://fbref.com/en/players/a69cc629/Kristoffer-Askildsen,7,3,2,3,2,4,10,6,15,4,11,11,18,6,0
https://fbref.com/en/players/8a6de8c7/Lameck-Banda,30,20,13,14,3,15,41,26,24,2,22,8,38,5,0
https://fbref.com/en/players/5a08ee41/Federico-Baschirotto,40,30,35,5,0,22,36,14,45,29,16,36,76,192,0
https://fbref.com/en/players/79370f8c/Kristijan-Bistrovic,3,1,3,0,0,0,5,5,3,0,3,0,3,4,0
https://fbref.com/en/players/c69ef855/Alexis-Blin,69,39,27,33,9,38,73,35,55,15,40,34,103,74,0
https://fbref.com/en/players/6c4307ee/Tommaso-Cassandro,1,1,0,1,0,0,0,0,1,1,0,0,1,0,0
https://fbref.com/en/players/4d1efb48/Pietro-Ceccaroni,0,0,0,0,0,0,0,0,1,1,0,3,3,2,0
https://fbref.com/en/players/07f8bcc8/Assan-Ceesay,23,18,7,8,8,9,17,8,15,2,13,3,26,24,0
https://fbref.com/en/players/04df29a5/Lorenzo-Colombo,17,9,1,9,7,6,14,8,22,0,22,2,19,7,0
https://fbref.com/en/players/2990c466/Kastriot-Dermaku,0,0,0,0,0,0,0,0,0,0,0,0,0,0,0
https://fbref.com/en/players/1fca9171/Federico-Di-Francesco,28,16,7,11,10,9,19,10,16,0,16,8,36,14,0
https://fbref.com/en/players/9f5a610b/Wladimiro-Falcone,2,0,2,0,0,2,2,0,0,0,0,2,4,21,3
https://fbref.com/en/players/c74d63ac/Antonino-Gallo,56,36,35,12,9,38,57,19,37,6,31,13,69,71,0
https://fbref.com/en/players/822ed0ec/Valentin-Gendrey,88,57,54,25,9,40,71,31,45,4,41,37,125,89,0
https://fbref.com/en/players/f025eade/Joan-Gonzalez,48,28,20,18,10,17,51,34,37,8,29,16,64,28,0
https://fbref.com/en/players/d4456fb3/Morten-Hjulmand,90,52,49,40,1,37,67,30,43,11,32,72,162,54,0
https://fbref.com/en/players/dc765618/Thorir-Johann-Helgason,2,2,1,0,1,2,3,1,3,1,2,3,5,3,0
https://fbref.com/en/players/a3695ac2/Marcin-Listkowski,0,0,0,0,0,0,0,0,0,0,0,3,3,2,0
https://fbref.com/en/players/4c8845f7/Youssef-Maleh,17,8,3,7,7,6,14,8,20,1,19,5,22,10,0
https://fbref.com/en/players/c730da00/Yildirim-Mert-Cetin,1,0,1,0,0,0,0,0,0,0,0,1,2,1,0
https://fbref.com/en/players/ea02beaf/Remi-Oudin,25,13,9,12,4,10,23,13,16,2,14,29,54,23,0
https://fbref.com/en/players/149c5f5d/Giuseppe-Pezzella,21,9,16,2,3,9,16,7,11,3,8,8,29,31,1
https://fbref.com/en/players/2a6cd437/Marin-Pongracic,16,14,8,7,1,5,7,2,4,3,1,16,32,31,0
https://fbref.com/en/players/1d4e63b6/Pablo-Rodriguez,2,1,2,0,0,0,2,2,3,0,3,0,2,0,0
https://fbref.com/en/players/09899de8/Simone-Romagnoli,6,5,3,3,0,2,2,0,4,1,3,1,7,11,0
https://fbref.com/en/players/674cfc5a/Gabriel-Strefezza,50,24,18,20,12,27,53,26,36,3,33,16,66,15,0
https://fbref.com/en/players/26c54058/Alessandro-Tuia,10,6,6,4,0,3,9,6,3,1,2,15,25,29,0
https://fbref.com/en/players/3eed9821/Samuel-Umtiti,52,34,25,25,2,18,26,8,26,14,12,26,78,79,0
https://fbref.com/en/players/b3ef6517/Joel-Voelkerling-Persson,1,1,0,0,1,0,1,1,1,0,1,0,1,0,0
https://fbref.com/en/players/5bc43860/Brenden-Aaronson,45,18,16,22,7,15,46,31,43,3,40,5,50,6,1
https://fbref.com/en/players/2b09d998/Tyler-Adams,89,46,44,35,10,50,77,27,48,8,40,35,124,29,0
https://fbref.com/en/players/420d7c7d/Luke-Ayling,66,37,42,15,9,42,85,43,34,11,23,26,92,52,2
https://fbref.com/en/players/93feac6e/Patrick-Bamford,9,6,0,6,3,4,20,16,12,5,7,5,14,13,0
https://fbref.com/en/players/dc64b8b3/Liam-Cooper,38,23,27,9,2,23,36,13,16,8,8,34,72,57,3
https://fbref.com/en/players/e0d1510a/Cody-Drameh,5,4,0,4,1,2,3,1,0,0,0,1,6,1,0
https://fbref.com/en/players/24f59bb2/Junior-Firpo,47,25,27,15,5,24,46,22,23,7,16,24,71,40,0
https://fbref.com/en/players/9f1938ab/Adam-Forshaw,12,9,5,7,0,7,17,10,9,1,8,4,16,2,0
https://fbref.com/en/players/01962d0d/Joe-Gelhardt,6,2,1,3,2,3,5,2,5,0,5,0,6,4,0
https://fbref.com/en/players/75fdd638/Degnand-Gnonto,27,17,7,15,5,10,30,20,24,1,23,5,32,7,0
https://fbref.com/en/players/f3354c07/Sam-Greenwood,15,7,7,8,0,8,21,13,10,2,8,1,16,1,0
https://fbref.com/en/players/56d838f7/Darko-Gyabi,2,2,1,1,0,0,0,0,2,0,2,0,2,0,0
https://fbref.com/en/players/aa849a12/Jack-Harrison,41,17,5,15,21,12,52,40,47,2,45,22,63,25,0
https://fbref.com/en/players/c931d9f9/Daniel-James,6,2,1,3,2,3,6,3,4,0,4,2,8,2,0
https://fbref.com/en/players/6ad43f9a/Mateo-Joseph,0,0,0,0,0,0,0,0,1,0,1,0,0,1,0
https://fbref.com/en/players/282679b4/Mateusz-Klich,12,8,3,4,5,7,13,6,4,0,4,0,12,1,0
https://fbref.com/en/players/ea6bc03a/Robin-Koch,53,30,32,16,5,24,56,32,44,21,23,43,96,152,1
https://fbref.com/en/players/bba30585/Diego-Llorente,13,10,8,5,0,4,8,4,6,2,4,15,28,24,2
https://fbref.com/en/players/01c3aff5/Weston-McKennie,30,13,5,18,7,10,29,19,22,3,19,22,52,26,0
https://fbref.com/en/players/6b625ac2/Illan-Meslier,2,1,2,0,0,2,4,2,0,0,0,1,3,30,3
https://fbref.com/en/players/39769cff/Rasmus-Nissen,62,35,35,21,6,42,76,34,32,14,18,35,97,61,0
https://fbref.com/en/players/cda0b317/Joel-Robles,0,0,0,0,0,0,1,1,0,0,0,0,0,2,1
https://fbref.com/en/players/da27e268/Marc-Roca,66,40,27,34,5,20,65,45,34,10,24,23,89,24,2
https://fbref.com/en/players/1fb1c435/Rodrigo,24,10,2,15,7,8,19,11,16,4,12,6,30,21,1
https://fbref.com/en/players/c64c01fc/Georginio-Rutter,10,9,5,3,2,5,8,3,5,0,5,3,13,3,0
https://fbref.com/en/players/8e16dd48/Luis-Sinisterra,21,14,8,9,4,11,18,7,11,1,10,8,29,2,0
https://fbref.com/en/players/f4d296e4/Pascal-Struijk,84,57,43,31,10,49,75,26,32,12,20,32,116,70,1
https://fbref.com/en/players/df04eb4b/Crysencio-Summerville,30,20,14,14,2,11,23,12,20,2,18,13,43,11,0
https://fbref.com/en/players/4b803b3c/Maximilian-Wober,25,18,9,15,1,16,24,8,32,14,18,27,52,67,1
https://fbref.com/en/players/b827d5b3/Marc-Albrighton,4,1,0,2,2,1,8,7,6,2,4,1,5,5,0
https://fbref.com/en/players/1a4ef233/Daniel-Amartey,19,8,13,5,1,12,14,2,24,17,7,8,27,71,0
https://fbref.com/en/players/3ea50f67/Harvey-Barnes,26,14,8,14,4,14,42,28,32,1,31,8,34,12,0
https://fbref.com/en/players/505486d6/Victor-Bernth-Kristiansen,38,23,18,16,4,22,30,8,16,4,12,3,41,26,0
https://fbref.com/en/players/a2081c6b/Lewis-Brunt,0,0,0,0,0,0,0,0,0,0,0,0,0,2,0
https://fbref.com/en/players/197640fd/Timothy-Castagne,87,44,53,27,7,41,84,43,50,13,37,43,130,110,0
https://fbref.com/en/players/ca45605e/Patson-Daka,14,8,6,8,0,3,12,9,14,2,12,7,21,7,0
https://fbref.com/en/players/5c74c0f5/Kiernan-Dewsbury-Hall,53,29,14,34,5,19,47,28,55,13,42,28,81,21,0
https://fbref.com/en/players/f8fcd2a5/Jonny-Evans,13,5,12,1,0,7,11,4,15,11,4,18,31,51,0
https://fbref.com/en/players/9c221d14/Wout-Faes,56,33,28,26,2,28,44,16,53,37,16,41,97,113,2
https://fbref.com/en/players/132a82f1/Wesley-Fofana,4,2,1,2,1,1,3,2,1,1,0,9,13,5,0
https://fbref.com/en/players/c92e1a31/Kelechi-Iheanacho,7,2,0,3,4,3,10,7,9,1,8,0,7,8,0
https://fbref.com/en/players/10d221cd/Daniel-Iversen,0,0,0,0,0,0,0,0,0,0,0,0,0,6,1
https://fbref.com/en/players/fb614c44/James-Justin,20,18,7,12,1,9,14,5,24,6,18,15,35,47,0
https://fbref.com/en/players/ee38d9c5/James-Maddison,51,26,25,19,7,19,50,31,19,1,18,13,64,6,1
https://fbref.com/en/players/1598599e/Nampalys-Mendy,13,9,7,6,0,8,15,7,20,4,16,13,26,2,0
https://fbref.com/en/players/6b47c5db/Wilfred-Ndidi,61,42,34,24,3,17,43,26,32,14,18,38,99,48,3
https://fbref.com/en/players/75a72a99/Ricardo-Pereira,11,7,8,3,0,7,17,10,8,2,6,4,15,20,0
https://fbref.com/en/players/819aa8e7/Ayoze-Perez,11,8,5,4,2,8,19,11,6,0,6,2,13,3,0
https://fbref.com/en/players/86695068/Dennis-Praet,12,9,5,6,1,6,11,5,12,2,10,5,17,6,0
https://fbref.com/en/players/ae59b359/Boubakary-Soumare,57,34,29,26,2,23,43,20,15,4,11,33,90,27,1
https://fbref.com/en/players/0a6cb1b1/Harry-Souttar,15,9,10,5,0,7,18,11,16,12,4,12,27,45,0
https://fbref.com/en/players/21166ff4/Caglar-Soyuncu,14,9,10,4,0,7,10,3,9,8,1,7,21,30,0
https://fbref.com/en/players/7120a04d/Tete,14,8,5,7,2,6,21,15,9,0,9,2,16,3,0
https://fbref.com/en/players/fc027d02/Luke-Thomas,23,19,15,5,3,15,32,17,20,4,16,27,50,35,0
https://fbref.com/en/players/56f7a928/Youri-Tielemans,66,39,27,30,9,23,61,38,35,8,27,28,94,24,1
https://fbref.com/en/players/45963054/Jamie-Vardy,10,5,4,3,3,1,7,6,17,3,14,2,12,30,0
https://fbref.com/en/players/d3ce0e89/Danny-Ward,1,1,1,0,0,1,3,2,0,0,0,0,1,14,2
https://fbref.com/en/players/82464ce3/Salis-Abdul-Samed,46,26,18,23,5,29,52,23,38,9,29,36,82,26,0
https://fbref.com/en/players/e4114f5d/Patrick-Berg,0,0,0,0,0,0,1,1,0,0,0,1,1,0,0
https://fbref.com/en/players/62e02107/Ismaelben-Boura,6,4,4,2,0,5,6,1,2,1,1,2,8,3,0
https://fbref.com/en/players/3b676989/Adam-Buksa,1,0,0,0,1,0,3,3,0,0,0,0,1,0,0
https://fbref.com/en/players/46359159/Jimmy-Cabot,20,12,10,8,2,12,26,14,5,0,5,4,24,12,0
https://fbref.com/en/players/741418c3/Alexis-Claude-Maurice,14,9,5,8,1,6,16,10,6,0,6,2,16,1,0
https://fbref.com/en/players/59948ef7/David-Pereira-da-Costa,13,7,1,10,2,7,19,12,19,1,18,11,24,6,0
https://fbref.com/en/players/6e33125f/Kevin-Danso,37,19,25,11,1,19,30,11,48,34,14,33,70,124,0
https://fbref.com/en/players/5313ed43/Seko-Fofana,28,13,8,18,2,15,39,24,17,4,13,19,47,14,0
https://fbref.com/en/players/574aa9ec/Steven-Fortes,0,0,0,0,0,0,0,0,0,0,0,0,0,0,0
https://fbref.com/en/players/00a8d210/Przemyslaw-Frankowski,77,51,37,31,9,39,80,41,38,6,32,41,118,42,2
https://fbref.com/en/players/4b96c347/Angelo-Fulgini,14,7,2,4,8,5,14,9,11,0,11,8,22,2,0
https://fbref.com/en/players/23c63b7f/Ignatius-Ganago,0,0,0,0,0,0,0,0,0,0,0,0,0,1,0
https://fbref.com/en/players/06c48679/Jonathan-Gradit,62,40,30,25,7,31,53,22,40,26,14,38,100,83,0
https://fbref.com/en/players/5167c97e/Massadio-Haidara,24,16,9,9,6,12,24,12,26,9,17,36,60,39,1
https://fbref.com/en/players/5b1bf5e3/Gael-Kakuta,0,0,0,0,0,0,0,0,0,0,0,0,0,1,0
https://fbref.com/en/players/c90f380c/Remy-Labeau-Lascary,4,2,4,0,0,0,0,0,4,0,4,1,5,0,0
https://fbref.com/en/players/547a72ad/Julien-Le-Cardinal,6,4,5,0,1,4,6,2,3,0,3,2,8,5,0
https://fbref.com/en/players/edbe46dc/Jean-Louis-Leca,0,0,0,0,0,0,0,0,0,0,0,0,0,0,1
https://fbref.com/en/players/b3f8bdef/Deiver-Machado,45,26,18,20,7,21,34,13,21,4,17,21,66,27,0
https://fbref.com/en/players/6f5ec8bb/Facundo-Medina,31,20,16,15,0,13,35,22,25,9,16,26,57,62,1
https://fbref.com/en/players/b5bb8188/Jean-Onana,28,17,8,17,3,10,22,12,15,5,10,18,46,20,0
https://fbref.com/en/players/8652a85c/Lois-Openda,11,9,2,6,3,2,13,11,9,0,9,2,13,6,0
https://fbref.com/en/players/be98f358/Lukasz-Poreba,5,4,2,1,2,2,3,1,3,0,3,4,9,2,0
https://fbref.com/en/players/90fcf472/Wesley-Said,4,1,1,2,1,2,6,4,4,0,4,1,5,2,0
https://fbref.com/en/players/60d90c55/Brice-Samba,1,0,1,0,0,1,2,1,1,0,1,0,1,12,2
https://fbref.com/en/players/7a42d0df/Florian-Sotoca,39,19,11,17,11,15,40,25,41,2,39,29,68,51,0
https://fbref.com/en/players/c76b7567/Adrien-Thomasson,24,17,8,11,5,12,45,33,25,2,23,4,28,17,0
https://fbref.com/en/players/b003239d/Christopher-Wooh,0,0,0,0,0,0,1,1,0,0,0,0,0,1,0
https://fbref.com/en/players/dcfb17f4/Amine-Adli,18,10,4,6,8,5,17,12,28,2,26,6,24,7,0
https://fbref.com/en/players/555d5edd/Nadiem-Amiri,15,6,5,8,2,9,20,11,12,1,11,6,21,10,2
https://fbref.com/en/players/e0b113a7/Robert-Andrich,61,38,30,27,4,26,45,19,27,9,18,42,103,55,2
https://fbref.com/en/players/56413b1f/Charles-Aranguiz,17,7,7,10,0,12,20,8,4,0,4,7,24,4,0
https://fbref.com/en/players/ce81d82d/Ayman-Azhil,0,0,0,0,0,0,0,0,0,0,0,0,0,0,0
https://fbref.com/en/players/10549b49/Sardar-Azmoun,6,3,1,4,1,1,7,6,4,0,4,2,8,14,0
https://fbref.com/en/players/a8567629/Mitchel-Bakker,16,8,9,7,0,6,15,9,20,2,18,15,31,20,2
https://fbref.com/en/players/bee0bab1/Karim-Bellarabi,2,0,1,1,0,2,3,1,0,0,0,0,2,0,0
https://fbref.com/en/players/54b4dc4e/Kerem-Demirbay,36,18,16,17,3,18,34,16,26,6,20,16,52,11,0
https://fbref.com/en/players/aeed5c06/Moussa-Diaby,14,8,4,8,2,7,14,7,8,0,8,5,19,3,0
https://fbref.com/en/players/a9142dc3/Timothy-Fosu-Mensah,7,5,3,3,1,4,4,0,2,0,2,0,7,1,0
https://fbref.com/en/players/74f2e748/Jeremie-Frimpong,53,27,22,26,5,23,44,21,24,3,21,16,69,40,0
https://fbref.com/en/players/0c7a48f8/Piero-Hincapie,51,34,28,20,3,25,38,13,41,20,21,31,82,83,1
https://fbref.com/en/players/5521f419/Adam-Hlozek,9,4,4,3,2,3,9,6,9,2,7,6,15,9,0
https://fbref.com/en/players/ad3389d5/Lukas-Hradecky,0,0,0,0,0,0,0,0,0,0,0,0,0,3,3
https://fbref.com/en/players/15f3ec41/Callum-Hudson-Odoi,5,3,4,0,1,1,1,0,0,0,0,2,7,4,0
https://fbref.com/en/players/1f3afdcb/Odilon-Kossonou,21,14,12,7,2,8,16,8,26,11,15,24,45,58,1
https://fbref.com/en/players/8a6ab963/Andrey-Lunyov,0,0,0,0,0,0,0,0,0,0,0,0,0,0,0
https://fbref.com/en/players/e75129bd/Noah-Mbamba,0,0,0,0,0,0,0,0,0,0,0,0,0,0,0
https://fbref.com/en/players/e82adcab/Exequiel-Palacios,59,36,20,33,6,29,48,19,29,2,27,33,92,28,0
https://fbref.com/en/players/53070b63/Paulinho,0,0,0,0,0,0,0,0,1,0,1,0,0,2,0
https://fbref.com/en/players/ea003d07/Joel-Pohjanpalo,0,0,0,0,0,0,0,0,0,0,0,0,0,0,0
https://fbref.com/en/players/5d4f7d61/Patrik-Schick,0,0,0,0,0,0,1,1,4,1,3,1,1,7,0
https://fbref.com/en/players/73000a79/Daley-Sinkgraven,10,7,7,3,0,7,9,2,8,4,4,5,15,7,0
https://fbref.com/en/players/bd142efb/Jonathan-Tah,25,12,21,4,0,12,18,6,30,18,12,40,65,118,0
https://fbref.com/en/players/a73c8f95/Edmond-Tapsoba,51,30,35,12,4,30,42,12,40,17,23,36,87,109,1
https://fbref.com/en/players/e7fcf289/Florian-Wirtz,18,10,9,7,2,8,16,8,15,1,14,1,19,6,0
https://fbref.com/en/players/ef9c1c95/Benjamin-Andre,128,74,51,60,17,65,121,56,50,8,42,47,175,60,0
https://fbref.com/en/players/a1390d2f/Carlos-Baleba,13,11,2,9,2,9,14,5,13,3,10,1,14,3,2
https://fbref.com/en/players/b2bd0f6c/Jonathan-Bamba,37,17,12,14,11,14,45,31,36,1,35,22,59,14,0
https://fbref.com/en/players/148e136f/Remy-Cabella,64,37,21,28,15,29,64,35,41,5,36,17,81,7,1
https://fbref.com/en/players/f5dfc256/Leonardo-Cesar-Jardim,NA,0,NA,NA,NA,NA,NA,NA,NA,NA,NA,0,NA,NA,NA
https://fbref.com/en/players/b3d76d84/Lucas-Chevalier,2,1,2,0,0,2,2,0,1,0,1,2,4,7,2
https://fbref.com/en/players/ce50fd99/Jonathan-David,24,17,6,11,7,10,27,17,20,2,18,8,32,13,0
https://fbref.com/en/players/1bfb6fef/Bafode-Diakite,54,35,23,24,7,32,57,25,37,8,29,17,71,58,0
https://fbref.com/en/players/b2336681/Tiago-Djalo,31,21,23,7,1,13,20,7,17,11,6,23,54,60,1
https://fbref.com/en/players/90f87966/Jose-Fonte,23,17,18,4,1,10,21,11,27,14,13,25,48,112,2
https://fbref.com/en/players/1961b2aa/Andre-Gomes,37,19,12,17,8,19,52,33,20,5,15,9,46,16,1
https://fbref.com/en/players/645a3363/Angel-Gomes,41,19,12,21,8,18,49,31,22,2,20,13,54,11,1
https://fbref.com/en/players/d5d22a58/Gabriel-Gudmundsson,19,11,7,10,2,12,22,10,11,2,9,10,29,20,0
https://fbref.com/en/players/cf182add/Ismaily,41,18,16,16,9,17,32,15,25,5,20,21,62,39,0
https://fbref.com/en/players/01870104/Mohamed-Lamine-Bayo,3,3,0,2,1,0,12,12,3,1,2,0,3,1,0
https://fbref.com/en/players/468fdbad/Jonas-Martin,9,7,4,5,0,5,14,9,3,1,2,7,16,3,0
https://fbref.com/en/players/f29131b5/Amine-Messoussa,0,0,0,0,0,0,0,0,0,0,0,0,0,0,0
https://fbref.com/en/players/ed90babd/Adam-Ounas,20,11,4,10,6,8,13,5,16,0,16,7,27,5,0
https://fbref.com/en/players/ed8cecc9/Simon-Ramet,0,0,0,0,0,0,0,0,0,0,0,0,0,0,0
https://fbref.com/en/players/102c9665/Alexsandro-Ribeiro,32,18,24,7,1,19,28,9,11,2,9,25,57,59,1
https://fbref.com/en/players/01becd60/Alan-Virginius,3,2,1,1,1,0,4,4,0,0,0,2,5,1,0
https://fbref.com/en/players/8eec784d/Timothy-Weah,24,14,13,9,2,16,29,13,17,3,14,23,47,18,0
https://fbref.com/en/players/f5c8b425/Yusuf-Yazici,0,0,0,0,0,0,0,0,2,0,2,0,0,1,0
https://fbref.com/en/players/6763f716/Leny-Yoro,11,5,8,3,0,4,9,5,6,1,5,18,29,27,1
https://fbref.com/en/players/0ff630d0/Akim-Zedadka,1,1,1,0,0,0,2,2,3,0,3,2,3,6,0
https://fbref.com/en/players/34a88e3e/Edon-Zhegrova,18,12,6,7,5,12,20,8,9,0,9,2,20,2,0
https://fbref.com/en/players/77e84962/Thiago-Alcantara,43,24,20,21,2,14,23,9,15,3,12,21,64,13,2
https://fbref.com/en/players/cd1acf9d/Trent-Alexander-Arnold,57,40,32,16,9,42,79,37,25,7,18,43,100,41,2
https://fbref.com/en/players/7a2e46a8/Alisson,0,0,0,0,0,0,3,3,3,0,3,0,0,20,0
https://fbref.com/en/players/32e8417f/Stefan-Bajcetic,9,6,5,3,1,8,27,19,7,0,7,9,18,4,0
https://fbref.com/en/players/966e28d0/Fabio-Carvalho,8,8,3,3,2,3,6,3,6,0,6,6,14,0,0
https://fbref.com/en/players/73341ace/Bobby-Clark,0,0,0,0,0,0,0,0,2,0,2,0,0,0,0
https://fbref.com/en/players/4a1a9578/Luis-Diaz,17,11,4,8,5,8,15,7,8,0,8,6,23,2,0
https://fbref.com/en/players/733f1a7d/Ben-Doak,3,2,1,2,0,1,1,0,1,0,1,0,3,0,0
https://fbref.com/en/players/c8387671/Harvey-Elliott,27,18,6,12,9,9,36,27,26,1,25,15,42,8,0
https://fbref.com/en/players/7f3b388c/Fabinho,65,38,18,40,7,24,62,38,38,11,27,37,102,40,0
https://fbref.com/en/players/4c370d81/Roberto-Firmino,17,12,2,12,3,4,21,17,16,1,15,7,24,2,0
https://fbref.com/en/players/1971591f/Cody-Gakpo,26,15,4,13,9,13,38,25,13,1,12,4,30,2,0
https://fbref.com/en/players/7a11550b/Joe-Gomez,28,21,15,11,2,11,19,8,17,11,6,24,52,51,2
https://fbref.com/en/players/935e6b8f/Jordan-Henderson,32,23,10,18,4,15,36,21,21,3,18,21,53,16,1
https://fbref.com/en/players/4fb9c88f/Curtis-Jones,34,17,8,12,14,18,31,13,12,2,10,3,37,9,0
https://fbref.com/en/players/178ae8f8/Diogo-Jota,23,15,8,8,7,12,37,25,5,0,5,3,26,11,0
https://fbref.com/en/players/f25c8e3a/Naby-Keita,5,4,2,3,0,1,4,3,1,0,1,2,7,3,0
https://fbref.com/en/players/62d7ef38/Caoimhin-Kelleher,0,0,0,0,0,0,0,0,0,0,0,0,0,0,0
https://fbref.com/en/players/5ed9b537/Ibrahima-Konate,38,26,25,13,0,16,27,11,12,5,7,26,64,61,4
https://fbref.com/en/players/b217ef29/Joel-Matip,14,8,12,2,0,11,23,12,8,3,5,21,35,45,3
https://fbref.com/en/players/2f90f6b8/James-Milner,26,16,11,11,4,15,34,19,14,2,12,12,38,15,0
https://fbref.com/en/players/4d77b365/Darwin-Nunez,11,5,2,4,5,4,17,13,10,0,10,3,14,13,0
https://fbref.com/en/players/38c7feef/Alex-Oxlade-Chamberlain,5,4,1,2,2,1,5,4,5,2,3,1,6,4,0
https://fbref.com/en/players/515ebe8d/Nathaniel-Phillips,2,1,0,2,0,2,2,0,0,0,0,2,4,1,0
https://fbref.com/en/players/2e4f5f03/Andrew-Robertson,38,21,12,16,10,21,41,20,32,5,27,18,56,50,3
https://fbref.com/en/players/e342ad68/Mohamed-Salah,21,12,4,5,12,10,26,16,21,0,21,6,27,4,0
https://fbref.com/en/players/f315ca93/Kostas-Tsimikas,14,9,10,2,2,10,16,6,8,1,7,12,26,15,0
https://fbref.com/en/players/e06683ca/Virgil-van-Dijk,27,14,13,11,3,8,19,11,24,16,8,31,58,138,2
https://fbref.com/en/players/31626657/Laurent-Abergel,92,52,59,30,3,39,92,53,47,8,39,34,126,39,0
https://fbref.com/en/players/b94b8be1/Adil-Aouchiche,5,2,3,1,1,1,9,8,1,0,1,4,9,1,0
https://fbref.com/en/players/f6496133/Quentin-Boisgard,6,2,1,4,1,3,4,1,3,1,2,4,10,2,0
https://fbref.com/en/players/e3e32fbb/Igor-Carioca,18,11,12,2,4,12,21,9,7,0,7,5,23,17,0
https://fbref.com/en/players/4db5915d/Yoann-Cathline,19,12,7,6,6,5,12,7,10,1,9,8,27,16,1
https://fbref.com/en/players/29939a1d/Stephane-Diarra,25,17,14,9,2,11,29,18,13,1,12,22,47,9,0
https://fbref.com/en/players/40774c6b/Bamba-Dieng,19,10,5,12,2,3,11,8,6,0,6,2,21,6,0
https://fbref.com/en/players/92d90c8f/Ckene-Doucoure,2,2,2,0,0,1,2,1,0,0,0,1,3,0,0
https://fbref.com/en/players/745ca0a3/Romain-Faivre,13,8,5,4,4,5,25,20,11,0,11,1,14,4,0
https://fbref.com/en/players/4a987ffa/Adrian-Grbic,0,0,0,0,0,0,1,1,3,0,3,0,0,0,0
https://fbref.com/en/players/546bb36e/Bonke-Innocent,28,17,13,14,1,11,36,25,22,5,17,26,54,31,0
https://fbref.com/en/players/b2fe86e5/Eli-Junior-Kroupi,0,0,0,0,0,0,1,1,0,0,0,1,1,0,0
https://fbref.com/en/players/dd211559/Gedeon-Kalulu,64,34,43,14,7,30,48,18,32,3,29,28,92,79,2
https://fbref.com/en/players/0e8d7b6c/Ayman-Kari,0,0,0,0,0,0,0,0,4,0,4,3,3,0,0
https://fbref.com/en/players/04bb2b06/Ibrahima-Kone,24,13,3,13,8,5,11,6,13,0,13,4,28,18,0
https://fbref.com/en/players/f066022d/Julien-Laporte,22,16,18,3,1,16,22,6,33,27,6,18,40,108,2
https://fbref.com/en/players/2d22cea7/Armand-Lauriente,8,7,3,4,1,3,7,4,5,1,4,4,12,1,0
https://fbref.com/en/players/afe39ca8/Theo-Le-Bris,31,19,17,11,3,15,33,18,21,2,19,18,49,31,0
https://fbref.com/en/players/6f806d99/Enzo-Le-Fee,108,64,52,40,16,43,113,70,50,5,45,34,142,38,1
https://fbref.com/en/players/2321ea6e/Vincent-Le-Goff,75,32,56,16,3,45,62,17,29,9,20,41,116,105,1
https://fbref.com/en/players/22bfb57e/Jean-Victor-Makengo,16,8,5,10,1,6,20,14,8,5,3,10,26,13,1
https://fbref.com/en/players/c4173f1a/Vito-Mannone,0,0,0,0,0,0,0,0,0,0,0,0,0,4,3
https://fbref.com/en/players/cf1ef7ec/Chrislain-Matsima,0,0,0,0,0,0,0,0,3,3,0,2,2,7,0
https://fbref.com/en/players/04ac78d2/Bamo-Meite,18,8,13,4,1,7,16,9,33,23,10,16,34,70,0
https://fbref.com/en/players/065dc209/Terem-Moffi,8,5,1,4,3,3,5,2,11,3,8,3,11,10,0
https://fbref.com/en/players/dc29b608/Yvon-Mvogo,0,0,0,0,0,0,0,0,0,0,0,2,2,6,3
https://fbref.com/en/players/2f9e4435/Dango-Ouattara,41,26,20,11,10,15,28,13,24,6,18,19,60,21,0
https://fbref.com/en/players/e546b2e3/Julien-Ponceau,28,19,10,14,4,10,32,22,27,3,24,14,42,12,0
https://fbref.com/en/players/a4a44eb0/Montassar-Talbi,53,25,40,13,0,22,35,13,55,34,21,40,93,190,3
https://fbref.com/en/players/061266cd/Darlin-Yongwa,13,11,7,5,1,4,15,11,13,1,12,5,18,11,0
https://fbref.com/en/players/a5db0bec/Houssem-Aouar,12,5,5,5,2,3,9,6,12,2,10,8,20,3,0
https://fbref.com/en/players/508a9011/Mohamed-El-Arouch,1,1,1,0,0,0,0,0,0,0,0,0,1,0,0
https://fbref.com/en/players/a0d55a09/Bradley-Barcola,25,16,8,10,7,8,39,31,29,0,29,19,44,10,0
https://fbref.com/en/players/2db2fd7b/Jerome-Boateng,3,0,2,1,0,2,6,4,8,5,3,6,9,16,0
https://fbref.com/en/players/f81ef10d/Maxence-Caqueret,87,54,27,38,22,43,109,66,45,3,42,39,126,27,0
https://fbref.com/en/players/b34c63a5/Rayan-Cherki,14,8,2,5,7,8,23,15,6,0,6,5,19,1,0
https://fbref.com/en/players/1ec7e1c5/Damien-Da-Silva,8,7,5,3,0,3,3,0,4,3,1,5,13,12,0
https://fbref.com/en/players/e7986081/Moussa-Dembele,8,4,3,3,2,4,7,3,5,0,5,2,10,6,0
https://fbref.com/en/players/6de23ab0/Sinaly-Diomande,42,24,26,15,1,31,49,18,26,13,13,49,91,75,1
https://fbref.com/en/players/745ca0a3/Romain-Faivre,6,3,2,2,2,1,3,2,3,0,3,0,6,0,0
https://fbref.com/en/players/d56b9520/Malo-Gusto,42,26,23,11,8,21,43,22,22,5,17,28,70,23,1
https://fbref.com/en/players/f28474a4/Henrique,9,4,3,2,4,6,13,7,3,1,2,5,14,8,0
https://fbref.com/en/players/45cce300/Jefferson,17,4,4,9,4,6,15,9,6,0,6,1,18,0,0
https://fbref.com/en/players/c385bf49/Sael-Kumbedi,47,27,27,13,7,20,38,18,23,7,16,10,57,16,0
https://fbref.com/en/players/9dbb75ca/Alexandre-Lacazette,43,23,7,17,19,10,29,19,23,3,20,15,58,4,0
https://fbref.com/en/players/1e52971c/Johann-Lepenant,58,34,24,27,7,32,86,54,29,5,24,28,86,17,3
https://fbref.com/en/players/f00de885/Anthony-Lopes,1,0,1,0,0,1,4,3,0,0,0,3,4,10,0
https://fbref.com/en/players/1a2935f6/Dejan-Lovren,25,19,20,5,0,20,29,9,20,10,10,26,51,70,1
https://fbref.com/en/players/5b9512c5/Castello-Lukeba,39,23,27,8,4,21,31,10,42,24,18,75,114,105,1
https://fbref.com/en/players/c6e5d20f/Thiago-Mendes,48,27,24,21,3,30,40,10,28,8,20,47,95,51,4
https://fbref.com/en/players/9b6f7fd5/Lucas-Paqueta,5,4,0,5,0,1,3,2,2,0,2,1,6,3,0
https://fbref.com/en/players/d504b3e1/Jeff-Reine-Adelaide,8,5,1,5,2,5,9,4,4,0,4,6,14,0,0
https://fbref.com/en/players/7f41ee30/Remy-Riou,1,0,1,0,0,1,1,0,0,0,0,0,1,3,0
https://fbref.com/en/players/d5326924/Amin-Sarr,9,6,1,4,4,1,4,3,2,0,2,0,9,4,0
https://fbref.com/en/players/61f80c89/Mamadou-Sarr,0,0,0,0,0,0,0,0,0,0,0,0,0,0,0
https://fbref.com/en/players/f0661424/Nicolas-Tagliafico,91,53,36,41,14,50,78,28,45,11,34,57,148,47,0
https://fbref.com/en/players/7120a04d/Tete,21,10,8,5,8,10,19,9,9,0,9,13,34,2,0
https://fbref.com/en/players/5ceba7fc/Karl-Toko-Ekambi,9,9,2,4,3,4,15,11,12,2,10,9,18,6,0
https://fbref.com/en/players/652d4c37/Corentin-Tolisso,44,27,16,23,5,25,66,41,25,5,20,24,68,23,1
https://fbref.com/en/players/378825c7/Ramy-Bensebaini,34,21,21,10,3,26,39,13,44,14,30,36,70,98,1
https://fbref.com/en/players/36578017/Yvandro-Borges-Sanches,2,2,0,2,0,2,2,0,0,0,0,0,2,0,0
https://fbref.com/en/players/48035304/Nico-Elvedi,46,24,32,12,2,27,41,14,31,16,15,35,81,149,3
https://fbref.com/en/players/458e3479/Oscar-Fraulo,0,0,0,0,0,0,0,0,0,0,0,0,0,0,0
https://fbref.com/en/players/b77f44a4/Marvin-Friedrich,17,11,13,3,1,10,13,3,14,6,8,11,28,52,0
https://fbref.com/en/players/dfb6490a/Patrick-Herrmann,6,2,4,1,1,2,4,2,2,0,2,2,8,1,0
https://fbref.com/en/players/2903a856/Jonas-Hofmann,31,16,17,8,6,15,52,37,36,2,34,16,47,21,0
https://fbref.com/en/players/97d545ae/Ko-Itakura,29,17,18,7,4,16,30,14,41,25,16,27,56,95,0
https://fbref.com/en/players/fa4cabd1/Jan-Jakob-Olschowsky,0,0,0,0,0,0,1,1,1,0,1,0,0,1,0
https://fbref.com/en/players/34b54da7/Tony-Jantschke,2,1,1,1,0,1,1,0,5,3,2,0,2,5,0
https://fbref.com/en/players/86574238/Kouadio-Kone,74,39,37,33,4,24,47,23,44,12,32,32,106,21,0
https://fbref.com/en/players/496aeede/Christoph-Kramer,44,33,24,15,5,22,55,33,34,2,32,17,61,40,0
https://fbref.com/en/players/4aea5077/Stefan-Lainer,16,8,10,5,1,10,23,13,8,1,7,14,30,34,1
https://fbref.com/en/players/e110ea4b/Nathan-NGoumou,11,5,5,5,1,7,13,6,9,0,9,1,12,4,0
https://fbref.com/en/players/e79269bd/Luca-Netz,25,13,19,3,3,19,32,13,5,1,4,6,31,27,0
https://fbref.com/en/players/36a59ba4/Florian-Neuhaus,19,9,9,5,5,8,27,19,20,3,17,12,31,5,0
https://fbref.com/en/players/c631f952/Jonas-Omlin,1,1,1,0,0,1,3,2,1,0,1,0,1,9,1
https://fbref.com/en/players/bc6bd723/Alassane-Plea,16,8,5,7,4,8,26,18,23,3,20,12,28,14,0
https://fbref.com/en/players/cc971106/Rocco-Reitz,0,0,0,0,0,0,0,0,0,0,0,0,0,0,0
https://fbref.com/en/players/236f02cd/Joe-Scally,31,20,25,5,1,24,31,7,17,6,11,8,39,61,0
https://fbref.com/en/players/0d8a37c2/Tobias-Sippel,0,0,0,0,0,0,0,0,0,0,0,0,0,1,1
https://fbref.com/en/players/420c18a1/Yann-Sommer,1,0,1,0,0,1,1,0,0,0,0,0,1,8,0
https://fbref.com/en/players/7cd6badb/Lars-Stindl,24,14,4,17,3,10,28,18,24,5,19,11,35,19,0
https://fbref.com/en/players/0b45a8d7/Semir-Telalovic,0,0,0,0,0,0,0,0,0,0,0,0,0,0,0
https://fbref.com/en/players/6f8cd6d0/Marcus-Thuram,14,7,3,6,5,6,13,7,20,3,17,6,20,22,0
https://fbref.com/en/players/346d51d9/Julian-Weigl,43,16,21,21,1,23,41,18,23,2,21,18,61,32,0
https://fbref.com/en/players/be42a291/Hannes-Wolf,11,8,4,5,2,5,13,8,3,0,3,3,14,9,0
https://fbref.com/en/players/462475ed/Ludovic-Ajorque,6,5,1,4,1,1,9,8,8,2,6,1,7,8,0
https://fbref.com/en/players/a2a85828/Aymen-Barkok,18,8,10,5,3,5,10,5,7,0,7,3,21,9,0
https://fbref.com/en/players/00242b75/Leandro-Barreiro-Martins,60,38,19,28,13,22,49,27,38,13,25,41,101,39,1
https://fbref.com/en/players/857a5abe/Stefan-Bell,43,28,32,10,1,22,44,22,42,15,27,44,87,133,0
https://fbref.com/en/players/05e2d5ea/Delano-Burgzorg,3,3,1,1,1,2,3,1,2,0,2,0,3,2,0
https://fbref.com/en/players/05f99a4a/Jonathan-Burkardt,3,1,0,1,2,1,4,3,6,1,5,1,4,1,0
https://fbref.com/en/players/0118c54c/Anthony-Caci,58,33,32,20,6,28,42,14,28,4,24,54,112,40,0
https://fbref.com/en/players/5ddb8f9f/Danny-da-Costa,20,16,7,8,5,12,20,8,22,3,19,9,29,26,0
https://fbref.com/en/players/dee3013b/Finn-Dahmen,0,0,0,0,0,0,0,0,0,0,0,0,0,3,0
https://fbref.com/en/players/3bb625ac/Edimilson-Fernandes,35,25,26,5,4,18,34,16,37,16,21,54,89,87,2
https://fbref.com/en/players/4b96c347/Angelo-Fulgini,6,5,2,3,1,5,12,7,5,0,5,5,11,7,0
https://fbref.com/en/players/ae9b998d/Brajan-Gruda,0,0,0,0,0,0,0,0,0,0,0,0,0,0,0
https://fbref.com/en/players/a5ec3ede/Alexander-Hack,30,18,21,9,0,19,33,14,18,5,13,24,54,45,1
https://fbref.com/en/players/2e77d607/Andreas-Hanche-Olsen,35,23,24,7,4,22,39,17,16,8,8,33,68,77,2
https://fbref.com/en/players/271b8617/Marcus-Ingvartsen,4,1,0,2,2,1,10,9,9,1,8,4,8,10,0
https://fbref.com/en/players/34b0387f/Lee-Jae-sung,38,17,9,21,8,16,36,20,29,5,24,17,55,21,0
https://fbref.com/en/players/0fbecd11/Dominik-Kohr,59,33,23,31,5,29,61,32,46,9,37,34,93,26,1
https://fbref.com/en/players/7e12a98d/Maxim-Leitsch,9,7,6,3,0,4,5,1,7,4,3,18,27,26,1
https://fbref.com/en/players/2f3e911a/Aaron-Martin,42,27,25,11,6,21,40,19,22,1,21,15,57,31,0
https://fbref.com/en/players/9ff8ec4a/Suliman-Mustapha,2,2,0,2,0,0,0,0,4,0,4,0,2,0,0
https://fbref.com/en/players/f26834c7/Karim-Onisiwo,19,12,3,10,6,4,21,17,19,0,19,2,21,7,0
https://fbref.com/en/players/0c88efca/Eniss-Shabani,0,0,0,0,0,0,0,0,0,0,0,0,0,0,0
https://fbref.com/en/players/0f59a7bf/Anton-Stach,27,21,10,15,2,16,38,22,28,2,26,41,68,25,0
https://fbref.com/en/players/27270af4/Niklas-Tauer,2,1,2,0,0,1,3,2,2,1,1,2,4,4,0
https://fbref.com/en/players/231c67ff/Nelson-Weiper,2,0,0,0,2,1,3,2,2,0,2,0,2,1,0
https://fbref.com/en/players/f68b64fc/Silvan-Widmer,26,17,15,10,1,20,39,19,22,8,14,31,57,28,0
https://fbref.com/en/players/5c4bf6ba/Robin-Zentner,0,0,0,0,0,0,4,4,0,0,0,0,0,17,1
https://fbref.com/en/players/f3b1d9a2/Amath,29,19,14,8,7,14,22,8,13,1,12,5,34,5,0
https://fbref.com/en/players/4a5f2032/Josep-Antoni-Gaya,0,0,0,0,0,0,0,0,4,2,2,1,1,6,0
https://fbref.com/en/players/9fec8860/Ludwig-Augustinsson,2,1,2,0,0,1,3,2,1,0,1,1,3,3,0
https://fbref.com/en/players/bfd381b3/Iddrisu-Baba,31,17,15,16,0,15,32,17,18,8,10,11,42,39,0
https://fbref.com/en/players/d637fc22/Rodrigo-Battaglia,12,5,7,5,0,6,14,8,16,7,9,5,17,18,0
https://fbref.com/en/players/0f26ffd7/Copete,53,28,35,16,2,26,36,10,38,17,21,44,97,111,2
https://fbref.com/en/players/808d48f3/Jaume-Costa,50,34,26,17,7,29,51,22,13,5,8,22,72,44,1
https://fbref.com/en/players/192c89a6/Braian-Cufre,5,2,2,1,2,2,5,3,2,1,1,2,7,1,0
https://fbref.com/en/players/91f7631f/Inigo-Ruiz-de-Galarreta,54,38,27,23,4,20,52,32,26,9,17,30,84,19,0
https://fbref.com/en/players/1fc474ae/Giovanni-Gonzalez,16,8,11,2,3,9,22,13,8,2,6,7,23,22,0
https://fbref.com/en/players/30061f53/Dominik-Greif,0,0,0,0,0,0,0,0,0,0,0,0,0,0,0
https://fbref.com/en/players/8b298f56/Clement-Grenier,20,8,6,12,2,10,20,10,9,1,8,6,26,7,0
https://fbref.com/en/players/82cfae2a/Dennis-Hadzikadunic,9,6,4,5,0,4,4,0,5,4,1,3,12,27,0
https://fbref.com/en/players/360d70f8/Lago-Junior,1,0,0,1,0,1,1,0,0,0,0,0,1,0,0
https://fbref.com/en/players/7d08063d/Tino-Kadewere,6,3,3,3,0,4,9,5,6,2,4,2,8,1,0
https://fbref.com/en/players/8455ad90/Lee-Kangin,42,24,10,22,10,18,61,43,25,2,23,11,53,7,0
https://fbref.com/en/players/38b0cf42/Javier-Llabres,0,0,0,0,0,0,0,0,0,0,0,0,0,1,0
https://fbref.com/en/players/5db04597/Pablo-Maffeo,75,46,54,16,5,45,78,33,38,11,27,26,101,76,0
https://fbref.com/en/players/a0255c67/Manu-Morlanes,22,9,12,8,2,13,24,11,10,5,5,5,27,9,0
https://fbref.com/en/players/0cadc46d/Vedat-Muriqi,12,7,4,7,1,3,13,10,19,7,12,12,24,73,0
https://fbref.com/en/players/f35430a4/Matija-Nastasic,10,8,7,1,2,3,6,3,11,4,7,18,28,43,1
https://fbref.com/en/players/d1b060e2/Abdon-Prats,1,0,1,0,0,0,0,0,5,0,5,0,1,2,0
https://fbref.com/en/players/2f456b86/Ruben-Quintanilla,0,0,0,0,0,0,0,0,1,0,1,0,0,0,0
https://fbref.com/en/players/b857bd29/Antonio-Raillo,34,21,23,11,0,10,15,5,38,29,9,31,65,158,1
https://fbref.com/en/players/58ad9383/Predrag-Rajkovic,0,0,0,0,0,0,2,2,0,0,0,0,0,16,1
https://fbref.com/en/players/8cfc2f69/Angel-Rodriguez,1,1,0,1,0,0,2,2,3,0,3,1,2,1,0
https://fbref.com/en/players/70f8e0bd/Dani-Rodriguez,42,23,18,22,2,21,46,25,31,8,23,21,63,14,0
https://fbref.com/en/players/924ff27e/Leonardo-Roman,0,0,0,0,0,0,0,0,0,0,0,0,0,0,0
https://fbref.com/en/players/b75ac54b/Franco-Russo,2,1,2,0,0,0,1,1,5,0,5,3,5,5,0
https://fbref.com/en/players/a254bbe0/Antonio-Sanchez,19,8,13,4,2,10,34,24,18,0,18,22,41,14,1
https://fbref.com/en/players/f2c6ac01/Martin-Valjent,35,27,22,12,1,19,28,9,39,21,18,29,64,137,0
https://fbref.com/en/players/89ac64a6/Manuel-Akanji,36,25,15,18,3,23,36,13,27,9,18,16,52,33,0
https://fbref.com/en/players/eaeca114/Nathan-Ake,26,12,15,9,2,11,15,4,20,10,10,20,46,48,0
https://fbref.com/en/players/15ab5a2b/Julian-Alvarez,26,16,3,13,10,9,29,20,13,0,13,2,28,6,0
https://fbref.com/en/players/bd6351cd/Joao-Cancelo,29,21,16,9,4,17,24,7,7,1,6,19,48,9,1
https://fbref.com/en/players/5cc3ce65/Shea-Charles,4,0,4,0,0,1,1,0,0,0,0,1,5,2,0
https://fbref.com/en/players/e46012d4/Kevin-De-Bruyne,28,12,3,12,13,14,39,25,27,2,25,9,37,10,0
https://fbref.com/en/players/31c69ef1/Ruben-Dias,21,13,10,10,1,11,18,7,21,13,8,18,39,56,1
https://fbref.com/en/players/3bb7b8b4/Ederson,3,1,3,0,0,1,2,1,0,0,0,1,4,10,2
https://fbref.com/en/players/ed1e53f3/Phil-Foden,16,10,9,5,2,8,19,11,25,2,23,5,21,12,0
https://fbref.com/en/players/01e5f06e/Sergio-Gomez,9,4,6,1,2,5,8,3,5,3,2,2,11,9,1
https://fbref.com/en/players/b0b4fd3e/Jack-Grealish,25,16,10,12,3,13,22,9,17,3,14,7,32,9,0
https://fbref.com/en/players/819b3158/Ilkay-Gundogan,30,18,7,13,10,12,33,21,18,3,15,20,50,13,0
https://fbref.com/en/players/1f44ac21/Erling-Haaland,3,2,0,2,1,1,5,4,12,4,8,3,6,14,0
https://fbref.com/en/players/119b9a8e/Aymeric-Laporte,11,8,6,4,1,7,11,4,10,4,6,3,14,30,1
https://fbref.com/en/players/b57e066e/Rico-Lewis,16,9,9,5,2,6,11,5,8,4,4,6,22,13,1
https://fbref.com/en/players/892d5bb1/Riyad-Mahrez,30,14,8,13,9,13,38,25,27,1,26,9,39,5,0
https://fbref.com/en/players/c1242d4e/Stefan-Ortega,0,0,0,0,0,0,0,0,0,0,0,0,0,0,0
https://fbref.com/en/players/dc7f8a28/Cole-Palmer,5,1,0,3,2,3,5,2,2,1,1,1,6,2,0
https://fbref.com/en/players/53552942/Maximo-Perrone,0,0,0,0,0,0,0,0,1,0,1,0,0,0,0
https://fbref.com/en/players/4f565d77/Kalvin-Phillips,6,4,3,3,0,2,9,7,7,3,4,5,11,10,0
https://fbref.com/en/players/6434f10d/Rodri,67,41,28,28,11,26,52,26,40,14,26,33,100,43,1
https://fbref.com/en/players/3eb22ec9/Bernardo-Silva,44,23,11,25,8,18,44,26,23,6,17,16,60,6,0
https://fbref.com/en/players/5eecec3d/John-Stones,23,13,11,8,4,7,10,3,17,10,7,9,32,40,0
https://fbref.com/en/players/86dd77d1/Kyle-Walker,13,9,8,5,0,4,24,20,12,2,10,18,31,22,0
https://fbref.com/en/players/99127249/Antony,22,9,9,9,4,8,28,20,18,0,18,11,33,6,0
https://fbref.com/en/players/50dc94ce/Donny-van-de-Beek,0,0,0,0,0,0,1,1,2,1,1,1,1,1,0
https://fbref.com/en/players/4d224fe8/Casemiro,89,46,43,35,11,48,92,44,49,11,38,34,123,64,0
https://fbref.com/en/players/d9565625/Diogo-Dalot,54,41,40,13,1,33,45,12,25,7,18,37,91,55,2
https://fbref.com/en/players/2fba6108/Anthony-Elanga,3,0,0,2,1,1,2,1,4,0,4,2,5,4,0
https://fbref.com/en/players/980522ec/Christian-Eriksen,22,18,10,7,5,10,32,22,23,9,14,11,33,20,1
https://fbref.com/en/players/507c7bdf/Bruno-Fernandes,68,42,24,25,19,30,71,41,37,5,32,25,93,40,1
https://fbref.com/en/players/b853e0ad/Fred,47,30,24,20,3,15,38,23,38,2,36,19,66,19,0
https://fbref.com/en/players/7aa8adfe/Alejandro-Garnacho,5,2,2,0,3,1,11,10,5,0,5,5,10,3,0
https://fbref.com/en/players/7ba6d84e/David-de-Gea,0,0,0,0,0,0,1,1,0,0,0,1,1,15,3
https://fbref.com/en/players/f5deef4c/Victor-Lindelof,22,17,10,9,3,9,17,8,18,9,9,21,43,63,1
https://fbref.com/en/players/d8931174/Harry-Maguire,8,6,6,1,1,4,5,1,18,11,7,13,21,41,0
https://fbref.com/en/players/c6220452/Kobbie-Mainoo,0,0,0,0,0,0,0,0,1,1,0,0,0,0,0
https://fbref.com/en/players/6b6c793c/Tyrell-Malacia,46,33,33,12,1,14,25,11,13,3,10,25,71,49,0
https://fbref.com/en/players/8b788c01/Anthony-Martial,5,3,0,2,3,1,4,3,11,2,9,1,6,4,0
https://fbref.com/en/players/bac46a10/Lisandro-Martinez,54,28,33,18,3,30,43,13,51,27,24,33,87,103,0
https://fbref.com/en/players/d93c2511/Scott-McTominay,32,19,16,10,6,13,22,9,15,6,9,14,46,45,0
https://fbref.com/en/players/ac7e7b1c/Facundo-Pellistri,1,1,0,1,0,0,0,0,0,0,0,0,1,3,0
https://fbref.com/en/players/a1d5bd30/Marcus-Rashford,20,10,7,8,5,9,24,15,31,4,27,7,27,14,0
https://fbref.com/en/players/dea698d9/Cristiano-Ronaldo,2,2,1,0,1,1,2,1,0,0,0,1,3,9,0
https://fbref.com/en/players/e280527c/Marcel-Sabitzer,12,8,3,8,1,2,11,9,6,2,4,8,20,11,0
https://fbref.com/en/players/dbf053da/Jadon-Sancho,16,10,7,5,4,8,28,20,25,2,23,7,23,6,0
https://fbref.com/en/players/9c94165b/Luke-Shaw,55,36,31,22,2,32,45,13,51,17,34,36,91,55,2
https://fbref.com/en/players/9f8e9423/Raphael-Varane,24,9,18,6,0,7,17,10,24,17,7,11,35,91,0
https://fbref.com/en/players/9e525177/Aaron-Wan-Bissaka,40,25,20,17,3,23,25,2,24,8,16,22,62,41,0
https://fbref.com/en/players/c4e87b8b/Wout-Weghorst,11,5,6,1,4,2,9,7,7,2,5,7,18,9,0
https://fbref.com/en/players/a1232f4e/Eric-Bailly,13,10,6,6,1,7,7,0,15,12,3,12,25,18,1
https://fbref.com/en/players/0af4dcf0/Cedric-Bakambu,2,1,2,0,0,2,2,0,0,0,0,0,2,0,0
https://fbref.com/en/players/7c3ed041/Leonardo-Balerdi,57,37,43,12,2,32,45,13,48,29,19,63,120,91,1
https://fbref.com/en/players/1f6298f2/Salim-Ben-Seghir,0,0,0,0,0,0,0,0,1,0,1,0,0,0,0
https://fbref.com/en/players/967f34d3/Ruben-Blanco,0,0,0,0,0,0,0,0,0,0,0,0,0,1,0
https://fbref.com/en/players/94f8d10c/Duje-Caleta-Car,0,0,0,0,0,0,0,0,0,0,0,0,0,1,0
https://fbref.com/en/players/5219ab4a/Jonathan-Clauss,46,28,21,16,9,23,52,29,29,4,25,31,77,40,2
https://fbref.com/en/players/40774c6b/Bamba-Dieng,4,4,2,1,1,3,4,1,5,1,4,0,4,0,0
https://fbref.com/en/players/8827bf46/Gerson,6,4,1,4,1,3,5,2,5,0,5,2,8,4,0
https://fbref.com/en/players/41eebdf5/Samuel-Gigot,46,24,22,21,3,12,15,3,24,7,17,45,91,85,1
https://fbref.com/en/players/5ea8ef20/Matteo-Guendouzi,39,18,9,21,9,14,38,24,12,5,7,21,60,18,0
https://fbref.com/en/players/7155e3e1/Pape-Gueye,18,7,10,7,1,7,15,8,9,2,7,9,27,2,0
https://fbref.com/en/players/e7d59f4f/Amine-Harit,6,4,0,3,3,3,8,5,4,1,3,4,10,6,0
https://fbref.com/en/players/eeba07f8/Luis-Javier-Suarez,4,1,1,2,1,1,4,3,1,0,1,3,7,6,0
https://fbref.com/en/players/c066d1a5/Issa-Kabore,33,19,10,18,5,21,32,11,11,1,10,12,45,21,1
https://fbref.com/en/players/3935e52e/Sead-Kolasinac,52,36,24,22,6,24,37,13,19,2,17,43,95,35,1
https://fbref.com/en/players/20b9f052/Pau-Lopez,0,0,0,0,0,0,1,1,0,0,0,0,0,5,1
https://fbref.com/en/players/48d5bd33/Ruslan-Malinovskyi,21,11,3,12,6,10,26,16,13,1,12,3,24,9,0
https://fbref.com/en/players/e76cb9cc/Chancel-Mbemba,43,26,24,17,2,22,31,9,25,12,13,42,85,89,0
https://fbref.com/en/players/85613cf0/Arkadiusz-Milik,1,1,0,0,1,0,1,1,0,0,0,0,1,2,0
https://fbref.com/en/players/7af655fe/Francois-Mughe,0,0,0,0,0,0,0,0,0,0,0,0,0,0,0
https://fbref.com/en/players/83299cc0/Azzedine-Ounahi,2,1,1,1,0,0,2,2,1,0,1,0,2,0,0
https://fbref.com/en/players/58ae47b2/Dimitri-Payet,6,4,2,2,2,3,10,7,4,0,4,0,6,4,0
https://fbref.com/en/players/ed45c4a5/Valentin-Rongier,93,59,33,47,13,41,77,36,50,11,39,54,147,38,1
https://fbref.com/en/players/2c0f8e9e/Alexis-Sanchez,27,17,5,16,6,3,24,21,14,0,14,5,32,6,0
https://fbref.com/en/players/a65c844b/Nuno-Tavares,56,30,19,24,13,28,55,27,32,4,28,15,71,25,0
https://fbref.com/en/players/01fd01e8/Souleymane-Toure,2,1,1,1,0,1,2,1,1,0,1,0,2,5,0
https://fbref.com/en/players/1880614f/Cengiz-Under,37,19,15,13,9,13,34,21,18,2,16,18,55,13,0
https://fbref.com/en/players/4a56052c/Jordan-Veretout,56,35,17,32,7,25,53,28,22,7,15,36,92,40,2
https://fbref.com/en/players/74d4cec6/Vitinha,15,7,0,6,9,3,11,8,3,0,3,2,17,6,0
https://fbref.com/en/players/26777636/Yacine-Adli,6,3,2,4,0,2,2,0,2,0,2,1,7,1,0
https://fbref.com/en/players/59bf127b/Tiemoue-Bakayoko,5,5,4,1,0,3,3,0,0,0,0,0,5,0,1
https://fbref.com/en/players/f449640d/Fode-Ballo-Toure,14,9,7,6,1,7,10,3,11,3,8,2,16,3,0
https://fbref.com/en/players/db092d3b/Ismael-Bennacer,59,33,26,31,2,30,51,21,25,7,18,26,85,16,1
https://fbref.com/en/players/2146785a/Davide-Calabria,71,44,31,32,8,38,61,23,22,7,15,25,96,34,0
https://fbref.com/en/players/2ef7c612/Charles-De-Ketelaere,26,12,7,14,5,13,30,17,14,2,12,4,30,9,0
https://fbref.com/en/players/5976f83e/Sergino-Dest,12,6,3,5,4,3,4,1,1,0,1,4,16,2,0
https://fbref.com/en/players/407feb71/Brahim-Diaz,32,15,5,22,5,5,15,10,11,0,11,7,39,6,0
https://fbref.com/en/players/e288d4b3/Alessandro-Florenzi,6,4,3,2,1,4,7,3,1,0,1,4,10,2,0
https://fbref.com/en/players/c235e803/Matteo-Gabbia,17,10,12,5,0,6,8,2,8,3,5,5,22,29,0
https://fbref.com/en/players/16ceb862/Olivier-Giroud,8,5,2,4,2,2,10,8,11,3,8,3,11,23,0
https://fbref.com/en/players/d4c9725f/Theo-Hernandez,43,24,27,15,1,22,38,16,34,7,27,21,64,35,1
https://fbref.com/en/players/4cde5509/Zlatan-Ibrahimovic,0,0,0,0,0,0,0,0,1,1,0,0,0,2,0
https://fbref.com/en/players/85f7d1be/Pierre-Kalulu,57,39,33,21,3,28,42,14,41,17,24,41,98,56,1
https://fbref.com/en/players/8b8a56ce/Simon-Kjaer,15,8,9,6,0,7,11,4,14,11,3,9,24,35,1
https://fbref.com/en/players/817c6964/Rade-Krunic,40,28,18,18,4,16,50,34,31,11,20,16,56,21,0
https://fbref.com/en/players/93088fbb/Marko-Lazetic,0,0,0,0,0,0,0,0,0,0,0,0,0,0,0
https://fbref.com/en/players/20730eae/Rafael-Leao,8,7,2,3,3,6,14,8,9,2,7,15,23,8,0
https://fbref.com/en/players/fcb38f57/Mike-Maignan,1,0,1,0,0,1,1,0,0,0,0,1,2,10,1
https://fbref.com/en/players/f49c4ae9/Junior-Messias,24,18,9,9,6,5,19,14,20,4,16,7,31,28,0
https://fbref.com/en/players/30223b33/Antonio-Mirante,0,0,0,0,0,0,0,0,0,0,0,0,0,0,0
https://fbref.com/en/players/43a166b4/Divock-Origi,10,5,4,3,3,5,10,5,6,2,4,0,10,13,0
https://fbref.com/en/players/55a1cac2/Tommaso-Pobega,27,16,8,15,4,13,20,7,12,4,8,9,36,11,0
https://fbref.com/en/players/536cebe5/Ante-Rebic,10,8,1,3,6,3,11,8,6,1,5,1,11,5,0
https://fbref.com/en/players/ee251371/Alexis-Saelemaekers,31,20,12,16,3,19,41,22,13,1,12,19,50,11,0
https://fbref.com/en/players/b056e3da/Ciprian-Tatarusanu,0,0,0,0,0,0,0,0,0,0,0,1,1,2,0
https://fbref.com/en/players/ff5ea0bf/Malick-Thiaw,31,26,22,9,0,11,20,9,11,5,6,12,43,65,1
https://fbref.com/en/players/7edfbb8a/Fikayo-Tomori,70,34,44,25,1,22,34,12,46,25,21,29,99,88,1
https://fbref.com/en/players/0db169ae/Sandro-Tonali,64,41,35,24,5,27,44,17,34,9,25,25,89,26,1
https://fbref.com/en/players/f86cd5df/Aster-Vranckx,3,2,0,2,1,2,7,5,3,1,2,2,5,1,0
https://fbref.com/en/players/3dd738a1/Ruben-Aguilar,19,9,7,7,5,8,22,14,13,1,12,18,37,28,1
https://fbref.com/en/players/b625b241/Maghnes-Akliouche,7,4,4,3,0,2,8,6,2,0,2,3,10,2,0
https://fbref.com/en/players/06df8256/Benoit-Badiashile,10,8,6,4,0,5,10,5,9,6,3,17,27,40,1
https://fbref.com/en/players/3bd65247/Eliesse-Ben-Seghir,18,10,4,12,2,4,12,8,18,1,17,4,22,1,0
https://fbref.com/en/players/942b4f90/Wissam-Ben-Yedder,16,9,2,5,9,4,13,9,15,0,15,4,20,0,0
https://fbref.com/en/players/5b479568/Myron-Boadu,3,3,0,2,1,1,7,6,1,0,1,0,3,1,0
https://fbref.com/en/players/489e80e3/Mohamed-Camara,83,45,38,39,6,48,92,44,45,6,39,27,110,14,1
https://fbref.com/en/players/8104e41e/Krepin-Diatta,30,21,4,17,9,13,32,19,29,1,28,17,47,12,0
https://fbref.com/en/players/37143438/Edan-Diop,13,8,3,3,7,7,15,8,7,1,6,4,17,1,0
https://fbref.com/en/players/19053e31/Sofiane-Diop,0,0,0,0,0,0,0,0,0,0,0,1,1,0,0
https://fbref.com/en/players/ad82197c/Axel-Disasi,30,20,13,13,4,13,27,14,51,31,20,56,86,112,2
https://fbref.com/en/players/0b4f388a/Breel-Embolo,15,9,2,7,6,5,10,5,14,3,11,5,20,12,0
https://fbref.com/en/players/822d51d7/Youssouf-Fofana,81,41,31,42,8,38,74,36,50,6,44,56,137,32,1
https://fbref.com/en/players/3708e9fa/Aleksandr-Golovin,62,36,19,32,11,28,72,44,28,1,27,37,99,10,0
https://fbref.com/en/players/a0415710/Ismail-Jakobs,11,5,7,3,1,5,12,7,9,1,8,9,20,18,0
https://fbref.com/en/players/a99138af/Jean-Lucas,9,5,3,5,1,6,12,6,2,1,1,4,13,2,0
https://fbref.com/en/players/dfc5d4fa/Soungoutou-Magassa,4,1,2,2,0,2,4,2,3,0,3,1,5,1,0
https://fbref.com/en/players/d9764034/Guillermo-Maripan,46,26,26,20,0,17,33,16,39,27,12,38,84,87,0
https://fbref.com/en/players/3ef0fa48/Gelson-Martins,15,8,6,4,5,4,13,9,4,1,3,3,18,2,0
https://fbref.com/en/players/15944afd/Eliot-Matazo,26,12,11,13,2,11,26,15,18,4,14,15,41,11,1
https://fbref.com/en/players/cf1ef7ec/Chrislain-Matsima,11,6,7,2,2,4,7,3,5,5,0,9,20,16,0
https://fbref.com/en/players/f833a830/Takumi-Minamino,15,8,5,7,3,7,35,28,14,0,14,6,21,4,0
https://fbref.com/en/players/afb0c500/Alexander-Nubel,0,0,0,0,0,0,1,1,0,0,0,1,1,10,3
https://fbref.com/en/players/4315f30d/Malang-Sarr,6,3,5,1,0,1,5,4,11,7,4,15,21,29,2
https://fbref.com/en/players/30af8b93/Caio-Henrique-Oliveira-Silva,74,51,42,28,4,44,76,32,28,8,20,26,100,68,1
https://fbref.com/en/players/ee45fd85/Vanderson,84,48,36,34,14,44,75,31,36,9,27,48,132,36,1
https://fbref.com/en/players/64f69877/Kevin-Volland,8,4,1,5,2,2,8,6,8,0,8,2,10,0,0
https://fbref.com/en/players/8608f269/Matis-Carvalho,0,0,0,0,0,0,0,0,0,0,0,1,1,0,0
https://fbref.com/en/players/7909ffa4/Joris-Chotard,64,34,37,23,4,40,78,38,40,11,29,40,104,42,1
https://fbref.com/en/players/8f325097/Nicolas-Cozza,38,21,27,9,2,26,38,12,11,5,6,21,59,35,1
https://fbref.com/en/players/e4448c8c/Sacha-Delaye,1,0,0,0,1,1,1,0,0,0,0,0,1,0,0
https://fbref.com/en/players/1a066e69/Maxime-Esteve,24,13,17,5,2,12,17,5,28,17,11,34,58,90,0
https://fbref.com/en/players/faf00ab8/Khalil-Fayad,30,14,12,16,2,12,21,9,8,1,7,9,39,4,0
https://fbref.com/en/players/4b792f35/Cheikh-Faye,0,0,0,0,0,0,0,0,0,0,0,1,1,0,0
https://fbref.com/en/players/375622c5/Jordan-Ferri,55,35,32,19,4,30,89,59,22,6,16,26,81,21,0
https://fbref.com/en/players/ea0ff634/Valere-Germain,13,11,3,5,5,4,12,8,8,0,8,6,19,12,0
https://fbref.com/en/players/f6857b4f/Axel-Gueguin,0,0,0,0,0,0,0,0,1,0,1,0,0,0,0
https://fbref.com/en/players/f323d995/Christopher-Jullien,46,28,29,14,3,28,51,23,35,18,17,43,89,114,1
https://fbref.com/en/players/3814120d/Bingourou-Kamara,0,0,0,0,0,0,0,0,0,0,0,0,0,2,0
https://fbref.com/en/players/2677a1de/Wahbi-Khazri,26,13,13,7,6,6,25,19,17,1,16,9,35,20,0
https://fbref.com/en/players/562a4799/Boubakar-Kouyate,31,18,18,11,2,19,35,16,24,14,10,34,65,73,1
https://fbref.com/en/players/2fa2a875/Benjamin-Lecomte,0,0,0,0,0,0,2,2,0,0,0,0,0,6,0
https://fbref.com/en/players/fcc84a07/Leo-Leroy,53,38,24,26,3,31,57,26,25,2,23,14,67,8,0
https://fbref.com/en/players/654f49ca/Beni-Makouana,1,0,0,1,0,0,2,2,3,1,2,0,1,1,0
https://fbref.com/en/players/e54a9890/Faitout-Maouassa,52,32,26,20,6,18,41,23,31,3,28,20,72,23,0
https://fbref.com/en/players/30144daa/Stephy-Mavididi,24,19,12,8,4,13,27,14,21,1,20,4,28,10,0
https://fbref.com/en/players/6690ef25/Pedro-Mendes,0,0,0,0,0,0,0,0,0,0,0,0,0,0,1
https://fbref.com/en/players/7b9a9e25/Arnaud-Nordin,26,14,10,12,4,12,28,16,19,1,18,14,40,7,0
https://fbref.com/en/players/c631f952/Jonas-Omlin,1,0,1,0,0,0,0,0,0,0,0,0,1,8,1
https://fbref.com/en/players/6388e356/Falaye-Sacko,46,25,25,15,6,32,51,19,43,14,29,33,79,75,1
https://fbref.com/en/players/93c942fb/Theo-Sainte-Luce,13,11,8,5,0,7,14,7,7,2,5,10,23,11,0
https://fbref.com/en/players/87935cf3/Mamadou-Sakho,9,5,4,5,0,3,5,2,17,12,5,8,17,35,1
https://fbref.com/en/players/6bde367b/Teji-Savanier,46,30,16,19,11,23,70,47,30,2,28,30,76,12,1
https://fbref.com/en/players/4e0afc5d/Arnaud-Souquet,22,16,13,7,2,11,14,3,8,3,5,4,26,4,0
https://fbref.com/en/players/b99bec05/Issiaga-Sylla,28,16,19,8,1,15,31,16,19,3,16,32,60,35,0
https://fbref.com/en/players/4a0c6555/Thibault-Tamas,0,0,0,0,0,0,0,0,0,0,0,1,1,0,0
https://fbref.com/en/players/7f783431/Enzo-Tchato,26,17,14,11,1,13,22,9,17,2,15,7,33,33,0
https://fbref.com/en/players/0d7b6576/Elye-Wahi,9,3,2,3,4,5,14,9,14,2,12,3,12,5,0
https://fbref.com/en/players/8f68aa41/Valentin-Antov,6,5,3,3,0,1,5,4,5,4,1,4,10,14,1
https://fbref.com/en/players/32ebfe1e/Andrea-Barberis,7,2,4,3,0,5,11,6,0,0,0,8,15,1,0
https://fbref.com/en/players/204ac005/Samuele-Birindelli,35,19,21,10,4,18,29,11,28,8,20,16,51,30,0
https://fbref.com/en/players/0def2376/Warren-Bondo,1,0,1,0,0,0,0,0,1,0,1,0,1,0,0
https://fbref.com/en/players/226008f1/Luca-Caldirola,26,14,19,4,3,13,26,13,32,18,14,25,51,66,1
https://fbref.com/en/players/54e53b7e/Gianluca-Caprari,16,6,3,11,2,8,26,18,22,1,21,8,24,3,0
https://fbref.com/en/players/f7e2af2c/Andrea-Carboni,3,2,2,0,1,2,5,3,3,2,1,3,6,2,1
https://fbref.com/en/players/b033f803/Franco-Carboni,1,1,1,0,0,0,2,2,3,0,3,1,2,0,0
https://fbref.com/en/players/8d3cd59d/Carlos,73,38,42,23,8,33,54,21,24,6,18,24,97,85,1
https://fbref.com/en/players/5de3866c/Patrick-Ciurria,31,18,20,10,1,17,33,16,24,2,22,7,38,32,0
https://fbref.com/en/players/6499048c/Andrea-Colpani,14,9,6,5,3,8,12,4,14,2,12,3,17,6,0
https://fbref.com/en/players/f554e29b/Alessio-Cragno,0,0,0,0,0,0,1,1,0,0,0,0,0,0,0
https://fbref.com/en/players/060606ec/Marco-DAlessandro,4,4,3,1,0,2,5,3,2,0,2,1,5,3,0
https://fbref.com/en/players/4e0c8d66/Michele-Di-Gregorio,0,0,0,0,0,0,3,3,1,0,1,4,4,18,3
https://fbref.com/en/players/22051fbe/Giulio-Donati,4,1,1,1,2,3,6,3,3,1,2,4,8,11,0
https://fbref.com/en/players/9250bcff/Christian-Gytkjaer,6,2,1,4,1,2,5,3,6,1,5,0,6,2,0
https://fbref.com/en/players/89976232/Armando-Izzo,73,50,44,27,2,29,45,16,29,17,12,50,123,87,1
https://fbref.com/en/players/aa54ec6f/Pablo-Mari,37,19,29,7,1,17,26,9,22,14,8,31,68,111,3
https://fbref.com/en/players/cdf65d12/Marlon,35,21,20,14,1,15,29,14,13,4,9,18,53,50,0
https://fbref.com/en/players/ea468ea8/Luca-Marrone,0,0,0,0,0,0,2,2,2,2,0,0,0,4,1
https://fbref.com/en/players/54ab971f/Salvatore-Molina,6,5,2,4,0,4,5,1,4,2,2,1,7,2,0
https://fbref.com/en/players/efc9e31f/Dany-Mota,8,7,1,3,4,2,10,8,5,1,4,6,14,25,0
https://fbref.com/en/players/7afb1573/Pepin,28,19,10,11,7,9,27,18,14,3,11,13,41,17,0
https://fbref.com/en/players/780e3631/Matteo-Pessina,57,36,28,21,8,26,62,36,50,15,35,37,94,33,1
https://fbref.com/en/players/03f946ed/Andrea-Petagna,7,5,2,3,2,3,6,3,16,4,12,3,10,18,0
https://fbref.com/en/players/539230cf/Andrea-Ranocchia,3,1,1,2,0,3,4,1,5,5,0,0,3,7,0
https://fbref.com/en/players/d9ebed1c/Filippo-Ranocchia,11,6,5,4,2,4,12,8,5,1,4,4,15,7,0
https://fbref.com/en/players/e58cbfd5/Nicolo-Rovella,45,29,22,21,2,13,36,23,20,1,19,40,85,17,0
https://fbref.com/en/players/b70bde8f/Stefano-Sensi,41,26,25,13,3,18,48,30,13,3,10,20,61,4,0
https://fbref.com/en/players/c414df9d/Mattia-Valoti,17,10,7,9,1,5,16,11,13,3,10,3,20,6,0
https://fbref.com/en/players/a14d0ab0/Samuele-Vignato,0,0,0,0,0,0,0,0,1,0,1,0,0,0,0
https://fbref.com/en/players/1e93fc5d/Mohamed-Achi,1,1,1,0,0,1,1,0,0,0,0,0,1,0,0
https://fbref.com/en/players/feb5d3ab/Dennis-Appiah,21,11,14,7,0,10,27,17,13,5,8,10,31,16,0
https://fbref.com/en/players/42f0113f/Stredair-Appuah,2,1,0,2,0,0,0,0,2,0,2,1,3,0,0
https://fbref.com/en/players/6191093d/Ludovic-Blas,47,30,17,19,11,17,49,32,26,1,25,19,66,8,0
https://fbref.com/en/players/e0f3a1f6/Jean-Charles-Castelletto,43,26,29,12,2,22,36,14,35,22,13,58,101,90,0
https://fbref.com/en/players/3c6bbbab/Fabien-Centonze,58,37,30,22,6,30,42,12,24,7,17,44,102,55,1
https://fbref.com/en/players/68a26d51/Pedro-Chirivella,33,22,12,15,6,17,44,27,24,1,23,20,53,7,0
https://fbref.com/en/players/3010aefb/Marcus-Coco,24,15,11,9,4,11,23,12,13,3,10,14,38,7,0
https://fbref.com/en/players/0e7ccfc4/Sebastien-Corchia,16,6,10,2,4,11,22,11,9,3,6,14,30,21,0
https://fbref.com/en/players/d33c706e/Andy-Delort,5,4,1,2,2,2,6,4,3,0,3,0,5,2,0
https://fbref.com/en/players/477e50ce/Remy-Descamps,0,0,0,0,0,0,0,0,0,0,0,0,0,0,0
https://fbref.com/en/players/dff0c299/Lohann-Doucet,3,0,2,0,1,3,4,1,2,0,2,2,5,4,0
https://fbref.com/en/players/bc7b4580/Fabio,4,2,1,2,1,4,6,2,2,0,2,3,7,11,0
https://fbref.com/en/players/23c63b7f/Ignatius-Ganago,9,7,2,3,4,4,7,3,13,1,12,2,11,12,0
https://fbref.com/en/players/3befc2b6/Andrei-Girotto,122,73,71,45,6,74,132,58,55,24,31,73,195,176,1
https://fbref.com/en/players/b73f17f8/Evann-Guessand,24,16,8,13,3,6,12,6,17,1,16,9,33,6,0
https://fbref.com/en/players/576817b7/Jaouen-Hadjam,27,21,13,9,5,16,25,9,10,3,7,12,39,12,0
https://fbref.com/en/players/32f3d97e/Abdoul-Kader-Bamba,0,0,0,0,0,0,2,2,3,1,2,0,0,1,0
https://fbref.com/en/players/4e7db402/Alban-Lafont,0,0,0,0,0,0,1,1,0,0,0,0,0,20,4
https://fbref.com/en/players/0bfca6a1/Quentin-Merlin,31,19,19,8,4,18,38,20,27,4,23,24,55,30,0
https://fbref.com/en/players/595e6f3e/Mostafa-Mohamed,18,13,5,7,6,9,20,11,23,1,22,10,28,33,0
https://fbref.com/en/players/7e82a78f/Florent-Mollet,14,6,5,4,5,7,24,17,12,1,11,10,24,11,0
https://fbref.com/en/players/af0c835b/Samuel-Moutoussamy,64,34,27,28,9,26,76,50,23,2,21,24,88,15,0
https://fbref.com/en/players/779847d6/Nicolas-Pallois,69,44,51,16,2,42,70,28,35,18,17,30,99,131,2
https://fbref.com/en/players/5f3eaaf5/Moses-Simon,18,9,6,7,5,7,15,8,14,1,13,11,29,3,0
https://fbref.com/en/players/2acd49b9/Moussa-Sissoko,26,16,16,7,3,12,18,6,22,5,17,16,42,17,0
https://fbref.com/en/players/de488e56/Charles-Traore,8,5,5,2,1,5,7,2,9,2,7,10,18,12,0
https://fbref.com/en/players/d60cf08d/Joao-Victor,19,11,9,7,3,12,22,10,11,1,10,15,34,30,0
https://fbref.com/en/players/fb4c5b6e/Nathan-Zeze,3,2,2,1,0,1,1,0,0,0,0,0,3,1,0
https://fbref.com/en/players/61b3978f/Bartosz-Bereszynski,3,2,1,1,1,2,2,0,4,0,4,3,6,3,0
https://fbref.com/en/players/dc3fa3b5/Diego-Demme,1,0,1,0,0,0,4,4,2,0,2,0,1,1,0
https://fbref.com/en/players/230a2fac/Giovanni-Di-Lorenzo,60,29,33,19,8,25,49,24,30,9,21,30,90,60,0
https://fbref.com/en/players/cf007308/Elif-Elmas,24,13,8,12,4,11,23,12,18,2,16,11,35,5,0
https://fbref.com/en/players/3b387cc7/Gianluca-Gaetano,5,3,1,3,1,0,0,0,1,0,1,1,6,0,0
https://fbref.com/en/players/f0f7f62f/Pierluigi-Gollini,0,0,0,0,0,0,0,0,0,0,0,0,0,1,0
https://fbref.com/en/players/79083382/Juan-Jesus,16,11,9,6,1,9,12,3,18,11,7,10,26,29,0
https://fbref.com/en/players/dea88efd/Khvicha-Kvaratskhelia,43,23,12,8,23,17,43,26,20,0,20,5,48,6,1
https://fbref.com/en/players/e1cbb531/Stanislav-Lobotka,83,44,35,35,13,43,73,30,29,7,22,23,106,16,0
https://fbref.com/en/players/a69e4806/Hirving-Lozano,24,13,10,6,8,9,21,12,31,0,31,15,39,6,0
https://fbref.com/en/players/9413b19f/Alex-Meret,0,0,0,0,0,0,0,0,0,0,0,0,0,6,1
https://fbref.com/en/players/e0f8151c/Kim-Min-jae,55,30,32,22,1,25,29,4,36,26,10,41,96,123,1
https://fbref.com/en/players/5cdddffa/Tanguy-Ndombele,14,8,4,8,2,4,7,3,10,1,9,7,21,7,1
https://fbref.com/en/players/41c12f75/Mathias-Olivera,39,23,16,16,7,22,43,21,28,2,26,22,61,26,0
https://fbref.com/en/players/8c90fd7a/Victor-Osimhen,10,6,1,2,7,0,7,7,6,1,5,6,16,29,0
https://fbref.com/en/players/ed90babd/Adam-Ounas,0,0,0,0,0,0,0,0,0,0,0,1,1,0,0
https://fbref.com/en/players/5e861944/Matteo-Politano,18,9,9,5,4,11,25,14,6,0,6,7,25,7,0
https://fbref.com/en/players/6e058f06/Giacomo-Raspadori,10,8,0,6,4,4,10,6,9,0,9,4,14,4,0
https://fbref.com/en/players/4b3e1a38/Amir-Rrahmani,33,18,20,13,0,17,26,9,36,20,16,14,47,79,1
https://fbref.com/en/players/0b5a292a/Mario-Rui,34,22,17,13,4,20,41,21,17,4,13,15,49,24,1
https://fbref.com/en/players/343c0d52/Giovanni-Simeone,12,3,3,5,4,3,8,5,2,1,1,1,13,4,0
https://fbref.com/en/players/b35a7399/Leo-Skiri-Ostigard,4,1,3,1,0,1,1,0,3,3,0,6,10,18,1
https://fbref.com/en/players/6bb2c084/Andre-Frank-Zambo-Anguissa,53,32,16,29,8,16,64,48,50,4,46,49,102,25,0
https://fbref.com/en/players/3b12b11f/Alessandro-Zanoli,1,0,0,1,0,0,0,0,0,0,0,0,1,1,0
https://fbref.com/en/players/2f45300d/Karim-Zedadka,0,0,0,0,0,0,0,0,0,0,0,0,0,1,0
https://fbref.com/en/players/d19ef4ef/Alessio-Zerbin,10,5,4,5,1,4,8,4,2,0,2,2,12,2,0
https://fbref.com/en/players/a5296e55/Piotr-Zielinski,17,10,1,11,5,12,25,13,16,5,11,14,31,7,0
https://fbref.com/en/players/862a1c15/Miguel-Almiron,46,30,16,19,11,18,42,24,25,2,23,10,56,17,0
https://fbref.com/en/players/de31038e/Elliot-Anderson,11,5,5,3,3,6,12,6,11,2,9,6,17,2,0
https://fbref.com/en/players/ccce7025/Sven-Botman,38,24,31,7,0,22,28,6,44,24,20,34,72,126,2
https://fbref.com/en/players/b2d31e83/Dan-Burn,60,38,29,23,8,34,67,33,42,16,26,32,92,120,2
https://fbref.com/en/players/3a949a25/Martin-Dubravka,0,0,0,0,0,0,1,1,0,0,0,0,0,1,0
https://fbref.com/en/players/d56543a0/Ryan-Fraser,2,2,0,0,2,2,5,3,3,1,2,0,2,3,0
https://fbref.com/en/players/2bd83368/Anthony-Gordon,14,12,5,7,2,9,20,11,9,1,8,2,16,1,1
https://fbref.com/en/players/82518f62/Bruno-Guimaraes,78,40,27,46,5,38,65,27,28,4,24,36,114,22,1
https://fbref.com/en/players/8e92be30/Alexander-Isak,18,8,4,7,7,10,28,18,21,2,19,4,22,8,0
https://fbref.com/en/players/c17bfb65/Joelinton,70,49,36,26,8,26,62,36,52,7,45,48,118,39,0
https://fbref.com/en/players/77cf6852/Emil-Krafth,0,0,0,0,0,0,0,0,0,0,0,0,0,0,0
https://fbref.com/en/players/450ab6fc/Jamaal-Lascelles,1,0,1,0,0,1,1,0,3,2,1,0,1,17,0
https://fbref.com/en/players/efb9215a/Jamal-Lewis,0,0,0,0,0,0,0,0,0,0,0,0,0,0,0
https://fbref.com/en/players/a2b105e0/Sean-Longstaff,42,21,16,20,6,20,52,32,35,8,27,16,58,23,0
https://fbref.com/en/players/758dd7f0/Javier-Manquillo,3,2,2,1,0,2,2,0,1,0,1,1,4,1,0
https://fbref.com/en/players/2c6835e5/Lewis-Miley,0,0,0,0,0,0,0,0,1,0,1,0,0,0,0
https://fbref.com/en/players/de112b84/Jacob-Murphy,15,7,3,8,4,8,20,12,17,0,17,7,22,3,0
https://fbref.com/en/players/4b40d9ca/Nick-Pope,1,0,1,0,0,1,3,2,0,0,0,0,1,27,2
https://fbref.com/en/players/71ef519e/Matt-Ritchie,1,1,0,1,0,1,3,2,0,0,0,1,2,0,0
https://fbref.com/en/players/2b16cb1a/Allan-Saint-Maximin,10,3,3,6,1,2,11,9,4,0,4,5,15,2,0
https://fbref.com/en/players/c8aa95da/Fabian-Schar,47,22,31,13,3,24,39,15,34,19,15,52,99,139,0
https://fbref.com/en/players/3727dd3c/Jonjo-Shelvey,1,0,1,0,0,0,1,1,1,0,1,0,1,0,0
https://fbref.com/en/players/e514ab62/Matt-Targett,13,10,8,3,2,9,24,15,8,3,5,9,22,16,0
https://fbref.com/en/players/21512407/Kieran-Trippier,71,49,36,27,8,46,90,44,45,15,30,43,114,84,2
https://fbref.com/en/players/a3b03921/Joe-Willock,51,30,13,26,12,25,58,33,54,8,46,25,76,17,0
https://fbref.com/en/players/c596fcb0/Callum-Wilson,9,3,0,8,1,0,3,3,8,0,8,1,10,5,0
https://fbref.com/en/players/4e9a0555/Chris-Wood,5,4,0,3,2,3,5,2,2,2,0,1,6,7,0
https://fbref.com/en/players/ae11ba3d/Ayoub-Amraoui,6,5,3,3,0,2,5,3,1,0,1,4,10,4,0
https://fbref.com/en/players/6a827d8e/Youcef-Atal,38,22,18,15,5,23,32,9,9,0,9,14,52,13,0
https://fbref.com/en/players/1ddbc7ca/Melvin-Bard,96,60,61,29,6,59,89,30,35,4,31,64,160,40,1
https://fbref.com/en/players/3a24769f/Ross-Barkley,16,9,7,4,5,7,13,6,7,2,5,8,24,6,0
https://fbref.com/en/players/4a5e83ad/Alexis-Beka-Beka,16,5,6,9,1,4,15,11,9,1,8,12,28,6,0
https://fbref.com/en/players/705a1642/Reda-Belahyane,8,6,5,3,0,3,5,2,5,1,4,2,10,0,0
https://fbref.com/en/players/0400dd2f/Badredine-Bouanani,13,9,2,7,4,7,14,7,4,0,4,1,14,2,0
https://fbref.com/en/players/f9d5908e/Hicham-Boudaoui,67,32,31,30,6,35,53,18,34,5,29,36,103,16,0
https://fbref.com/en/players/02bcaf8e/Bilal-Brahimi,8,5,2,5,1,1,7,6,4,0,4,4,12,0,0
https://fbref.com/en/players/af69e7f0/Joe-Bryan,5,4,3,2,0,4,4,0,2,0,2,1,6,1,0
https://fbref.com/en/players/db87a2c4/Marcin-Bulka,0,0,0,0,0,0,1,1,0,0,0,1,1,0,0
https://fbref.com/en/players/741418c3/Alexis-Claude-Maurice,3,2,2,1,0,3,3,0,0,0,0,2,5,1,0
https://fbref.com/en/players/4a021593/Andrea-Dacourt,0,0,0,0,0,0,0,0,0,0,0,0,0,0,0
https://fbref.com/en/players/7ef972c3/Flavius-Daniliuc,2,0,2,0,0,1,1,0,4,1,3,0,2,1,0
https://fbref.com/en/players/fd2bc67d/Dante,70,40,45,21,4,36,59,23,52,31,21,47,117,125,2
https://fbref.com/en/players/d33c706e/Andy-Delort,2,0,1,1,0,1,2,1,0,0,0,1,3,7,0
https://fbref.com/en/players/19053e31/Sofiane-Diop,23,11,12,6,5,7,20,13,14,2,12,16,39,5,0
https://fbref.com/en/players/aad56ca3/Amine-Gouiri,1,1,1,0,0,0,1,1,1,0,1,0,1,3,0
https://fbref.com/en/players/c9f49454/Rares-Ilie,3,3,0,1,2,2,4,2,2,0,2,1,4,1,0
https://fbref.com/en/players/7cdda3bf/Gaetan-Laborde,45,25,13,17,15,18,40,22,27,2,25,9,54,13,0
https://fbref.com/en/players/2b471f99/Mario-Lemina,32,21,11,14,7,12,18,6,13,5,8,11,43,20,0
https://fbref.com/en/players/fc4cf6a7/Jordan-Lotomba,65,38,33,24,8,31,48,17,38,11,27,32,97,53,0
https://fbref.com/en/players/3322e296/Antoine-Mendy,22,13,16,5,1,9,15,6,6,1,5,2,24,16,0
https://fbref.com/en/players/065dc209/Terem-Moffi,12,6,0,6,6,2,12,10,3,0,3,2,14,5,0
https://fbref.com/en/players/65c55288/Youssouf-Ndayishimiye,13,9,8,5,0,6,11,5,8,5,3,12,25,22,1
https://fbref.com/en/players/57e3f0c7/Nicolas-Pepe,25,13,14,5,6,11,25,14,17,0,17,3,28,1,0
https://fbref.com/en/players/ef619b0b/Aaron-Ramsey,47,25,18,19,10,16,39,23,25,4,21,17,64,18,1
https://fbref.com/en/players/1a6b7ea4/Pablo-Rosario,46,26,22,20,4,18,34,16,15,5,10,23,69,32,1
https://fbref.com/en/players/53af52f3/Kasper-Schmeichel,1,0,1,0,0,1,4,3,1,0,1,1,2,11,1
https://fbref.com/en/players/8f7e6783/Calvin-Stengs,2,2,1,0,1,1,2,1,0,0,0,0,2,0,0
https://fbref.com/en/players/7d9397f8/Khephren-Thuram,51,25,22,23,6,19,43,24,33,13,20,38,89,34,0
https://fbref.com/en/players/88f130ed/Jean-Clair-Todibo,76,48,54,19,3,41,56,15,41,19,22,41,117,110,2
https://fbref.com/en/players/7a3f8712/Theo-Trinker,0,0,0,0,0,0,0,0,0,0,0,0,0,0,0
https://fbref.com/en/players/75438a9a/Mattia-Viti,4,2,1,1,2,2,5,3,9,3,6,8,12,22,0
https://fbref.com/en/players/5c2b4f07/Serge-Aurier,64,41,41,18,5,23,33,10,34,11,23,29,93,75,0
https://fbref.com/en/players/e5478b87/Taiwo-Awoniyi,17,10,2,10,5,6,10,4,18,4,14,4,21,20,0
https://fbref.com/en/players/5dbefa9d/Andre-Ayew,5,3,0,4,1,2,4,2,6,1,5,0,5,7,0
https://fbref.com/en/players/de40e38c/Giulian-Biancone,2,1,2,0,0,1,1,0,0,0,0,1,3,0,0
https://fbref.com/en/players/a4ac4b8f/Willy-Boly,13,6,8,3,2,8,13,5,13,4,9,12,25,45,0
https://fbref.com/en/players/85322440/Cafu,0,0,0,0,0,0,0,0,0,0,0,0,0,1,0
https://fbref.com/en/players/963a9201/Jack-Colback,18,13,12,6,0,5,8,3,3,0,3,3,21,9,0
https://fbref.com/en/players/3e5e4e63/Steve-Cook,8,4,4,4,0,5,7,2,16,11,5,12,20,51,0
https://fbref.com/en/players/a816dbfb/Danilo,18,7,7,9,2,6,25,19,26,6,20,9,27,19,0
https://fbref.com/en/players/2c44a35d/Emmanuel-Dennis,17,11,5,5,7,8,17,9,13,1,12,2,19,6,0
https://fbref.com/en/players/51a3c4c8/Felipe,42,23,29,13,0,24,41,17,34,13,21,36,78,90,0
https://fbref.com/en/players/98d2c2c4/Remo-Freuler,43,23,23,15,5,19,43,24,36,9,27,29,72,45,0
https://fbref.com/en/players/32f60ed8/Morgan-Gibbs-White,26,14,7,7,12,11,32,21,23,4,19,14,40,15,0
https://fbref.com/en/players/e5a76dfe/Dean-Henderson,0,0,0,0,0,0,0,0,0,0,0,0,0,12,1
https://fbref.com/en/players/76eca7e2/Wayne-Hennessey,1,0,1,0,0,1,1,0,0,0,0,0,1,2,0
https://fbref.com/en/players/0cd31129/Brennan-Johnson,34,20,18,8,8,8,28,20,30,1,29,5,39,7,1
https://fbref.com/en/players/8d3c902d/Cheikhou-Kouyate,29,21,18,8,3,9,13,4,14,2,12,10,39,24,0
https://fbref.com/en/players/810e3c74/Jesse-Lingard,4,4,2,2,0,1,7,6,11,0,11,5,9,4,0
https://fbref.com/en/players/ed9f7cfe/Renan-Lodi,52,39,38,8,6,33,66,33,25,6,19,33,85,74,0
https://fbref.com/en/players/a572e291/Orel-Mangala,28,20,16,10,2,12,29,17,21,7,14,23,51,15,0
https://fbref.com/en/players/4e5a4cbc/Scott-McKenna,12,7,7,3,2,6,10,4,20,14,6,12,24,85,1
https://fbref.com/en/players/10ec4169/Alexander-Mighten,0,0,0,0,0,0,1,1,0,0,0,0,0,0,0
https://fbref.com/en/players/ecada4fc/Keylor-Navas,0,0,0,0,0,0,0,0,0,0,0,1,1,11,1
https://fbref.com/en/players/00242715/Moussa-Niakhate,18,9,15,3,0,11,22,11,18,8,10,19,37,60,0
https://fbref.com/en/players/089667a5/Lewis-OBrien,16,9,4,11,1,6,12,6,13,2,11,5,21,9,0
https://fbref.com/en/players/2964fd20/Gustavo-Scarpa,5,2,3,1,1,2,5,3,4,0,4,0,5,3,0
https://fbref.com/en/players/3727dd3c/Jonjo-Shelvey,2,1,0,1,1,1,9,8,7,2,5,5,7,10,1
https://fbref.com/en/players/b017b770/Sam-Surridge,5,0,1,3,1,1,4,3,5,2,3,0,5,7,0
https://fbref.com/en/players/a105d46a/Harry-Toffolo,17,8,10,4,3,10,14,4,16,8,8,10,27,33,0
https://fbref.com/en/players/dd323728/Neco-Williams,72,47,49,17,6,38,71,33,33,8,25,33,105,48,0
https://fbref.com/en/players/4e9a0555/Chris-Wood,0,0,0,0,0,0,1,1,2,1,1,1,1,2,0
https://fbref.com/en/players/a5212312/Joe-Worrall,53,25,39,12,2,25,35,10,33,23,10,26,79,111,1
https://fbref.com/en/players/c1fe2a48/Ryan-Yates,38,19,19,16,3,14,22,8,26,8,18,10,48,44,0
https://fbref.com/en/players/253a06b9/Ezequiel-Avila,8,5,2,4,2,6,23,17,12,1,11,8,16,16,0
https://fbref.com/en/players/aad53e64/Kike-Barja,15,9,6,5,4,8,24,16,7,0,7,4,19,3,0
https://fbref.com/en/players/50cbc806/Iker-Benito,4,3,0,3,1,2,4,2,0,0,0,2,6,4,0
https://fbref.com/en/players/4accb7e0/Darko-Brasanac,29,20,12,10,7,12,23,11,14,2,12,12,41,9,0
https://fbref.com/en/players/8f3565b3/Ante-Budimir,19,9,0,12,7,2,10,8,10,0,10,5,24,19,0
https://fbref.com/en/players/a56da3ba/Juan-Cruz-Armada,24,14,17,4,3,13,23,10,21,8,13,13,37,58,0
https://fbref.com/en/players/bed68338/Abdessamad-Ezzalzouli,29,19,13,12,4,13,23,10,20,0,20,4,33,6,0
https://fbref.com/en/players/a01c3d54/Aitor-Fernandez,1,1,1,0,0,0,1,1,0,0,0,2,3,17,0
https://fbref.com/en/players/3e42f707/David-Garcia,34,20,22,12,0,19,22,3,28,13,15,45,79,151,0
https://fbref.com/en/players/5c96b017/Ruben-Garcia,20,11,12,4,4,7,24,17,14,1,13,12,32,13,0
https://fbref.com/en/players/4a633cfe/Unai-Garcia,23,13,13,8,2,12,17,5,23,14,9,19,42,60,2
https://fbref.com/en/players/5a626448/Moi-Gomez,26,17,9,14,3,15,32,17,15,3,12,10,36,5,1
https://fbref.com/en/players/132ac341/Aridane-Hernandez,21,15,17,4,0,12,25,13,34,21,13,28,49,96,1
https://fbref.com/en/players/e19c989c/Jorge-Herrando,0,0,0,0,0,0,0,0,1,0,1,0,0,3,0
https://fbref.com/en/players/a4995f48/Sergio-Herrera,2,0,2,0,0,2,2,0,1,0,1,1,3,6,2
https://fbref.com/en/players/3701906c/Pablo-Ibanez,29,13,7,17,5,12,35,23,19,2,17,8,37,24,0
https://fbref.com/en/players/e897d8ba/Kike,6,3,0,4,2,2,5,3,6,1,5,1,7,13,0
https://fbref.com/en/players/9939e168/Jon-Moncayola,55,39,24,22,9,30,76,46,37,5,32,17,72,32,2
https://fbref.com/en/players/a21417e2/Diego-Moreno,4,4,2,2,0,3,8,5,7,4,3,5,9,21,0
https://fbref.com/en/players/175ece4c/Iker-Munoz,1,0,0,1,0,0,3,3,2,1,1,3,4,8,0
https://fbref.com/en/players/7c363088/Aimar-Oroz,26,14,8,10,8,8,30,22,24,1,23,24,50,6,0
https://fbref.com/en/players/1f079188/Ruben-Pena,32,18,10,18,4,20,41,21,23,8,15,17,49,31,0
https://fbref.com/en/players/ffacd3d5/Manu-Sanchez,51,35,35,9,7,33,63,30,33,5,28,14,65,51,0
https://fbref.com/en/players/d733aa38/Roberto-Torres,0,0,0,0,0,0,0,0,0,0,0,0,0,0,0
https://fbref.com/en/players/0e4fef6e/Lucas-Torro,48,32,28,15,5,18,42,24,24,3,21,42,90,64,1
https://fbref.com/en/players/3a9c4b7b/Nacho-Vidal,27,14,16,6,5,17,32,15,17,4,13,19,46,33,1
https://fbref.com/en/players/433dc9a2/Juan-Bernat,32,16,18,9,5,21,39,18,11,2,9,9,41,22,1
https://fbref.com/en/players/2180c761/El-Chadaille-Bitshiabu,10,7,7,2,1,3,12,9,9,7,2,9,19,13,3
https://fbref.com/en/players/08f5afaa/Gianluigi-Donnarumma,1,0,1,0,0,1,2,1,0,0,0,0,1,12,4
https://fbref.com/en/players/5b92d896/Hugo-Ekitike,12,4,1,10,1,4,12,8,12,0,12,9,21,3,0
https://fbref.com/en/players/5b3cfa12/Ismael-Gharbi,0,0,0,0,0,0,2,2,2,0,2,3,3,0,0
https://fbref.com/en/players/e42d61c7/Achraf-Hakimi,54,34,19,20,15,31,59,28,34,2,32,16,70,19,0
https://fbref.com/en/players/910e3cad/Ilyes-Housni,1,1,1,0,0,1,1,0,0,0,0,0,1,0,0
https://fbref.com/en/players/aef6e670/Presnel-Kimpembe,17,8,9,6,2,9,13,4,12,7,5,13,30,9,1
https://fbref.com/en/players/96fcd380/Alexandre-Letellier,0,0,0,0,0,0,0,0,0,0,0,0,0,0,0
https://fbref.com/en/players/d5f2f82b/Marquinhos,33,25,18,12,3,18,26,8,43,27,16,23,56,83,2
https://fbref.com/en/players/42fd9c7f/Kylian-Mbappe,10,4,0,5,5,5,16,11,5,0,5,5,15,6,0
https://fbref.com/en/players/f20e4cc9/Nuno-Mendes,45,30,29,12,4,30,41,11,19,3,16,17,62,18,0
https://fbref.com/en/players/d70ce98e/Lionel-Messi,26,18,1,13,12,11,27,16,11,0,11,2,28,0,0
https://fbref.com/en/players/ac73ec79/Nordi-Mukiele,31,23,16,6,9,19,29,10,22,9,13,14,45,16,0
https://fbref.com/en/players/69384e5d/Neymar,22,14,6,9,7,9,19,10,7,1,6,4,26,1,1
https://fbref.com/en/players/dff153a4/Leandro-Paredes,1,1,1,0,0,1,1,0,2,1,1,1,2,0,0
https://fbref.com/en/players/f8ce97ca/Timothee-Pembele,5,5,3,1,1,2,4,2,2,0,2,4,9,2,0
https://fbref.com/en/players/8fd9996f/Danilo-Pereira,32,17,15,14,3,19,26,7,26,19,7,36,68,59,1
https://fbref.com/en/players/08511d65/Sergio-Ramos,34,26,14,18,2,23,44,21,29,13,16,34,68,93,3
https://fbref.com/en/players/c0c7ff58/Fabian-Ruiz-Pena,62,28,25,30,7,43,79,36,24,1,23,18,80,23,1
https://fbref.com/en/players/032f894e/Renato-Sanches,8,1,1,3,4,5,14,9,13,3,10,9,17,4,0
https://fbref.com/en/players/9744ff80/Pablo-Sarabia,5,4,2,2,1,1,7,6,3,0,3,2,7,0,0
https://fbref.com/en/players/fed17f5a/Carlos-Soler,20,12,6,10,4,10,19,9,12,4,8,4,24,6,0
https://fbref.com/en/players/1467af0d/Marco-Verratti,76,49,34,36,6,38,89,51,42,6,36,27,103,11,3
https://fbref.com/en/players/3b029691/Vitinha,58,25,21,27,10,27,83,56,27,4,23,25,83,15,0
https://fbref.com/en/players/6b9960cf/Warren-Zaire-Emery,17,10,5,10,2,8,29,21,11,0,11,12,29,17,0
https://fbref.com/en/players/f582d5c1/Sanoussy-Ba,0,0,0,0,0,0,0,0,0,0,0,0,0,0,0
https://fbref.com/en/players/663e080e/Janis-Blaswich,0,0,0,0,0,0,0,0,0,0,0,0,0,10,0
https://fbref.com/en/players/fc62f087/Abdou-Diallo,6,5,5,1,0,1,3,2,8,5,3,8,14,22,0
https://fbref.com/en/players/9a2e0ccc/Emil-Forsberg,16,11,1,8,7,6,20,14,25,2,23,3,19,7,0
https://fbref.com/en/players/bcb2ccd8/Peter-Gulacsi,0,0,0,0,0,0,0,0,0,0,0,0,0,2,0
https://fbref.com/en/players/5ad50391/Josko-Gvardiol,23,17,15,8,0,9,22,13,34,17,17,34,57,76,1
https://fbref.com/en/players/92432bc6/Amadou-Haidara,25,11,15,10,0,13,34,21,26,6,20,26,51,20,0
https://fbref.com/en/players/8ff2354e/Marcel-Halstenberg,40,21,20,15,5,23,41,18,22,1,21,21,61,29,0
https://fbref.com/en/players/0a89e877/Benjamin-Henrichs,73,46,41,29,3,43,66,23,48,4,44,35,108,46,0
https://fbref.com/en/players/b825a650/Kevin-Kampl,21,11,6,14,1,6,27,21,26,9,17,22,43,11,0
https://fbref.com/en/players/ca8033cb/Lukas-Klostermann,16,8,7,9,0,8,15,7,6,3,3,13,29,31,0
https://fbref.com/en/players/c1b7847c/Konrad-Laimer,60,31,23,30,7,30,54,24,31,4,27,18,78,8,0
https://fbref.com/en/players/7c56da38/Christopher-Nkunku,6,4,2,1,3,1,6,5,8,3,5,8,14,11,0
https://fbref.com/en/players/5458f670/Hugo-Novoa,8,2,1,3,4,4,7,3,4,0,4,1,9,0,0
https://fbref.com/en/players/bdedffac/Orjan-Nyland,0,0,0,0,0,0,0,0,0,0,0,0,0,0,0
https://fbref.com/en/players/ae44e8e2/Dani-Olmo,15,9,1,10,4,6,14,8,15,0,15,6,21,6,0
https://fbref.com/en/players/20030c06/Willi-Orban,51,30,33,18,0,26,43,17,42,24,18,39,90,129,1
https://fbref.com/en/players/d2416c2e/Yussuf-Poulsen,6,4,1,4,1,2,5,3,3,1,2,0,6,5,0
https://fbref.com/en/players/7d450ed3/David-Raum,39,25,23,12,4,17,29,12,24,6,18,16,55,26,1
https://fbref.com/en/players/8f056768/Xaver-Schlager,41,24,13,26,2,20,43,23,19,2,17,17,58,23,0
https://fbref.com/en/players/3effaa34/Andre-Silva,12,6,2,5,5,3,8,5,11,1,10,3,15,3,0
https://fbref.com/en/players/fcb27134/Mohamed-Simakan,21,14,12,5,4,14,21,7,21,4,17,16,37,55,0
https://fbref.com/en/players/934e1968/Dominik-Szoboszlai,45,28,12,20,13,17,42,25,43,2,41,17,62,27,0
https://fbref.com/en/players/e92cd3f7/Alexander-Sorloth,0,0,0,0,0,0,0,0,0,0,0,0,0,0,0
https://fbref.com/en/players/49fe9070/Timo-Werner,10,5,4,3,3,4,12,8,12,0,12,7,17,5,0
https://fbref.com/en/players/cee88597/Ivan-Balliu,52,29,26,20,6,18,30,12,26,3,23,25,77,72,1
https://fbref.com/en/players/d8712bf9/Bebe,0,0,0,0,0,0,2,2,1,0,1,0,0,0,0
https://fbref.com/en/players/873619c6/Sergio-Camello,16,10,3,9,4,5,17,12,9,1,8,2,18,26,0
https://fbref.com/en/players/274ab13c/Catena,29,14,23,4,2,13,27,14,32,25,7,28,57,159,1
https://fbref.com/en/players/63c5e56b/Pep-Chavarria,6,4,2,1,3,1,5,4,8,0,8,2,8,8,0
https://fbref.com/en/players/9a0408b6/Pathe-Ciss,39,29,11,23,5,15,34,19,23,10,13,22,61,34,0
https://fbref.com/en/players/5ae499d0/Santi-Comesana,71,44,24,41,6,38,82,44,39,3,36,32,103,17,0
https://fbref.com/en/players/fc70e345/Stole-Dimitrievski,1,0,1,0,0,1,2,1,2,0,2,1,2,17,3
https://fbref.com/en/players/66116290/Radamel-Falcao,4,4,1,3,0,1,8,7,5,1,4,2,6,10,0
https://fbref.com/en/players/90bbd822/Alvaro-Garcia,49,28,21,13,15,11,33,22,41,4,37,34,83,24,1
https://fbref.com/en/players/7226539b/Fran-Garcia,84,54,53,23,8,55,96,41,49,8,41,44,128,66,0
https://fbref.com/en/players/90162357/Mario-Hernandez,3,2,2,1,0,3,7,4,2,0,2,2,5,0,0
https://fbref.com/en/players/6eaed4eb/Florian-Lejeune,28,17,19,8,1,17,25,8,24,16,8,15,43,123,0
https://fbref.com/en/players/73683fa9/Diego-Lopez,0,0,0,0,0,0,0,0,0,0,0,0,0,0,1
https://fbref.com/en/players/88050721/Unai-Lopez,32,20,10,17,5,13,37,24,12,1,11,15,47,6,1
https://fbref.com/en/players/2ae30661/Andres-Martin,4,2,2,1,1,3,5,2,2,0,2,1,5,2,0
https://fbref.com/en/players/b151a3f2/Diego-Mendez,0,0,0,0,0,0,0,0,0,0,0,1,1,0,0
https://fbref.com/en/players/5487adcd/Abdul-Mumin,11,9,5,6,0,3,7,4,13,5,8,9,20,36,2
https://fbref.com/en/players/44e8521b/Pablo-Munoz,0,0,0,0,0,0,1,1,0,0,0,0,0,0,0
https://fbref.com/en/players/a6103274/Randy-Ntekja,4,2,2,2,0,1,1,0,2,0,2,2,6,3,0
https://fbref.com/en/players/49dbab27/Isaac-Palazon-Camacho,45,30,11,23,11,24,66,42,42,3,39,17,62,30,0
https://fbref.com/en/players/fc8b614b/Jose-Pozo,2,2,0,2,0,0,0,0,0,0,0,1,3,1,0
https://fbref.com/en/players/405f267a/Salvi,13,8,5,5,3,2,8,6,0,0,0,2,15,2,0
https://fbref.com/en/players/79f2a5f5/Esteban-Saveljich,0,0,0,0,0,0,0,0,0,0,0,0,0,0,0
https://fbref.com/en/players/7106f0a0/Mario-Suarez,0,0,0,0,0,0,0,0,1,0,1,0,0,0,0
https://fbref.com/en/players/02ef8778/Raul-de-Tomas,3,2,0,1,2,2,6,4,4,0,4,0,3,6,0
https://fbref.com/en/players/fc647b34/Oscar-Trejo,48,32,12,23,13,9,44,35,31,3,28,8,56,8,1
https://fbref.com/en/players/592f3158/Oscar-Valentin,92,51,29,50,13,46,121,75,60,9,51,44,136,30,0
https://fbref.com/en/players/05439de2/David-Alaba,15,11,8,4,3,9,15,6,18,9,9,14,29,37,1
https://fbref.com/en/players/1e465e70/Sergio-Arribas,0,0,0,0,0,0,0,0,1,0,1,0,0,0,0
https://fbref.com/en/players/45af8a54/Marco-Asensio,16,10,8,6,2,8,19,11,8,3,5,5,21,4,0
https://fbref.com/en/players/70d74ece/Karim-Benzema,9,5,2,4,3,2,11,9,11,0,11,2,11,5,0
https://fbref.com/en/players/7b9c2d84/Eduardo-Camavinga,68,48,32,21,15,24,64,40,24,5,19,17,85,25,0
https://fbref.com/en/players/4958bfb2/Dani-Carvajal,32,18,15,12,5,18,35,17,24,6,18,15,47,49,0
https://fbref.com/en/players/4d224fe8/Casemiro,0,0,0,0,0,0,0,0,0,0,0,0,0,1,0
https://fbref.com/en/players/c0617e2b/Dani-Ceballos,43,29,13,15,15,25,64,39,23,2,21,25,68,6,1
https://fbref.com/en/players/1840e36d/Thibaut-Courtois,1,0,1,0,0,1,1,0,0,0,0,3,4,7,1
https://fbref.com/en/players/a39bb753/Eden-Hazard,0,0,0,0,0,0,2,2,1,0,1,1,1,0,0
https://fbref.com/en/players/7111d552/Vinicius-Junior,30,21,10,12,8,14,39,25,24,1,23,6,36,1,0
https://fbref.com/en/players/6ce1f46f/Toni-Kroos,51,32,16,33,2,23,69,46,23,4,19,24,75,11,0
https://fbref.com/en/players/3061e1ec/Andriy-Lunin,0,0,0,0,0,0,0,0,0,0,0,0,0,1,0
https://fbref.com/en/players/5c4dc0ff/Mariano,1,0,0,1,0,0,0,0,1,0,1,0,1,0,0
https://fbref.com/en/players/3cefcaef/Ferland-Mendy,21,12,14,6,1,12,20,8,7,2,5,14,35,16,0
https://fbref.com/en/players/2784f898/Eder-Militao,46,32,25,18,3,26,33,7,67,39,28,42,88,104,2
https://fbref.com/en/players/6025fab1/Luka-Modric,19,9,6,6,7,10,25,15,15,5,10,10,29,7,0
https://fbref.com/en/players/49a6ecbb/Alvaro-Munoz,2,1,1,0,1,1,1,0,0,0,0,0,2,1,0
https://fbref.com/en/players/2946f9a1/Nacho,24,16,17,5,2,12,29,17,11,6,5,18,42,37,0
https://fbref.com/en/players/1d1691ad/Alvaro-Odriozola,0,0,0,0,0,0,0,0,0,0,0,0,0,0,0
https://fbref.com/en/players/8f5e92a6/Rodrygo,17,10,3,7,7,4,23,19,23,0,23,8,25,5,0
https://fbref.com/en/players/18b896d6/Antonio-Rudiger,18,16,12,5,1,14,23,9,23,13,10,19,37,74,0
https://fbref.com/en/players/4f255115/Aurelien-Tchouameni,64,40,23,36,5,23,38,15,20,6,14,49,113,50,0
https://fbref.com/en/players/c2111b45/Jesus-Vallejo,0,0,0,0,0,0,0,0,0,0,0,0,0,0,0
https://fbref.com/en/players/0959c2a2/Federico-Valverde,31,20,14,11,6,13,26,13,31,4,27,17,48,15,0
https://fbref.com/en/players/fd51b456/Lucas-Vazquez,34,23,22,10,2,20,28,8,10,0,10,7,41,13,0
https://fbref.com/en/players/f8405304/Mohamed-Ali-Cho,13,10,6,5,2,4,10,6,9,0,9,2,15,2,0
https://fbref.com/en/players/200e89e1/Ander-Barrenetxea,21,15,15,6,0,12,28,16,15,1,14,5,26,7,0
https://fbref.com/en/players/f7dc2ae5/Aritz-Elustondo,26,17,15,10,1,14,26,12,15,6,9,20,46,43,1
https://fbref.com/en/players/e08647d6/Carlos-Fernandez,6,4,1,3,2,1,15,14,1,0,1,1,7,4,0
https://fbref.com/en/players/6f5f82c0/Andoni-Gorosabel,41,25,23,9,9,26,43,17,21,2,19,17,58,23,0
https://fbref.com/en/players/8e48dc61/Ander-Guevara,5,2,2,2,1,1,4,3,6,1,5,2,7,3,0
https://fbref.com/en/players/5ce0b5ba/Asier-Illarramendi,36,18,10,22,4,16,44,28,27,8,19,18,54,20,0
https://fbref.com/en/players/8e92be30/Alexander-Isak,1,1,0,0,1,0,0,0,0,0,0,0,1,2,0
https://fbref.com/en/players/211589b8/Jon-Karrikaburu,1,0,0,1,0,0,0,0,2,0,2,0,1,0,0
https://fbref.com/en/players/16aa3654/Takefusa-Kubo,44,26,18,16,10,16,38,22,29,1,28,9,53,4,0
https://fbref.com/en/players/9a64e67e/Robin-Le-Normand,36,23,25,9,2,14,27,13,22,14,8,33,69,93,0
https://fbref.com/en/players/d4808594/Jon-Magunacelaya,1,0,0,0,1,0,2,2,0,0,0,0,1,1,0
https://fbref.com/en/players/a83c19cf/Pablo-Marin,10,5,5,4,1,2,7,5,1,0,1,4,14,2,0
https://fbref.com/en/players/e1e75690/Ander-Martin,2,2,1,1,0,1,4,3,0,0,0,0,2,1,0
https://fbref.com/en/players/c9e39d91/Brais-Mendez,58,34,18,30,10,24,64,40,27,3,24,12,70,14,1
https://fbref.com/en/players/d080ed5e/Mikel-Merino,77,49,28,33,16,31,62,31,38,8,30,20,97,51,1
https://fbref.com/en/players/228b0d9d/Aihen-Munoz,38,23,17,17,4,22,47,25,26,5,21,9,47,38,0
https://fbref.com/en/players/c997b942/Roberto-Navarro,5,4,4,0,1,1,2,1,7,0,7,2,7,2,0
https://fbref.com/en/players/3d99999d/Olasagasti,4,4,1,2,1,1,2,1,2,0,2,0,4,1,0
https://fbref.com/en/players/8c3c640c/Mikel-Oyarzabal,13,7,5,3,5,5,19,14,14,4,10,3,16,5,0
https://fbref.com/en/players/44150beb/Jon-Pacheco,16,10,10,6,0,6,10,4,9,6,3,12,28,37,1
https://fbref.com/en/players/374ee424/Alex-Remiro,1,1,1,0,0,1,3,2,0,0,0,0,1,17,3
https://fbref.com/en/players/d9ba39fc/Diego-Rico,35,21,17,11,7,12,27,15,18,5,13,20,55,51,1
https://fbref.com/en/players/686cbe7d/Umar-Sadiq,1,1,0,0,1,0,1,1,2,0,2,0,1,0,0
https://fbref.com/en/players/e2716bd0/David-Silva,36,21,11,18,7,11,19,8,17,2,15,15,51,16,0
https://fbref.com/en/players/5fa714d5/Alex-Sola,18,9,14,3,1,7,10,3,7,2,5,7,25,10,0
https://fbref.com/en/players/e92cd3f7/Alexander-Sorloth,18,9,3,6,9,7,14,7,15,1,14,2,20,26,1
https://fbref.com/en/players/068f4dec/Benat-Turrientes,3,3,3,0,0,1,5,4,2,0,2,0,3,3,0
https://fbref.com/en/players/5c7845f6/Igor-Zubeldia,35,18,28,7,0,25,35,10,23,17,6,21,56,93,0
https://fbref.com/en/players/3ee0dd59/Martin-Zubimendi,59,33,23,30,6,24,45,21,44,17,27,37,96,55,4
https://fbref.com/en/players/32c2d95f/Yunis-Abdelhamid,82,50,47,33,2,39,52,13,65,27,38,64,146,116,1
https://fbref.com/en/players/7587446d/Martin-Adeline,3,3,2,1,0,3,4,1,3,1,2,3,6,3,0
https://fbref.com/en/players/75f1ed80/Emmanuel-Agbadou,71,49,53,16,2,42,65,23,30,14,16,32,103,107,3
https://fbref.com/en/players/6b5edd5d/Valentin-Atangana-Edoa,8,3,4,2,2,3,6,3,2,1,1,0,8,1,0
https://fbref.com/en/players/31822f8c/Folarin-Balogun,9,5,1,5,3,2,20,18,20,1,19,3,12,15,0
https://fbref.com/en/players/0b2c9aec/Mitchell-van-Bergen,18,8,6,7,5,8,20,12,8,2,6,6,24,11,0
https://fbref.com/en/players/47c609d5/El-Bilal-Toure,0,0,0,0,0,0,0,0,2,0,2,0,0,1,0
https://fbref.com/en/players/7b082ec2/Maxime-Busi,21,16,9,11,1,13,29,16,14,6,8,14,35,24,0
https://fbref.com/en/players/928a4a61/Jens-Cajuste,46,25,25,14,7,25,48,23,30,6,24,18,64,22,0
https://fbref.com/en/players/5fdcb075/Thibault-De-Smet,24,17,10,14,0,11,37,26,28,5,23,20,44,40,1
https://fbref.com/en/players/331c5a98/Mamadou-Diakhon,2,0,2,0,0,0,1,1,1,0,1,1,3,0,0
https://fbref.com/en/players/d8c19a60/Ibrahim-Diakite,3,3,3,0,0,2,3,1,0,0,0,5,8,6,0
https://fbref.com/en/players/eedea60b/Yehvann-Diouf,2,0,2,0,0,1,3,2,0,0,0,1,3,13,5
https://fbref.com/en/players/9226aa22/Kamory-Doumbia,31,16,9,14,8,12,37,25,17,1,16,13,44,3,0
https://fbref.com/en/players/9c221d14/Wout-Faes,1,1,1,0,0,1,2,1,6,3,3,7,8,19,0
https://fbref.com/en/players/2c8a91b9/Fallou-Fall,0,0,0,0,0,0,1,1,3,3,0,0,0,4,0
https://fbref.com/en/players/caef7840/Alexis-Flips,51,30,18,17,16,27,64,37,35,5,30,24,75,12,0
https://fbref.com/en/players/90eb507d/Thomas-Foket,35,22,18,11,6,17,46,29,21,7,14,33,68,29,2
https://fbref.com/en/players/49136c42/Andrew-Gravillon,16,8,9,6,1,8,13,5,18,9,9,21,37,36,0
https://fbref.com/en/players/7091324a/Rafik-Guitane,0,0,0,0,0,0,0,0,0,0,0,0,0,1,0
https://fbref.com/en/players/61b77d0a/Noah-Holm,6,4,2,2,2,2,5,3,0,0,0,0,6,5,0
https://fbref.com/en/players/dbd3a428/Junya-Ito,40,20,14,15,11,13,53,40,29,1,28,8,48,4,1
https://fbref.com/en/players/c9f2f83a/Check-Keita,12,9,9,3,0,4,9,5,6,5,1,5,17,24,1
https://fbref.com/en/players/6751b938/Samuel-Koeberle,0,0,0,0,0,0,0,0,0,0,0,0,0,0,0
https://fbref.com/en/players/40221fa7/Banzouzi-Locko,31,16,21,4,6,15,27,12,17,4,13,20,51,21,0
https://fbref.com/en/players/64c14d49/Dion-Lopy,45,24,22,16,7,23,62,39,27,3,24,22,67,18,0
https://fbref.com/en/players/706a60e1/Myziane-Maolida,8,3,2,5,1,5,12,7,1,0,1,2,10,0,0
https://fbref.com/en/players/a17a94d6/Azor-Matusiwa,66,41,30,29,7,36,61,25,37,11,26,46,112,52,0
https://fbref.com/en/players/46750e9c/Nathanael-Mbuku,2,1,2,0,0,2,2,0,0,0,0,0,2,0,0
https://fbref.com/en/players/2acf0cd7/Marshall-Munetsi,58,27,13,31,14,20,48,28,37,11,26,26,84,41,1
https://fbref.com/en/players/0810b6df/Patrick-Pentz,0,0,0,0,0,0,0,0,0,0,0,0,0,1,0
https://fbref.com/en/players/9c2b1f11/Kaj-Sierhuis,3,3,1,0,2,0,5,5,3,1,2,1,4,2,0
https://fbref.com/en/players/8ac64b4e/Mohamed-Toure,0,0,0,0,0,0,0,0,0,0,0,0,0,0,0
https://fbref.com/en/players/095e4199/Arber-Zeneli,9,3,3,3,3,5,12,7,8,0,8,2,11,2,0
https://fbref.com/en/players/0e46fa2f/Matthis-Abline,1,1,0,0,1,1,1,0,1,0,1,2,3,1,0
https://fbref.com/en/players/9e17ccff/Dogan-Alemdar,0,0,0,0,0,0,0,0,0,0,0,0,0,1,1
https://fbref.com/en/players/b026bbf6/Lorenz-Assignon,6,2,4,2,0,2,4,2,6,0,6,2,8,9,0
https://fbref.com/en/players/114bbdee/Loic-Bade,1,1,1,0,0,0,0,0,0,0,0,1,2,3,0
https://fbref.com/en/players/c678ddd7/Jeanoel-Belocian,10,7,3,5,2,5,9,4,6,3,3,6,16,11,0
https://fbref.com/en/players/20e73fac/Benjamin-Bourigeaud,45,29,16,23,6,21,65,44,38,3,35,31,76,32,0
https://fbref.com/en/players/1bd5bdc4/Alan-Do-Marcolino,0,0,0,0,0,0,0,0,0,0,0,0,0,1,0
https://fbref.com/en/players/fffea3e5/Jeremy-Doku,25,16,6,13,6,12,24,12,10,0,10,5,30,2,0
https://fbref.com/en/players/9e7483ff/Desire-Doue,37,18,10,23,4,13,32,19,17,1,16,13,50,3,0
https://fbref.com/en/players/b4ef3fb5/Guela-Doue,0,0,0,0,0,0,0,0,0,0,0,0,0,0,0
https://fbref.com/en/players/aad56ca3/Amine-Gouiri,42,25,14,16,12,14,33,19,21,0,21,12,54,10,0
https://fbref.com/en/players/923f4dda/Sehrou-Guirassy,0,0,0,0,0,0,0,0,0,0,0,0,0,0,0
https://fbref.com/en/players/bf4c41f9/Arnaud-Kalimuendo,15,8,3,6,6,5,20,15,15,2,13,2,17,9,0
https://fbref.com/en/players/7cdda3bf/Gaetan-Laborde,1,1,1,0,0,0,1,1,1,0,1,0,1,1,0
https://fbref.com/en/players/fc46aab1/Lovro-Majer,34,23,16,13,5,8,29,21,21,1,20,21,55,5,1
https://fbref.com/en/players/1d2d5cc8/Steve-Mandanda,0,0,0,0,0,0,2,2,0,0,0,0,0,9,3
https://fbref.com/en/players/70c52749/Birger-Meling,24,15,9,12,3,12,25,13,18,2,16,23,47,26,0
https://fbref.com/en/players/4534a352/Warmed-Omari,20,11,14,6,0,14,28,14,13,7,6,17,37,43,1
https://fbref.com/en/players/8d62d31a/Joe-Rodon,11,7,9,2,0,4,10,6,16,12,4,9,20,54,1
https://fbref.com/en/players/cad3fd4d/Ibrahim-Salah,8,1,5,3,0,2,15,13,3,0,3,2,10,0,0
https://fbref.com/en/players/5e22e2a4/Baptiste-Santamaria,41,22,13,23,5,21,41,20,21,5,16,21,62,23,0
https://fbref.com/en/players/9bc9a519/Djed-Spence,14,6,8,2,4,11,18,7,10,3,7,4,18,15,0
https://fbref.com/en/players/a62f8bf1/Kamaldeen-Sulemana,6,3,1,4,1,1,5,4,2,0,2,4,10,2,0
https://fbref.com/en/players/a0f9b535/Flavien-Tait,30,15,8,17,5,19,42,23,16,4,12,20,50,12,0
https://fbref.com/en/players/5148dcc5/Martin-Terrier,25,11,7,9,9,13,24,11,15,2,13,14,39,6,0
https://fbref.com/en/players/df8d6029/Arthur-Theate,29,19,17,8,4,17,30,13,26,14,12,30,59,114,3
https://fbref.com/en/players/5ceba7fc/Karl-Toko-Ekambi,3,1,1,1,1,3,9,6,5,0,5,9,12,3,0
https://fbref.com/en/players/a4b1028a/Hamari-Traore,48,32,26,15,7,28,52,24,33,7,26,38,86,64,0
https://fbref.com/en/players/5d0e0a1f/Adrien-Truffert,62,32,36,17,9,31,46,15,32,8,24,22,84,55,0
https://fbref.com/en/players/1df4a109/Chimuanya-Ugochukwu,36,19,13,20,3,16,24,8,24,10,14,21,57,16,0
https://fbref.com/en/players/b003239d/Christopher-Wooh,16,7,8,8,0,9,11,2,11,5,6,6,22,49,0
https://fbref.com/en/players/f3600c02/Xeka,10,3,6,3,1,7,16,9,11,2,9,6,16,8,0
https://fbref.com/en/players/f586779e/Tammy-Abraham,17,10,4,8,5,3,16,13,10,4,6,3,20,14,0
https://fbref.com/en/players/d705ba44/Andrea-Belotti,12,5,3,5,4,5,11,6,11,1,10,3,15,5,0
https://fbref.com/en/players/ae94a6c5/Edoardo-Bove,35,18,12,15,8,16,39,23,15,1,14,10,45,11,0
https://fbref.com/en/players/13ea2544/Mohamed-Camara,13,10,3,7,3,5,15,10,5,1,4,10,23,8,0
https://fbref.com/en/players/31a62dc7/Zeki-Celik,42,21,19,21,2,24,41,17,33,6,27,14,56,36,2
https://fbref.com/en/players/16657b95/Bryan-Cristante,113,62,55,49,9,55,90,35,39,10,29,18,131,53,0
https://fbref.com/en/players/e0921a4f/Paulo-Dybala,14,4,1,8,5,8,26,18,12,1,11,8,22,4,0
https://fbref.com/en/players/82efe6fa/Roger-Ibanez,67,33,38,26,3,32,48,16,30,11,19,66,133,95,2
https://fbref.com/en/players/9f84febe/Rick-Karsdorp,21,13,11,7,3,13,22,9,0,0,0,7,28,15,1
https://fbref.com/en/players/a40819d9/Marash-Kumbulla,4,4,2,2,0,2,3,1,2,1,1,4,8,6,0
https://fbref.com/en/players/bba30585/Diego-Llorente,10,5,6,4,0,5,12,7,4,2,2,11,21,20,0
https://fbref.com/en/players/2e7dafe5/Jordan-Majchrzak,0,0,0,0,0,0,0,0,0,0,0,0,0,0,0
https://fbref.com/en/players/5aa53281/Gianluca-Mancini,37,19,27,9,1,18,34,16,38,17,21,46,83,67,0
https://fbref.com/en/players/eb7822d7/Nemanja-Matic,47,27,24,19,4,19,33,14,27,7,20,25,72,21,1
https://fbref.com/en/players/2d3d7c0d/Filippo-Missori,4,3,3,0,1,3,6,3,0,0,0,3,7,5,0
https://fbref.com/en/players/79b0d6a0/Rui-Patricio,1,1,1,0,0,1,1,0,0,0,0,2,3,6,3
https://fbref.com/en/players/4a5a45c7/Lorenzo-Pellegrini,52,29,24,24,4,22,48,26,27,4,23,26,78,22,0
https://fbref.com/en/players/c84dcc88/Niccolo-Pisilli,0,0,0,0,0,0,0,0,0,0,0,0,0,0,0
https://fbref.com/en/players/d3aaad90/Stephan-El-Shaarawy,21,9,8,10,3,6,22,16,11,1,10,15,36,11,0
https://fbref.com/en/players/57469b2d/Eldor-Shomurodov,1,0,1,0,0,0,2,2,1,0,1,1,2,0,0
https://fbref.com/en/players/b6964eb6/Chris-Smalling,26,15,16,10,0,13,21,8,51,36,15,43,69,123,0
https://fbref.com/en/players/78f13530/Ola-Solbakken,2,2,1,1,0,2,7,5,2,0,2,2,4,8,0
https://fbref.com/en/players/3626daea/Leonardo-Spinazzola,15,8,7,6,2,8,23,15,13,3,10,9,24,25,0
https://fbref.com/en/players/bcf5058a/Mile-Svilar,0,0,0,0,0,0,0,0,0,0,0,0,0,1,0
https://fbref.com/en/players/eb3022c3/Benjamin-Tahirovic,8,5,5,2,1,4,12,8,9,4,5,3,11,3,0
https://fbref.com/en/players/08eb3b58/Matias-Vina,3,1,1,1,1,1,3,2,5,1,4,2,5,5,0
https://fbref.com/en/players/72f87f25/Cristian-Volpato,3,2,1,1,1,0,2,2,2,0,2,2,5,0,0
https://fbref.com/en/players/eb58eef0/Georginio-Wijnaldum,4,3,1,3,0,0,2,2,7,1,6,2,6,3,0
https://fbref.com/en/players/45191c29/Nicola-Zalewski,45,26,25,15,5,22,71,49,27,1,26,31,76,23,0
https://fbref.com/en/players/9907b1c8/Nicolo-Zaniolo,7,5,2,4,1,2,7,5,11,0,11,2,9,0,0
https://fbref.com/en/players/c83c203f/Emil-Bohinen,25,13,15,8,2,12,23,11,25,7,18,17,42,21,0
https://fbref.com/en/players/bf57eaab/Federico-Bonazzoli,5,3,0,3,2,0,9,9,9,1,8,3,8,0,0
https://fbref.com/en/players/3d13d9e4/Erik-Botheim,11,7,3,4,4,6,13,7,3,0,3,0,11,4,0
https://fbref.com/en/players/8bbe2df5/Domagoj-Bradaric,26,19,14,8,4,7,16,9,20,5,15,21,47,44,0
https://fbref.com/en/players/edd81e2a/Dylan-Bronn,34,18,17,16,1,20,30,10,32,20,12,20,54,58,1
https://fbref.com/en/players/356c9002/Antonio-Candreva,17,7,13,2,2,11,38,27,7,3,4,17,34,32,0
https://fbref.com/en/players/85a44ecc/Lassana-Coulibaly,84,50,42,35,7,30,73,43,35,7,28,25,109,33,2
https://fbref.com/en/players/22cd43d2/Domen-Crnigoj,8,3,0,7,1,1,2,1,9,1,8,9,17,6,0
https://fbref.com/en/players/7ef972c3/Flavius-Daniliuc,57,29,37,17,3,26,47,21,30,13,17,29,86,76,0
https://fbref.com/en/players/244bc2c8/Boulaye-Dia,12,5,3,6,3,2,7,5,10,0,10,7,19,27,1
https://fbref.com/en/players/4e358a2d/Federico-Fazio,15,12,8,7,0,4,11,7,9,4,5,28,43,61,0
https://fbref.com/en/players/a2565f79/Vincenzo-Fiorillo,0,0,0,0,0,0,0,0,0,0,0,0,0,0,0
https://fbref.com/en/players/0be276c6/Norbert-Gyomber,32,23,25,6,1,16,24,8,33,22,11,35,67,92,0
https://fbref.com/en/players/daa4c94c/Antonio-Iervolino,0,0,0,0,0,0,1,1,0,0,0,0,0,0,0
https://fbref.com/en/players/2a82aa85/Grigoris-Kastanos,39,23,18,19,2,16,40,24,20,6,14,8,47,8,0
https://fbref.com/en/players/b804c280/Julian-Kristoffersen,0,0,0,0,0,0,0,0,1,0,1,0,0,0,0
https://fbref.com/en/players/5fa57166/Matteo-Lovato,17,14,14,3,0,10,25,15,8,5,3,13,30,33,2
https://fbref.com/en/players/957e4c87/Giulio-Maggiore,20,8,11,6,3,10,21,11,19,4,15,8,28,10,0
https://fbref.com/en/players/eb0ec070/Pasquale-Mazzocchi,32,18,21,5,6,17,37,20,10,2,8,10,42,37,2
https://fbref.com/en/players/b136c945/Hans-Nicolussi-Caviglia,15,6,5,8,2,9,15,6,9,0,9,7,22,7,1
https://fbref.com/en/players/1e9bde92/Guillermo-Ochoa,0,0,0,0,0,0,2,2,0,0,0,0,0,9,1
https://fbref.com/en/players/17f3620a/Krzysztof-Piatek,18,11,3,9,6,5,21,16,17,4,13,2,20,39,0
https://fbref.com/en/players/caec77da/Lorenzo-Pirola,33,29,18,14,1,19,27,8,50,35,15,30,63,85,1
https://fbref.com/en/players/023937a9/Ivan-Radovanovic,12,4,8,4,0,4,10,6,9,3,6,7,19,9,1
https://fbref.com/en/players/f61c7c4e/Franck-Ribery,0,0,0,0,0,0,0,0,1,0,1,0,0,0,0
https://fbref.com/en/players/24eb7ed6/Junior-Sambia,12,5,7,4,1,6,10,4,9,3,6,8,20,16,1
https://fbref.com/en/players/343f753a/Luigi-Sepe,0,0,0,0,0,0,1,1,0,0,0,0,0,0,0
https://fbref.com/en/players/7ed4921e/William-Troost-Ekong,11,3,7,4,0,6,7,1,7,4,3,6,17,10,0
https://fbref.com/en/players/71005acd/Diego-Valencia,8,5,4,2,2,2,9,7,10,1,9,1,9,2,0
https://fbref.com/en/players/c7069d87/Tonny-Vilhena,44,22,16,23,5,20,50,30,17,7,10,18,62,21,0
https://fbref.com/en/players/2df7cc43/Bruno-Amione,50,33,36,14,0,19,43,24,26,11,15,25,75,62,1
https://fbref.com/en/players/649b01d8/Emil-Audero,0,0,0,0,0,0,2,2,0,0,0,0,0,7,1
https://fbref.com/en/players/3cd3b384/Tommaso-Augello,17,14,13,2,2,9,20,11,23,7,16,17,34,61,1
https://fbref.com/en/players/61b3978f/Bartosz-Bereszynski,28,18,15,11,2,17,26,9,18,4,14,21,49,25,0
https://fbref.com/en/players/5bd72174/Francesco-Caputo,3,1,0,0,3,0,3,3,0,0,0,1,4,3,0
https://fbref.com/en/players/8b95acda/Omar-Colley,17,10,10,7,0,9,12,3,9,5,4,22,39,69,1
https://fbref.com/en/players/8fef5412/Andrea-Conti,0,0,0,0,0,0,0,0,0,0,0,0,0,0,0
https://fbref.com/en/players/5722eced/Mickael-Cuisance,13,10,7,5,1,5,23,18,10,0,10,5,18,4,0
https://fbref.com/en/players/60e3603d/Manuel-De-Luca,0,0,0,0,0,0,0,0,0,0,0,0,0,0,0
https://fbref.com/en/players/d97f2e8d/Fabio-Depaoli,5,3,2,3,0,3,4,1,1,0,1,1,6,4,0
https://fbref.com/en/players/d0dbca9f/Alex-Ferrari,9,5,7,2,0,4,8,4,21,10,11,19,28,25,0
https://fbref.com/en/players/8f866fe8/Manolo-Gabbiadini,23,15,8,9,6,9,23,14,16,2,14,6,29,25,0
https://fbref.com/en/players/f1f1f238/Koray-Gunter,10,8,6,4,0,6,9,3,10,5,5,11,21,46,0
https://fbref.com/en/players/a47c6309/Emirhan-Ilkhan,6,3,2,2,2,2,3,1,5,1,4,0,6,3,0
https://fbref.com/en/players/71c620d7/Mihailo-Ivanovic,0,0,0,0,0,0,0,0,0,0,0,0,0,0,0
https://fbref.com/en/players/4a537185/Jese,2,0,0,2,0,0,1,1,3,1,2,1,3,2,0
https://fbref.com/en/players/c283ddef/Sam-Lammers,12,5,2,7,3,6,15,9,10,3,7,6,18,11,0
https://fbref.com/en/players/7d3cbc67/Mehdi-Leris,63,46,30,24,9,23,55,32,38,6,32,27,90,34,0
https://fbref.com/en/players/2bffcbf2/Lorenzo-Malagrida,1,0,0,0,1,1,3,2,1,0,1,0,1,1,0
https://fbref.com/en/players/ca73910d/Daniele-Montevago,1,0,0,0,1,0,1,1,2,1,1,0,1,1,0
https://fbref.com/en/players/b233e8e4/Jeison-Murillo,22,11,16,6,0,17,26,9,22,14,8,8,30,39,0
https://fbref.com/en/players/d183e9d6/Nicola-Murru,24,14,15,8,1,7,13,6,17,7,10,10,34,21,0
https://fbref.com/en/players/48329ff8/Samuel-Ntanda,0,0,0,0,0,0,0,0,0,0,0,0,0,0,0
https://fbref.com/en/players/e33f36d5/Bram-Nuytinck,54,38,33,21,0,23,34,11,36,21,15,23,77,84,0
https://fbref.com/en/players/3b9858f5/Marios-Oikonomou,3,2,3,0,0,1,3,2,5,4,1,4,7,13,0
https://fbref.com/en/players/3d6cee81/Flavio-Paoletti,2,2,0,2,0,1,5,4,1,0,1,5,7,9,0
https://fbref.com/en/players/62437b4f/Ignacio-Pussetto,6,3,2,3,1,3,4,1,4,0,4,0,6,3,0
https://fbref.com/en/players/ee4f2f3b/Fabio-Quagliarella,2,1,1,1,0,1,7,6,5,1,4,0,2,9,0
https://fbref.com/en/players/d7a35008/Nicola-Ravaglia,0,0,0,0,0,0,1,1,0,0,0,0,0,7,0
https://fbref.com/en/players/f1cfc209/Tomas-Rincon,56,27,22,26,8,29,61,32,37,7,30,30,86,18,0
https://fbref.com/en/players/4830e0af/Abdelhamid-Sabiri,18,7,5,9,4,4,13,9,18,4,14,2,20,5,0
https://fbref.com/en/players/9142b22f/Telasco-Segovia,0,0,0,0,0,0,0,0,0,0,0,0,0,0,0
https://fbref.com/en/players/14ae023f/Martin-Turk,0,0,0,0,0,0,0,0,0,0,0,0,0,1,0
https://fbref.com/en/players/33ecf462/Valerio-Verre,14,7,6,5,3,8,17,9,9,1,8,9,23,3,0
https://fbref.com/en/players/75e60d75/Ronaldo-Vieira,NA,10,NA,NA,NA,NA,NA,NA,NA,NA,NA,13,NA,NA,NA
https://fbref.com/en/players/bdc74a8f/Gonzalo-Villar,13,7,4,8,1,7,15,8,11,3,8,4,17,9,1
https://fbref.com/en/players/2f7acede/Harry-Winks,27,12,7,18,2,14,43,29,14,8,6,24,51,24,0
https://fbref.com/en/players/ee9040b4/Gerard-Yepes,5,3,2,3,0,1,3,2,3,0,3,4,9,3,0
https://fbref.com/en/players/3b12b11f/Alessandro-Zanoli,22,14,14,6,2,8,17,9,19,15,4,12,34,39,0
https://fbref.com/en/players/eccbe56a/Filip-Djuricic,43,22,18,20,5,14,32,18,19,6,13,7,50,8,0
https://fbref.com/en/players/ab472696/Agustin-Alvarez-Martinez,6,3,0,5,1,1,4,3,5,1,4,3,9,3,0
https://fbref.com/en/players/38d9ce53/Janis-Antiste,1,0,1,0,0,1,1,0,0,0,0,0,1,0,0
https://fbref.com/en/players/2200181e/Kaan-Ayhan,10,4,6,4,0,7,7,0,5,4,1,5,15,26,1
https://fbref.com/en/players/f42d6c13/Nedim-Bajrami,12,7,6,2,4,5,11,6,9,1,8,7,19,6,0
https://fbref.com/en/players/53a0e358/Domenico-Berardi,23,14,8,10,5,9,40,31,13,0,13,19,42,18,0
https://fbref.com/en/players/98a84572/Emil-Ceide,5,2,5,0,0,3,5,2,3,1,2,1,6,0,0
https://fbref.com/en/players/8cabdc1e/Andrea-Consigli,1,0,1,0,0,0,1,1,0,0,0,0,1,13,3
https://fbref.com/en/players/f778fe3f/Luca-DAndrea,4,0,2,1,1,1,4,3,2,0,2,1,5,1,0
https://fbref.com/en/players/854ee61a/Gregoire-Defrel,9,7,5,2,2,4,13,9,11,0,11,2,11,5,0
https://fbref.com/en/players/0fee6bda/Martin-Erlic,27,16,18,8,1,10,23,13,36,23,13,31,58,120,1
https://fbref.com/en/players/2a7d27c1/Davide-Frattesi,63,36,24,29,10,25,44,19,27,6,21,16,79,42,0
https://fbref.com/en/players/65fd099c/Abdou-Harroui,17,6,6,7,4,2,7,5,6,1,5,2,19,10,0
https://fbref.com/en/players/a2d9f138/Matheus-Henrique,26,12,9,11,6,12,24,12,15,4,11,12,38,10,0
https://fbref.com/en/players/570bb4b9/Hamed-Junior-Traore,11,6,4,6,1,4,11,7,4,0,4,2,13,0,1
https://fbref.com/en/players/0a483542/Giorgos-Kyriakopoulos,21,8,7,9,5,10,14,4,7,1,6,11,32,12,1
https://fbref.com/en/players/2d22cea7/Armand-Lauriente,21,15,5,7,9,8,21,13,20,0,20,12,33,8,0
https://fbref.com/en/players/20094685/Maxime-Lopez,42,18,26,12,4,16,56,40,24,6,18,22,64,21,0
https://fbref.com/en/players/91d0fabf/Riccardo-Marchizza,2,2,1,1,0,2,4,2,2,0,2,2,4,8,0
https://fbref.com/en/players/8650af85/Gian-Marco-Ferrari,23,16,11,10,2,10,17,7,29,20,9,23,46,81,4
https://fbref.com/en/players/1295552e/Mert-Muldur,0,0,0,0,0,0,0,0,0,0,0,0,0,0,0
https://fbref.com/en/players/ba1e04b3/Pedro-Obiang,26,17,12,12,2,10,18,8,12,2,10,8,34,15,0
https://fbref.com/en/players/f058ed1f/Gianluca-Pegolo,0,0,0,0,0,0,1,1,0,0,0,0,0,1,0
https://fbref.com/en/players/08aa9cd1/Andrea-Pinamonti,10,7,0,5,5,3,7,4,19,2,17,2,12,11,0
https://fbref.com/en/players/6e058f06/Giacomo-Raspadori,0,0,0,0,0,0,0,0,0,0,0,0,0,0,0
https://fbref.com/en/players/10e7f486/Rogerio,37,21,22,8,7,17,35,18,32,9,23,37,74,70,0
https://fbref.com/en/players/84594618/Filippo-Romagna,0,0,0,0,0,0,0,0,1,1,0,0,0,2,0
https://fbref.com/en/players/a378a02a/Ruan,38,26,25,12,1,19,29,10,29,17,12,24,62,80,3
https://fbref.com/en/players/3945ac70/Alessandro-Russo,0,0,0,0,0,0,0,0,0,0,0,0,0,1,1
https://fbref.com/en/players/76ff8d0d/Kristian-Thorstvedt,16,7,4,9,3,6,17,11,19,5,14,14,30,13,0
https://fbref.com/en/players/a96e5dc0/Jeremy-Toljan,36,23,17,14,5,22,33,11,31,14,17,18,54,60,1
https://fbref.com/en/players/82598b71/Nadir-Zortea,15,8,12,2,1,9,14,5,10,4,6,4,19,21,0
https://fbref.com/en/players/8ce30c57/Eder-Alvarez-Balanta,5,4,2,3,0,2,6,4,0,0,0,3,8,4,0
https://fbref.com/en/players/fe46e261/Mehmet-Aydin,25,18,14,9,2,11,24,13,11,0,11,10,35,15,0
https://fbref.com/en/players/f0a37d36/Cedric-Brunner,39,27,26,11,2,30,45,15,24,7,17,43,82,79,0
https://fbref.com/en/players/ab5b7dc1/Marius-Bulter,22,11,8,7,7,12,32,20,34,1,33,10,32,20,0
https://fbref.com/en/players/d1db4b83/Kerim-Calhanoglu,2,1,2,0,0,2,2,0,1,0,1,0,2,3,0
https://fbref.com/en/players/7bf9400b/Sepp-van-den-Berg,5,4,2,2,1,1,4,3,8,5,3,13,18,33,2
https://fbref.com/en/players/809940aa/Dominick-Drexler,25,17,12,10,3,9,22,13,18,2,16,8,33,12,0
https://fbref.com/en/players/1e43fad8/Ralf-Fahrmann,1,0,1,0,0,1,1,0,0,0,0,0,1,10,2
https://fbref.com/en/players/9642c929/Florian-Flick,12,3,7,5,0,4,14,10,9,3,6,4,16,18,0
https://fbref.com/en/players/33182cb8/Michael-Frey,13,5,2,8,3,4,13,9,6,0,6,2,15,1,0
https://fbref.com/en/players/f9dfb7ae/Leo-Greiml,10,5,4,5,1,5,12,7,7,3,4,3,13,16,0
https://fbref.com/en/players/8bf58a80/Andreas-Ivan,0,0,0,0,0,0,1,1,0,0,0,0,0,1,0
https://fbref.com/en/players/ee644761/Moritz-Jenz,14,11,8,5,1,5,8,3,16,10,6,8,22,53,1
https://fbref.com/en/players/463503e2/Marcin-Kaminski,6,4,4,0,2,2,4,2,8,7,1,9,15,28,0
https://fbref.com/en/players/8f0f2230/Kenan-Karaman,11,8,3,5,3,3,12,9,9,1,8,3,14,9,0
https://fbref.com/en/players/ab096c6f/Timothee-Kolodziejczak,0,0,0,0,0,0,1,1,0,0,0,1,1,1,0
https://fbref.com/en/players/f1e855eb/Soichiro-Kozuki,6,4,3,3,0,4,6,2,5,0,5,3,9,3,0
https://fbref.com/en/players/e717705a/Alex-Kral,34,24,10,22,2,17,37,20,31,6,25,17,51,53,0
https://fbref.com/en/players/9f77012e/Tom-Krauss,112,68,39,62,11,51,100,49,39,6,33,36,148,35,0
https://fbref.com/en/players/72984eee/Jordan-Larsson,8,5,1,7,0,2,9,7,9,0,9,4,12,3,0
https://fbref.com/en/players/33b554b7/Danny-Latza,17,13,8,8,1,5,17,12,16,1,15,5,22,15,0
https://fbref.com/en/players/ab3f1bdf/Henning-Matriciani,43,23,28,12,3,26,60,34,28,11,17,23,66,57,1
https://fbref.com/en/players/ebb32f3a/Keke-Maximilian-Topp,0,0,0,0,0,0,0,0,0,0,0,1,1,0,0
https://fbref.com/en/players/9ec9c8b6/Tobias-Mohr,8,5,3,5,0,2,7,5,14,5,9,8,16,19,0
https://fbref.com/en/players/7e82a78f/Florent-Mollet,4,1,0,4,0,2,7,5,7,1,6,1,5,1,0
https://fbref.com/en/players/36d9dabe/Thomas-Ouwejan,20,8,13,5,2,6,10,4,17,4,13,13,33,27,0
https://fbref.com/en/players/3745e8bd/Sebastian-Polter,4,3,0,4,0,1,4,3,4,0,4,1,5,6,0
https://fbref.com/en/players/6a52a6c6/Sidi-Sane,1,1,1,0,0,1,1,0,0,0,0,0,1,0,0
https://fbref.com/en/players/0d55d942/Alexander-Schwolow,0,0,0,0,0,0,2,2,0,0,0,1,1,6,3
https://fbref.com/en/players/65857fdf/Tim-Skarke,13,7,3,8,2,8,11,3,5,0,5,0,13,4,0
https://fbref.com/en/players/863ff1ee/Simon-Terodde,15,8,4,7,4,3,14,11,6,2,4,6,21,9,0
https://fbref.com/en/players/ff5ea0bf/Malick-Thiaw,3,1,2,1,0,1,2,1,4,3,1,9,12,24,1
https://fbref.com/en/players/d75f3980/Jere-Uronen,14,10,6,6,2,6,10,4,5,2,3,8,22,13,0
https://fbref.com/en/players/caffaf5a/Maya-Yoshida,34,22,19,13,2,18,29,11,40,29,11,46,80,132,2
https://fbref.com/en/players/fc3697dd/Rodrigo-Zalazar,16,8,5,9,2,9,24,15,16,1,15,7,23,13,0
https://fbref.com/en/players/81442ecb/Marcos-Acuna,57,36,34,17,6,30,42,12,16,5,11,23,80,36,0
https://fbref.com/en/players/629081bd/Carlos-Alvarez,NA,1,NA,NA,NA,NA,NA,NA,NA,NA,NA,0,NA,NA,NA
https://fbref.com/en/players/114bbdee/Loic-Bade,27,20,23,3,1,17,30,13,21,13,8,23,50,77,0
https://fbref.com/en/players/f6798fc3/Yassine-Bounou,2,1,2,0,0,1,4,3,0,0,0,2,4,11,1
https://fbref.com/en/players/2dce876a/Carmona,13,11,5,3,5,9,16,7,10,6,4,7,20,17,1
https://fbref.com/en/players/fb938d24/Jesus-Corona,1,0,1,0,0,0,1,1,0,0,0,1,2,1,0
https://fbref.com/en/players/fe641c1a/Thomas-Delaney,4,2,0,4,0,3,5,2,3,2,1,4,8,3,0
https://fbref.com/en/players/ac295d9e/Marko-Dmitrovic,0,0,0,0,0,0,0,0,0,0,0,0,0,6,0
https://fbref.com/en/players/cc83b74d/Kasper-Dolberg,1,0,0,1,0,1,3,2,0,0,0,0,1,5,0
https://fbref.com/en/players/04e17fd5/Youssef-En-Nesyri,16,8,3,7,6,4,14,10,6,2,4,4,20,16,0
https://fbref.com/en/players/41f32541/Fernando,34,23,14,17,3,18,30,12,21,10,11,24,58,29,0
https://fbref.com/en/players/7b5ab7f2/Bryan-Gil,22,11,11,7,4,10,23,13,10,0,10,8,30,10,0
https://fbref.com/en/players/6e4df551/Papu-Gomez,6,4,3,3,0,2,10,8,8,1,7,4,10,5,0
https://fbref.com/en/players/0076ab7f/Nemanja-Gudelj,43,33,22,18,3,20,33,13,39,29,10,34,77,102,1
https://fbref.com/en/players/7155e3e1/Pape-Gueye,37,22,13,21,3,16,33,17,21,5,16,22,59,10,0
https://fbref.com/en/players/a0b4bb3e/Isco,15,9,6,5,4,8,14,6,3,0,3,10,25,3,0
https://fbref.com/en/players/9d33c71a/Diego-Iturralde,1,0,1,0,0,0,2,2,0,0,0,0,1,1,0
https://fbref.com/en/players/4737cebe/Adnan-Januzaj,0,0,0,0,0,0,1,1,0,0,0,1,1,0,0
https://fbref.com/en/players/2a0c8ba4/Joan-Jordan,32,17,13,17,2,16,38,22,14,7,7,16,48,14,2
https://fbref.com/en/players/abe66106/Erik-Lamela,46,27,14,16,16,12,34,22,26,2,24,7,53,3,0
https://fbref.com/en/players/133faa84/Marcao,2,2,1,1,0,1,1,0,3,3,0,6,8,14,0
https://fbref.com/en/players/bbf5c11b/Rafa-Mir,8,2,2,4,2,2,5,3,5,1,4,4,12,11,0
https://fbref.com/en/players/374d5158/Gonzalo-Montiel,26,15,12,14,0,15,29,14,25,7,18,19,45,38,0
https://fbref.com/en/players/3f10bd22/Jesus-Navas,19,12,8,3,8,11,22,11,18,7,11,22,41,52,1
https://fbref.com/en/players/5853ac44/Tanguy-Nianzou,20,15,10,9,1,8,11,3,8,5,3,16,36,44,3
https://fbref.com/en/players/a08b974a/Lucas-Ocampos,22,14,9,9,4,8,31,23,17,2,15,8,30,5,0
https://fbref.com/en/players/f9358b61/Pedro-Ortiz,0,0,0,0,0,0,0,0,0,0,0,0,0,0,0
https://fbref.com/en/players/89f951b5/Ivan-Rakitic,37,26,10,18,9,19,40,21,21,1,20,27,64,20,0
https://fbref.com/en/players/3376a776/Karim-Rekik,11,5,8,3,0,4,5,1,12,5,7,10,21,24,0
https://fbref.com/en/players/2fbe6af0/Ivan-Romero,0,0,0,0,0,0,0,0,0,0,0,0,0,0,0
https://fbref.com/en/players/0a69de7b/Kike-Salas,1,1,1,0,0,0,0,0,4,3,1,5,6,23,0
https://fbref.com/en/players/c5642098/Manuel-Sebastian,7,4,3,3,1,5,8,3,0,0,0,0,7,2,0
https://fbref.com/en/players/4e219ad2/Suso,16,10,5,7,4,10,22,12,7,1,6,2,18,3,0
https://fbref.com/en/players/e73c9bb2/Alex-Telles,21,13,15,6,0,13,25,12,17,5,12,20,41,38,0
https://fbref.com/en/players/58a9a4d9/Oliver-Torres,39,23,12,13,14,18,59,41,26,5,21,10,49,10,0
https://fbref.com/en/players/f2bf1b0f/Che-Adams,17,13,7,8,2,7,12,5,13,4,9,4,21,22,0
https://fbref.com/en/players/4abac767/Carlos-Alcaraz,10,5,2,7,1,6,22,16,14,5,9,1,11,11,0
https://fbref.com/en/players/9eedf0e0/Samuel-Amo-Ameyaw,0,0,0,0,0,0,1,1,0,0,0,0,0,0,0
https://fbref.com/en/players/328f7d51/Joe-Aribo,31,20,15,12,4,11,20,9,14,1,13,10,41,11,0
https://fbref.com/en/players/68c720b5/Adam-Armstrong,14,9,6,5,3,3,10,7,15,3,12,5,19,6,0
https://fbref.com/en/players/97333cf5/Stuart-Armstrong,32,21,15,13,4,14,39,25,18,0,18,10,42,9,1
https://fbref.com/en/players/ed8d597c/Dominic-Ballard,0,0,0,0,0,0,0,0,0,0,0,1,1,0,0
https://fbref.com/en/players/c91441dc/Gavin-Bazunu,1,0,1,0,0,1,1,0,0,0,0,1,2,24,2
https://fbref.com/en/players/4115ce4e/Jan-Bednarek,27,21,20,7,0,12,16,4,38,27,11,49,76,87,0
https://fbref.com/en/players/a39d11bc/Armel-Bella-Kotchap,37,17,28,9,0,15,20,5,29,12,17,44,81,110,0
https://fbref.com/en/players/c07b7c5c/James-Bree,5,3,4,1,0,3,4,1,3,1,2,6,11,11,0
https://fbref.com/en/players/94f8d10c/Duje-Caleta-Car,14,10,9,4,1,6,9,3,15,11,4,15,29,65,1
https://fbref.com/en/players/11ff3d56/Ibrahima-Diallo,25,15,14,10,1,8,14,6,11,1,10,6,31,11,0
https://fbref.com/en/players/254147d4/Moussa-Djenepo,19,11,13,5,1,11,26,15,19,2,17,11,30,7,0
https://fbref.com/en/players/65983e4d/Kami-Doyle,0,0,0,0,0,0,0,0,0,0,0,0,0,0,0
https://fbref.com/en/players/007414dd/Samuel-Edozie,17,10,6,10,1,3,8,5,7,0,7,6,23,6,0
https://fbref.com/en/players/68dc0dac/Mohamed-Elyounoussi,46,28,22,20,4,19,43,24,40,3,37,27,73,37,0
https://fbref.com/en/players/cf7fb13a/Juan-Larios,7,6,6,1,0,5,5,0,2,0,2,3,10,4,0
https://fbref.com/en/players/ecad9aa5/Romeo-Lavia,60,35,27,29,4,21,53,32,47,11,36,33,93,23,1
https://fbref.com/en/players/afed6722/Valentino-Livramento,2,1,2,0,0,0,0,0,0,0,0,2,4,3,0
https://fbref.com/en/players/b5bf1770/Lyanco,24,16,15,9,0,12,18,6,30,25,5,20,44,65,2
https://fbref.com/en/players/e3a5814e/Ainsley-Maitland-Niles,45,24,23,18,4,28,44,16,28,7,21,22,67,45,1
https://fbref.com/en/players/3544641e/Sekou-Mara,14,10,5,8,1,3,9,6,11,0,11,1,15,5,0
https://fbref.com/en/players/36c2ca73/Alex-McCarthy,0,0,0,0,0,0,1,1,0,0,0,1,1,3,1
https://fbref.com/en/players/c06d1086/Paul-Onuachu,3,2,1,1,1,1,3,2,4,1,3,0,3,4,0
https://fbref.com/en/players/ee950928/Mislav-Orsic,1,1,1,0,0,0,0,0,0,0,0,0,1,0,0
https://fbref.com/en/players/6dfd8f05/Romain-Perraud,54,33,23,23,8,28,52,24,24,6,18,20,74,42,0
https://fbref.com/en/players/ab651565/Nathan-Redmond,0,0,0,0,0,0,0,0,0,0,0,0,0,0,0
https://fbref.com/en/players/4b511457/Oriol-Romeu,1,0,0,1,0,0,0,0,1,0,1,1,2,1,0
https://fbref.com/en/players/0b33f6ad/Mohammed-Salisu,51,29,33,16,2,24,34,10,56,25,31,31,82,122,1
https://fbref.com/en/players/6adbc307/Jack-Stephens,2,2,2,0,0,1,1,0,1,1,0,1,3,2,0
https://fbref.com/en/players/a62f8bf1/Kamaldeen-Sulemana,15,9,4,7,4,4,14,10,16,0,16,6,21,6,0
https://fbref.com/en/players/531a4aa8/Yan-Valery,0,0,0,0,0,0,0,0,1,0,1,0,0,3,0
https://fbref.com/en/players/1ecb65be/Theo-Walcott,13,6,8,4,1,8,27,19,8,1,7,9,22,7,0
https://fbref.com/en/players/984a5a64/Kyle-Walker-Peters,61,32,34,24,3,22,42,20,47,8,39,27,88,52,0
https://fbref.com/en/players/3515d404/James-Ward-Prowse,65,37,31,27,7,21,61,40,30,10,20,55,120,48,0
https://fbref.com/en/players/46fa7204/Kevin-Agudelo,71,38,22,30,19,25,59,34,39,5,34,10,81,6,0
https://fbref.com/en/players/bcc81786/Kelvin-Amian,54,32,33,12,9,24,31,7,34,12,22,22,76,87,1
https://fbref.com/en/players/10b9fa99/Ethan-Ampadu,66,37,33,28,5,17,41,24,48,23,25,36,102,98,0
https://fbref.com/en/players/1ac232b8/Simone-Bastoni,47,24,23,19,5,15,33,18,20,5,15,8,55,14,0
https://fbref.com/en/players/e892c325/Julius-Beck,2,1,1,1,0,0,0,0,0,0,0,0,2,0,0
https://fbref.com/en/players/0d077b88/Mehdi-Bourabia,41,20,13,22,6,19,41,22,39,12,27,32,73,57,0
https://fbref.com/en/players/ac7e640b/Mattia-Caldara,23,14,10,11,2,9,20,11,23,16,7,17,40,88,2
https://fbref.com/en/players/039a4fb6/Tio-Cipot,12,7,6,3,3,6,8,2,0,0,0,0,12,2,0
https://fbref.com/en/players/085e71a7/Bartlomiej-Dragowski,1,0,1,0,0,1,5,4,0,0,0,1,2,15,3
https://fbref.com/en/players/f503ea63/Albin-Ekdal,37,20,14,20,3,19,45,26,24,2,22,26,63,36,0
https://fbref.com/en/players/c55967eb/Mikael-Ellertsson,4,2,1,3,0,0,3,3,2,1,1,2,6,0,0
https://fbref.com/en/players/5cf5c9ad/Salvatore-Esposito,15,12,8,5,2,5,21,16,9,1,8,11,26,18,0
https://fbref.com/en/players/eb76987d/Salvador-Ferrer,4,2,2,2,0,1,3,2,3,1,2,1,5,4,0
https://fbref.com/en/players/f9758dae/Emmanuel-Gyasi,24,15,11,10,3,9,36,27,24,6,18,8,32,26,0
https://fbref.com/en/players/c2357b65/Emil-Holm,26,15,13,8,5,16,31,15,21,6,15,9,35,41,0
https://fbref.com/en/players/d8800a46/Petko-Hristov,6,4,2,4,0,5,8,3,4,2,2,4,10,12,0
https://fbref.com/en/players/dc3e663e/Jakub-Kiwior,22,17,15,7,0,6,24,18,26,18,8,24,46,71,1
https://fbref.com/en/players/9d60028d/Viktor-Kovalenko,9,5,1,6,2,5,8,3,11,2,9,4,13,7,0
https://fbref.com/en/players/b4101c2e/Raimonds-Krollis,1,1,0,0,1,0,1,1,0,0,0,0,1,0,0
https://fbref.com/en/players/801831fe/Daniel-Maldini,12,5,3,4,5,4,11,7,9,0,9,1,13,8,0
https://fbref.com/en/players/f794b426/Federico-Marchetti,0,0,0,0,0,0,0,0,0,0,0,0,0,0,0
https://fbref.com/en/players/a0aee24e/Joao-Moutinho,7,1,5,1,1,3,4,1,1,1,0,0,7,0,0
https://fbref.com/en/players/cf961d8d/Dimitris-Nikolaou,45,32,31,10,4,25,37,12,41,26,15,27,72,82,0
https://fbref.com/en/players/a4948e67/MBala-Nzola,12,5,0,6,6,3,9,6,20,6,14,7,19,21,0
https://fbref.com/en/players/6213fd82/Arkadiusz-Reca,44,28,22,12,10,19,32,13,21,5,16,24,68,54,0
https://fbref.com/en/players/da5a981b/Jacopo-Sala,1,0,1,0,0,0,2,2,2,0,2,1,2,2,0
https://fbref.com/en/players/4295f19c/Leandro-Sanca,1,1,0,0,1,1,1,0,0,0,0,0,1,0,0
https://fbref.com/en/players/57469b2d/Eldor-Shomurodov,5,5,3,1,1,2,11,9,5,1,4,3,8,4,0
https://fbref.com/en/players/2cb9486d/David-Strelec,2,2,0,1,1,2,2,0,0,0,0,0,2,0,0
https://fbref.com/en/players/d3298c99/Daniele-Verde,4,4,3,0,1,3,7,4,6,0,6,8,12,4,0
https://fbref.com/en/players/1bfe5ac9/Przemyslaw-Wisniewski,13,6,7,6,0,6,18,12,16,8,8,11,24,66,0
https://fbref.com/en/players/cc1a0c57/Jeroen-Zoet,1,1,1,0,0,1,1,0,0,0,0,0,1,1,0
https://fbref.com/en/players/54f6afe3/Petar-Zovko,1,0,1,0,0,1,1,0,0,0,0,0,1,0,0
https://fbref.com/en/players/4e1d5e59/Szymon-Zurkowski,9,3,4,4,1,2,15,13,9,2,7,4,13,6,0
https://fbref.com/en/players/48b28bfd/Jean-Eudes-Aholou,34,20,10,20,4,12,31,19,25,0,25,24,58,15,0
https://fbref.com/en/players/462475ed/Ludovic-Ajorque,5,4,1,4,0,3,9,6,3,1,2,2,7,7,0
https://fbref.com/en/players/10f0fdd3/Jean-Ricner-Bellegarde,47,25,15,21,11,11,25,14,26,3,23,26,73,22,0
https://fbref.com/en/players/4fb18ca4/Franci-Bouebari,3,0,1,2,0,3,5,2,0,0,0,2,5,2,0
https://fbref.com/en/players/29c02c9f/Colin-Dagba,32,20,17,10,5,19,26,7,18,2,16,17,49,19,0
https://fbref.com/en/players/8332db56/Thomas-Delaine,28,14,16,6,6,13,26,13,8,3,5,16,44,9,0
https://fbref.com/en/players/6605d143/Habib-Diallo,18,10,8,7,3,6,16,10,19,4,15,12,30,26,0
https://fbref.com/en/players/6d0fe035/Mouhamadou-Diarra,24,16,10,11,3,15,29,14,17,1,16,11,35,13,0
https://fbref.com/en/players/43e7a164/Alexander-Djiku,53,36,37,16,0,26,46,20,45,19,26,66,119,151,3
https://fbref.com/en/players/0512a60a/Ismael-Doukoure,48,24,23,21,4,20,34,14,26,8,18,27,75,54,0
https://fbref.com/en/players/50ac8941/Karol-Fila,0,0,0,0,0,0,0,0,0,0,0,1,1,1,0
https://fbref.com/en/players/42276181/Kevin-Gameiro,20,10,6,10,4,8,28,20,10,1,9,9,29,0,0
https://fbref.com/en/players/5d8d7454/Frederic-Guilbert,47,29,18,23,6,25,43,18,24,3,21,43,90,33,1
https://fbref.com/en/players/300ec91c/Dany-Jean,0,0,0,0,0,0,1,1,1,0,1,0,0,0,0
https://fbref.com/en/players/c5908bc4/Nordine-Kandil,3,2,1,2,0,0,3,3,2,0,2,1,4,1,0
https://fbref.com/en/players/321a71a7/Maxime-Le-Marchand,39,24,23,14,2,19,31,12,22,14,8,37,76,74,0
https://fbref.com/en/players/f7691f63/Dimitri-Lienard,46,29,20,18,8,34,57,23,28,4,24,16,62,24,0
https://fbref.com/en/players/3eaf8817/Lebo-Mothiba,1,0,1,0,0,0,1,1,6,1,5,0,1,4,0
https://fbref.com/en/players/6043997c/Gerzino-Nyamsi,28,20,14,12,2,10,12,2,19,11,8,10,38,63,1
https://fbref.com/en/players/49070d66/Lucas-Perrin,44,27,28,14,2,25,49,24,13,5,8,36,80,53,0
https://fbref.com/en/players/64ba07c0/Ronael-Pierre-Gabriel,25,18,11,12,2,15,17,2,16,3,13,9,34,22,0
https://fbref.com/en/players/51c30111/Sanjin-Prcic,27,12,6,16,5,19,31,12,22,7,15,25,52,22,0
https://fbref.com/en/players/6e7f1353/Morgan-Sanson,36,25,10,16,10,17,56,39,21,1,20,22,58,9,0
https://fbref.com/en/players/834b5c4c/Matz-Sels,4,3,4,0,0,4,4,0,0,0,0,4,8,23,0
https://fbref.com/en/players/1d383c10/Marvin-Senaya,0,0,0,0,0,0,1,1,1,0,1,0,0,1,0
https://fbref.com/en/players/0f8418aa/Ibrahima-Sissoko,40,22,18,17,5,22,42,20,20,6,14,10,50,19,0
https://fbref.com/en/players/2ccd89a3/Eduard-Sobol,19,10,10,6,3,9,13,4,10,1,9,8,27,19,0
https://fbref.com/en/players/c25a7a2a/Yuito-Suzuki,0,0,0,0,0,0,0,0,3,0,3,0,0,0,0
https://fbref.com/en/players/c76b7567/Adrien-Thomasson,19,9,8,6,5,9,30,21,18,0,18,3,22,2,0
https://fbref.com/en/players/a6c58494/Naouirou-Ahamada,17,11,7,7,3,8,20,12,16,5,11,8,25,7,0
https://fbref.com/en/players/5e66fa06/Waldemar-Anton,49,27,27,19,3,27,51,24,44,16,28,38,87,123,2
https://fbref.com/en/players/e61bdd69/Gil-Bastiao-Dias,8,6,3,4,1,3,12,9,7,0,7,2,10,3,0
https://fbref.com/en/players/d28339cb/Fabian-Bredlow,1,1,1,0,0,1,1,0,0,0,0,0,1,4,2
https://fbref.com/en/players/c6608135/Darko-Churlinov,3,2,2,1,0,2,3,1,1,0,1,0,3,0,0
https://fbref.com/en/players/05ba9d7c/Tanguy-Coulibaly,12,9,9,1,2,5,12,7,10,0,10,3,15,0,0
https://fbref.com/en/players/2f7fec15/Lilian-Egloff,12,10,4,5,3,4,6,2,2,0,2,1,13,1,0
https://fbref.com/en/players/c149016b/Wataru-Endo,70,37,30,31,9,38,85,47,44,6,38,26,96,63,0
https://fbref.com/en/players/0cf778df/Chris-Fuhrich,36,14,15,14,7,24,44,20,29,2,27,7,43,13,0
https://fbref.com/en/players/923f4dda/Sehrou-Guirassy,4,1,2,2,0,1,2,1,7,2,5,0,4,14,0
https://fbref.com/en/players/f24ea523/Genki-Haraguchi,16,7,7,7,2,4,16,12,13,2,11,8,24,6,0
https://fbref.com/en/players/204dded0/Hiroki-Ito,40,29,24,14,2,18,35,17,38,17,21,40,80,94,0
https://fbref.com/en/players/15f24fe7/Sasa-Kalajdzic,3,2,0,1,2,1,3,2,1,0,1,0,3,0,0
https://fbref.com/en/players/5762be5c/Atakan-Karazor,49,30,18,25,6,24,47,23,39,11,28,31,80,44,0
https://fbref.com/en/players/778ccc44/Thomas-Kastanaras,0,0,0,0,0,0,0,0,1,0,1,0,0,0,0
https://fbref.com/en/players/de4cac2d/Silas-Katompa,25,17,5,14,6,6,20,14,17,2,15,8,33,1,0
https://fbref.com/en/players/f1bc3876/Alou-Kuol,0,0,0,0,0,0,0,0,0,0,0,0,0,0,0
https://fbref.com/en/players/00963611/Konstantinos-Mavropanos,50,27,32,15,3,28,38,10,39,18,21,63,113,99,0
https://fbref.com/en/players/f76022e7/Enzo-Millot,23,16,9,10,4,12,19,7,20,3,17,12,35,7,0
https://fbref.com/en/players/29ddfb9c/Clinton-Mola,3,1,2,1,0,1,1,0,1,1,0,1,4,2,0
https://fbref.com/en/players/cbac6ec9/Florian-Muller,0,0,0,0,0,0,0,0,0,0,0,0,0,7,4
https://fbref.com/en/players/30261ba1/Nikolas-Nartey,11,6,7,3,1,5,9,4,9,0,9,4,15,12,0
https://fbref.com/en/players/ff3d391c/Juan-Perea,5,4,0,2,3,2,4,2,2,1,1,1,6,3,0
https://fbref.com/en/players/83e1f40e/Luca-Pfeiffer,1,1,1,0,0,0,1,1,4,0,4,1,2,5,0
https://fbref.com/en/players/af0d79a9/Borna-Sosa,27,21,18,8,1,21,32,11,20,5,15,19,46,37,0
https://fbref.com/en/players/99f7e9aa/Pascal-Stenzel,12,8,8,4,0,5,9,4,9,2,7,5,17,6,0
https://fbref.com/en/players/b492126a/Tiago-Tomas,10,4,2,4,4,8,13,5,9,2,7,1,11,5,0
https://fbref.com/en/players/cd61c7af/Lauren-Ulrich,1,1,0,0,1,0,0,0,0,0,0,0,1,0,0
https://fbref.com/en/players/fb377d11/Josha-Vagnoman,26,15,12,11,3,15,27,12,20,2,18,8,34,29,1
https://fbref.com/en/players/a4effc55/Dan-Axel-Zagadou,14,9,10,4,0,5,14,9,19,16,3,21,35,81,1
https://fbref.com/en/players/246d153b/Ola-Aina,17,13,5,8,4,9,15,6,12,2,10,11,28,26,0
https://fbref.com/en/players/78e6bf2c/Brian-Bayeye,3,0,3,0,0,1,1,0,1,1,0,1,4,2,0
https://fbref.com/en/players/4ae67f27/Alessandro-Buongiorno,38,25,22,16,0,16,31,15,38,19,19,60,98,105,2
https://fbref.com/en/players/933d3b51/Koffi-Djidji,50,25,32,17,1,18,32,14,29,14,15,34,84,72,0
https://fbref.com/en/players/548bd0de/Gvidas-Gineitis,3,1,0,2,1,1,2,1,0,0,0,0,3,1,0
https://fbref.com/en/players/49136c42/Andrew-Gravillon,3,3,0,3,0,0,0,0,4,2,2,9,12,16,0
https://fbref.com/en/players/bb376bed/Ivan-Ilic,18,7,6,11,1,10,20,10,12,3,9,5,23,10,0
https://fbref.com/en/players/a47c6309/Emirhan-Ilkhan,1,1,0,1,0,1,1,0,3,1,2,2,3,2,0
https://fbref.com/en/players/8b66d9cc/Yann-Karamoh,5,2,3,2,0,1,5,4,5,0,5,0,5,2,1
https://fbref.com/en/players/016ff750/Valentino-Lazaro,10,5,6,0,4,6,14,8,16,3,13,3,13,29,0
https://fbref.com/en/players/d023d70f/Karol-Linetty,32,17,7,22,3,13,25,12,28,8,20,19,51,25,0
https://fbref.com/en/players/c6e8cf1f/Sasa-Lukic,21,14,10,10,1,9,15,6,17,7,10,13,34,10,0
https://fbref.com/en/players/9fa26bc2/Vanja-Milinkovic-Savic,2,1,2,0,0,2,2,0,0,0,0,1,3,19,1
https://fbref.com/en/players/a9aa0d1d/Aleksei-Miranchuk,11,5,3,4,4,3,11,8,11,0,11,2,13,5,0
https://fbref.com/en/players/599d91d0/Michel-Ndary-Adopo,7,2,4,2,1,1,3,2,2,2,0,1,8,4,0
https://fbref.com/en/players/a44d3a3c/Pietro-Pellegri,6,2,1,3,2,2,3,1,5,1,4,0,6,4,0
https://fbref.com/en/players/0630eb63/Nemanja-Radonjic,2,1,2,0,0,0,4,4,3,0,3,2,4,4,0
https://fbref.com/en/players/9823be92/Samuele-Ricci,32,21,17,10,5,18,23,5,20,5,15,17,49,29,1
https://fbref.com/en/players/7f78ad23/Ricardo-Rodriguez,54,33,30,17,7,28,42,14,30,15,15,38,92,61,0
https://fbref.com/en/players/0a447501/Antonio-Sanabria,11,5,3,3,5,1,7,6,9,2,7,4,15,7,0
https://fbref.com/en/players/e613313c/Perr-Schuurs,51,25,29,17,5,14,26,12,28,16,12,28,79,102,0
https://fbref.com/en/players/16463a79/Demba-Seck,5,2,3,2,0,2,3,1,3,1,2,1,6,1,0
https://fbref.com/en/players/3cb132e6/Jacopo-Segre,0,0,0,0,0,0,0,0,0,0,0,0,0,0,0
https://fbref.com/en/players/8b609c34/Wilfried-Singo,27,17,14,10,3,12,19,7,15,2,13,12,39,33,1
https://fbref.com/en/players/75e60d75/Ronaldo-Vieira,NA,0,NA,NA,NA,NA,NA,NA,NA,NA,NA,0,NA,NA,NA
https://fbref.com/en/players/aa8e289e/Nikola-Vlasic,32,21,9,16,7,15,34,19,25,2,23,10,42,14,0
https://fbref.com/en/players/be2706c0/Mergim-Vojvoda,22,12,15,6,1,12,24,12,14,2,12,10,32,31,1
https://fbref.com/en/players/acf7e795/David-Zima,9,5,5,4,0,3,4,1,7,2,5,9,18,11,2
https://fbref.com/en/players/56628958/George-Abbott,0,0,0,0,0,0,0,0,0,0,0,1,1,0,0
https://fbref.com/en/players/3b8674e6/Rodrigo-Bentancur,45,28,15,21,9,16,28,12,28,15,13,20,65,22,0
https://fbref.com/en/players/6c203af0/Yves-Bissouma,16,13,6,6,4,2,7,5,15,6,9,12,28,10,0
https://fbref.com/en/players/bc914523/Matthew-Craig,4,1,2,2,0,0,0,0,0,0,0,0,4,0,0
https://fbref.com/en/players/f08490a6/Arnaut-Danjuma,2,0,1,1,0,0,0,0,1,0,1,0,2,0,0
https://fbref.com/en/players/44781702/Ben-Davies,28,11,13,13,2,14,26,12,17,8,9,18,46,72,0
https://fbref.com/en/players/ac861941/Eric-Dier,30,19,16,12,2,9,19,10,41,24,17,35,65,112,2
https://fbref.com/en/players/d557d734/Matt-Doherty,16,10,12,3,1,8,10,2,11,6,5,8,24,14,1
https://fbref.com/en/players/df8b52a5/Emerson,54,33,38,12,4,27,40,13,17,3,14,18,72,75,0
https://fbref.com/en/players/c3e39f12/Fraser-Forster,1,0,1,0,0,0,0,0,1,0,1,0,1,3,1
https://fbref.com/en/players/7b5ab7f2/Bryan-Gil,3,1,3,0,0,0,3,3,3,0,3,1,4,1,0
https://fbref.com/en/players/92e7e919/Son-Heung-min,24,12,7,8,9,9,30,21,23,2,21,13,37,6,0
https://fbref.com/en/players/8b04d6c1/Pierre-Hojbjerg,56,30,28,22,6,26,67,41,46,17,29,49,105,64,1
https://fbref.com/en/players/21a66f6a/Harry-Kane,15,12,1,6,8,7,21,14,27,7,20,2,17,18,0
https://fbref.com/en/players/df3cda47/Dejan-Kulusevski,38,15,23,7,8,16,44,28,19,0,19,13,51,7,0
https://fbref.com/en/players/4f28a6ff/Clement-Lenglet,38,23,18,15,5,16,34,18,26,11,15,18,56,68,2
https://fbref.com/en/players/8f62b6ee/Hugo-Lloris,1,1,1,0,0,1,3,2,0,0,0,1,2,13,4
https://fbref.com/en/players/feb5d972/Pape-Matar-Sarr,7,6,4,2,1,4,8,4,3,2,1,6,13,6,0
https://fbref.com/en/players/2b622f01/Lucas-Moura,8,5,1,3,4,1,4,3,0,0,0,2,10,1,1
https://fbref.com/en/players/6fe90922/Ivan-Perisic,42,24,25,10,7,27,47,20,29,7,22,22,64,49,1
https://fbref.com/en/players/27d0a506/Pedro-Porro,25,16,8,15,2,14,39,25,25,2,23,15,40,24,1
https://fbref.com/en/players/fa031b34/Richarlison,21,16,13,5,3,12,27,15,14,1,13,5,26,10,0
https://fbref.com/en/players/a3d94a58/Cristian-Romero,68,36,42,24,2,29,46,17,40,18,22,44,112,102,3
https://fbref.com/en/players/da7b447d/Davinson-Sanchez,24,11,17,6,1,14,20,6,16,10,6,12,36,41,0
https://fbref.com/en/players/6aa3e78b/Ryan-Sessegnon,16,11,9,7,0,6,12,6,8,1,7,6,22,17,1
https://fbref.com/en/players/6250083a/Oliver-Skipp,34,17,18,15,1,16,33,17,17,8,9,17,51,19,1
https://fbref.com/en/players/9bc9a519/Djed-Spence,0,0,0,0,0,0,0,0,0,0,0,0,0,0,0
https://fbref.com/en/players/e9971f2d/Japhet-Tanganga,3,2,3,0,0,1,5,4,1,0,1,2,5,8,0
https://fbref.com/en/players/4d90ce8c/Harvey-White,0,0,0,0,0,0,1,1,0,0,0,0,0,0,0
https://fbref.com/en/players/c2a6033c/Zakaria-Aboukhlal,33,23,13,9,11,14,45,31,18,1,17,22,55,23,0
https://fbref.com/en/players/5e6355f8/Yanis-Begraoui,2,0,1,0,1,1,2,1,0,0,0,1,3,0,0
https://fbref.com/en/players/636247ca/Veljko-Birmancevic,13,7,5,4,4,7,21,14,12,2,10,7,20,1,0
https://fbref.com/en/players/357103bd/Fares-Chaibi,31,18,8,15,8,17,50,33,38,5,33,19,50,36,1
https://fbref.com/en/players/bfb2056e/Logan-Costa,9,4,7,1,1,6,9,3,6,3,3,4,13,12,0
https://fbref.com/en/players/b70afb45/Thijs-Dallinga,8,6,2,2,4,1,13,12,17,3,14,3,11,20,0
https://fbref.com/en/players/4ca4f601/Brecht-Dejaegere,40,23,10,20,10,15,51,36,25,5,20,14,54,11,0
https://fbref.com/en/players/99d660b2/Branco-van-den-Boomen,71,36,26,32,13,36,89,53,27,4,23,10,81,27,2
https://fbref.com/en/players/1d5c96f8/Mikkel-Desler,71,38,36,27,8,43,67,24,35,6,29,36,107,48,2
https://fbref.com/en/players/698f11e3/Moussa-Diarra,20,9,9,9,2,9,15,6,25,10,15,19,39,27,1
https://fbref.com/en/players/0e12089d/Maxime-Dupe,0,0,0,0,0,0,0,0,0,0,0,0,0,9,3
https://fbref.com/en/players/badcdcae/Denis-Genreau,35,13,16,12,7,13,31,18,16,1,15,8,43,9,0
https://fbref.com/en/players/52cd0e88/Said-Hamulic,0,0,0,0,0,0,0,0,0,0,0,0,0,0,0
https://fbref.com/en/players/07ace8c3/Rhys-Healey,0,0,0,0,0,0,0,0,0,0,0,0,0,0,0
https://fbref.com/en/players/a426a912/Waren-Kamanzi,16,9,9,5,2,13,19,6,8,2,6,8,24,9,0
https://fbref.com/en/players/c43a8336/Kevin-Keben-Biakolo,3,2,2,0,1,0,4,4,1,0,1,5,8,9,0
https://fbref.com/en/players/2c70d915/Christian-Mawissa,2,0,1,1,0,1,3,2,0,0,0,3,5,1,0
https://fbref.com/en/players/e110ea4b/Nathan-NGoumou,3,2,2,1,0,1,1,0,2,0,2,2,5,0,0
https://fbref.com/en/players/3f319bb9/Rasmus-Nicolaisen,48,21,34,14,0,29,46,17,58,45,13,50,98,152,0
https://fbref.com/en/players/ff4df82e/Ado-Onaiwu,11,6,4,4,3,5,13,8,5,1,4,2,13,5,0
https://fbref.com/en/players/40ef7347/Rafael-Ratao,52,36,29,16,7,27,73,46,34,0,34,21,73,7,0
https://fbref.com/en/players/9b545925/Anthony-Rouault,66,37,54,10,2,30,58,28,52,26,26,56,122,126,4
https://fbref.com/en/players/92ffb8f9/Vincent-Sierro,19,11,9,9,1,11,29,18,12,3,9,4,23,11,1
https://fbref.com/en/players/d7547531/Naatan-Skytta,0,0,0,0,0,0,0,0,0,0,0,1,1,0,0
https://fbref.com/en/players/a08985b8/Stijn-Spierings,95,67,37,49,9,43,101,58,49,11,38,53,148,44,0
https://fbref.com/en/players/39b326ed/Gabriel-Suazo,38,22,20,15,3,29,63,34,21,5,16,22,60,24,1
https://fbref.com/en/players/b99bec05/Issiaga-Sylla,28,15,14,9,5,15,34,19,15,5,10,38,66,38,0
https://fbref.com/en/players/906baf89/Theocharis-Tsingaras,0,0,0,0,0,0,0,0,0,0,0,0,0,0,0
https://fbref.com/en/players/72d4922b/Oliver-Zanden,2,1,1,0,1,2,5,3,0,0,0,1,3,7,0
https://fbref.com/en/players/8bc8829a/Lucien-Agoume,42,25,18,15,9,17,33,16,14,5,9,27,69,24,0
https://fbref.com/en/players/22396615/Amar-Ahmed,1,1,0,1,0,0,1,1,0,0,0,1,2,0,0
https://fbref.com/en/players/3975195f/Thierno-Balde,27,14,19,4,4,18,30,12,15,3,12,23,50,39,0
https://fbref.com/en/players/b088d5d3/Andreas-Bruus,12,6,9,3,0,8,20,12,13,2,11,17,29,24,0
https://fbref.com/en/players/279ddf6a/Xavier-Chavalerin,82,50,39,30,13,27,71,44,31,8,23,41,123,24,0
https://fbref.com/en/players/cfa49cc1/Abdu-Conte,25,17,14,8,3,12,22,10,13,6,7,6,31,25,0
https://fbref.com/en/players/92b56413/Tristan-Dingome,1,1,0,1,0,0,2,2,0,0,0,0,1,0,0
https://fbref.com/en/players/836dc4a8/Kyliane-Dong,3,1,0,2,1,1,2,1,1,0,1,1,4,0,0
https://fbref.com/en/players/1b5b32d2/Jordan-Dongmo,1,0,0,1,0,1,1,0,0,0,0,0,1,0,0
https://fbref.com/en/players/db3164e1/Gauthier-Gallon,2,2,2,0,0,2,4,2,0,0,0,2,4,17,0
https://fbref.com/en/players/a94571f6/Mathis-Hamdi,0,0,0,0,0,0,1,1,0,0,0,1,1,1,0
https://fbref.com/en/players/9cd28348/Rudy-Kohon,4,3,4,0,0,2,2,0,1,0,1,1,5,2,0
https://fbref.com/en/players/86a2ba20/Rominigue-Kouame,44,27,28,14,2,17,41,24,32,11,21,49,93,46,1
https://fbref.com/en/players/0ed063d6/Yasser-Larouci,23,13,13,8,2,15,24,9,15,1,14,26,49,46,0
https://fbref.com/en/players/fd78b105/Mateusz-Lis,0,0,0,0,0,0,1,1,1,0,1,0,0,3,0
https://fbref.com/en/players/7c2965bb/Rony-Lopes,24,12,6,15,3,7,31,24,14,2,12,9,33,10,0
https://fbref.com/en/players/810edef9/Derek-Mazou-Sacko,0,0,0,0,0,0,1,1,1,0,1,1,1,1,0
https://fbref.com/en/players/8499c713/Marlos-Moreno,2,2,2,0,0,2,3,1,1,1,0,0,2,0,0
https://fbref.com/en/players/87e9c7cd/Papa-Ndiaga-Yade,10,6,6,2,2,7,22,15,10,2,8,8,18,10,0
https://fbref.com/en/players/35516eac/Wilson-Odobert,20,14,10,7,3,9,25,16,11,0,11,15,35,5,0
https://fbref.com/en/players/cd9b37a3/Ante-Palaversa,1,1,1,0,0,0,0,0,0,0,0,1,2,0,0
https://fbref.com/en/players/e5c1e0ca/Erik-Palmer-Brown,42,27,31,10,1,18,33,15,56,29,27,26,68,166,1
https://fbref.com/en/players/7d704e92/Jackson-Porozo,32,20,24,7,1,13,31,18,24,17,7,33,65,75,0
https://fbref.com/en/players/8dbff17c/Adil-Rami,19,14,13,5,1,17,32,15,23,16,7,25,44,75,3
https://fbref.com/en/players/d504b3e1/Jeff-Reine-Adelaide,3,2,2,1,0,1,2,1,2,0,2,2,5,1,0
https://fbref.com/en/players/beae3a73/Renaud-Ripart,40,23,14,20,6,19,52,33,29,2,27,7,47,5,0
https://fbref.com/en/players/c3725db2/Yoann-Salmier,51,29,34,12,5,21,35,14,34,19,15,39,90,124,0
https://fbref.com/en/players/fb14aa28/Mama-Samba-Balde,46,21,14,21,11,13,28,15,30,3,27,10,56,13,0
https://fbref.com/en/players/ed39121c/Florian-Tardieu,31,20,19,12,0,12,31,19,19,4,15,23,54,15,0
https://fbref.com/en/players/ca6f4846/Alexis-Tibidi,1,1,1,0,0,0,0,0,0,0,0,0,1,0,0
https://fbref.com/en/players/8a53d24b/Ike-Ugbo,5,2,2,2,1,3,11,8,8,2,6,2,7,4,0
https://fbref.com/en/players/aefa3050/Tanguy-Zoukrou,14,7,8,6,0,10,14,4,18,11,7,2,16,24,0
https://fbref.com/en/players/4b7a9fcc/James-Abankwah,1,1,0,1,0,0,0,0,4,2,2,0,1,5,0
https://fbref.com/en/players/963a328b/Tolgay-Arslan,29,18,13,15,1,14,39,25,19,0,19,12,41,9,1
https://fbref.com/en/players/19e4eab9/Rodrigo-Becao,70,36,50,17,3,40,53,13,44,24,20,26,96,68,2
https://fbref.com/en/players/ed5c0319/Beto,16,9,0,9,7,4,17,13,18,3,15,6,22,30,0
https://fbref.com/en/players/6fdac234/Jaka-Bijol,39,23,32,7,0,16,27,11,41,25,16,29,68,165,0
https://fbref.com/en/players/dee3d535/Leonardo-Buta,1,1,0,1,0,0,0,0,0,0,0,0,1,0,0
https://fbref.com/en/players/1faa06d5/Nicolo-Cocetta,0,0,0,0,0,0,1,1,1,1,0,1,1,1,0
https://fbref.com/en/players/39583cfd/Gerard-Deulofeu,8,5,5,1,2,5,15,10,8,1,7,2,10,1,0
https://fbref.com/en/players/dbfa4f16/Festy-Ebosele,15,10,8,7,0,4,10,6,5,0,5,2,17,5,0
https://fbref.com/en/players/9ba7b4fa/Enzo-Ebosse,15,9,11,4,0,9,13,4,27,6,21,11,26,29,0
https://fbref.com/en/players/76b2817e/Kingsley-Ehizibue,47,31,28,13,6,29,45,16,21,3,18,10,57,42,1
https://fbref.com/en/players/e04dca4a/Axel-Guessand,2,1,2,0,0,1,2,1,1,0,1,2,4,3,0
https://fbref.com/en/players/8c65eb5f/Mato-Jajalo,0,0,0,0,0,0,1,1,0,0,0,0,0,2,0
https://fbref.com/en/players/966eea58/Sandi-Lovric,40,18,16,16,8,25,43,18,25,2,23,26,66,21,0
https://fbref.com/en/players/22bfb57e/Jean-Victor-Makengo,16,13,7,7,2,5,9,4,8,2,6,9,25,3,0
https://fbref.com/en/players/de0f152c/Adam-Masina,10,7,7,3,0,6,15,9,11,4,7,10,20,28,1
https://fbref.com/en/players/b1236c63/Ilija-Nestorovski,7,3,2,1,4,5,11,6,6,1,5,2,9,10,0
https://fbref.com/en/players/e33f36d5/Bram-Nuytinck,7,4,3,4,0,4,8,4,6,6,0,5,12,22,0
https://fbref.com/en/players/8daee720/Simone-Pafundi,8,5,1,5,2,2,4,2,0,0,0,1,9,0,0
https://fbref.com/en/players/75f2c59f/Roberto-Pereyra,36,20,21,12,3,16,44,28,20,5,15,16,52,28,0
https://fbref.com/en/players/f7c491f1/Nehuen-Perez,77,40,54,20,3,39,55,16,53,23,30,35,112,106,1
https://fbref.com/en/players/217c93a1/Lazar-Samardzic,33,16,9,20,4,17,43,26,13,0,13,11,44,16,0
https://fbref.com/en/players/b6baba31/Vivaldo-Semedo,0,0,0,0,0,0,0,0,1,0,1,0,0,1,0
https://fbref.com/en/players/0d422df7/Marco-Silvestri,2,1,2,0,0,2,3,1,0,0,0,1,3,15,1
https://fbref.com/en/players/28f66c2e/Brandon-Soppy,1,1,0,1,0,0,0,0,4,0,4,1,2,1,0
https://fbref.com/en/players/f573a8bf/Isaac-Success,8,4,2,5,1,3,8,5,13,2,11,4,12,18,0
https://fbref.com/en/players/2b9fdeea/Florian-Thauvin,2,1,0,2,0,2,13,11,5,0,5,2,4,2,0
https://fbref.com/en/players/7cd520e8/Iyenoma-Udogie,71,45,42,24,5,34,59,25,34,6,28,36,107,25,0
https://fbref.com/en/players/26db8853/Walace,82,39,42,31,9,41,90,49,47,12,35,51,133,51,1
https://fbref.com/en/players/8abd0c03/Marvin-Zeegelaar,8,4,6,2,0,3,4,1,2,0,2,3,11,5,0
https://fbref.com/en/players/bd7d2e6d/Timo-Baumgartl,11,6,5,4,2,5,18,13,12,4,8,2,13,14,0
https://fbref.com/en/players/8eb55dbb/Sheraldo-Becker,15,5,1,7,7,2,11,9,13,1,12,3,18,7,1
https://fbref.com/en/players/30ae134d/Kevin-Behrens,11,7,4,4,3,4,18,14,18,3,15,5,16,25,0
https://fbref.com/en/players/f67c9d29/Danilho-Doekhi,38,23,21,17,0,14,26,12,27,12,15,29,67,93,0
https://fbref.com/en/players/7242b495/Niko-Giesselmann,21,11,9,9,3,13,31,18,17,5,12,9,30,28,0
https://fbref.com/en/players/37998008/Lennart-Grill,0,0,0,0,0,0,1,1,0,0,0,0,0,1,1
https://fbref.com/en/players/70dcf94d/Janik-Haberer,29,17,8,18,3,17,48,31,35,2,33,14,43,25,0
https://fbref.com/en/players/f24ea523/Genki-Haraguchi,12,8,1,10,1,3,9,6,7,1,6,3,15,9,0
https://fbref.com/en/players/a93b6f4e/Paul-Jaeckel,24,18,11,11,2,17,35,18,11,5,6,19,43,44,1
https://fbref.com/en/players/0a084b35/Josip-Juranovic,9,7,5,2,2,7,18,11,9,3,6,6,15,22,1
https://fbref.com/en/players/59e4b92e/Rani-Khedira,60,33,21,32,7,25,50,25,33,10,23,40,100,33,0
https://fbref.com/en/players/6bd5cd5d/Robin-Knoche,45,29,29,12,4,24,47,23,35,18,17,38,83,140,0
https://fbref.com/en/players/22798128/Aissa-Laidouni,14,7,6,8,0,5,17,12,22,4,18,9,23,3,0
https://fbref.com/en/players/c4987edc/Diogo-Leite,35,20,21,14,0,21,34,13,23,14,9,26,61,99,1
https://fbref.com/en/players/13fe7b69/Jamie-Leweling,5,3,2,2,1,3,5,2,3,0,3,1,6,0,0
https://fbref.com/en/players/1e274a0a/Sven-Michel,9,5,1,5,3,4,8,4,5,1,4,0,9,4,0
https://fbref.com/en/players/66385c46/Levin-Oztunali,0,0,0,0,0,0,1,1,0,0,0,0,0,0,0
https://fbref.com/en/players/5dc15574/Milos-Pantovic,4,2,4,0,0,3,5,2,3,0,3,0,4,5,0
https://fbref.com/en/players/b684a484/Jordan-Pefok,15,7,3,4,8,2,17,15,17,5,12,4,19,15,0
https://fbref.com/en/players/c68b1b13/Tymoteusz-Puchacz,1,0,1,0,0,0,0,0,0,0,0,0,1,1,0
https://fbref.com/en/players/13203c45/Jerome-Roussillon,16,9,6,8,2,8,12,4,7,2,5,4,20,22,0
https://fbref.com/en/players/009a4f60/Julian-Ryerson,28,17,17,10,1,15,25,10,15,3,12,12,40,19,0
https://fbref.com/en/players/a70b8345/Frederik-Ronnow,0,0,0,0,0,0,5,5,0,0,0,0,0,9,1
https://fbref.com/en/players/049751d7/Andras-Schafer,21,9,7,12,2,6,14,8,12,2,10,4,25,11,0
https://fbref.com/en/players/8872ed17/Paul-Seguin,17,8,9,4,4,8,18,10,6,0,6,6,23,7,0
https://fbref.com/en/players/65857fdf/Tim-Skarke,1,1,0,0,1,0,0,0,1,0,1,0,1,0,0
https://fbref.com/en/players/d1b49282/Morten-Thorsby,22,10,9,11,2,13,21,8,11,5,6,3,25,20,0
https://fbref.com/en/players/056d2d95/Christopher-Trimmel,31,16,16,12,3,20,31,11,14,1,13,25,56,48,0
https://fbref.com/en/players/e6697917/Domingos-Andre-Ribeiro-Almeida,66,42,23,32,11,26,57,31,26,0,26,20,86,16,1
https://fbref.com/en/players/130a7a3f/Samu-Castillejo,21,12,8,9,4,8,40,32,21,2,19,9,30,2,0
https://fbref.com/en/players/527f063d/Edinson-Cavani,7,4,3,3,1,3,15,12,10,3,7,2,9,11,0
https://fbref.com/en/players/15937e17/Eray-Comert,35,23,24,10,1,17,33,16,23,8,15,29,64,76,1
https://fbref.com/en/players/c78b352d/Thierry-Correia,71,52,46,22,3,31,54,23,25,2,23,24,95,54,2
https://fbref.com/en/players/d2110326/Mouctar-Diakhaby,30,16,19,11,0,13,20,7,30,17,13,20,50,111,2
https://fbref.com/en/players/37e103f8/Hugo-Duro,15,12,2,6,7,7,17,10,11,1,10,2,17,7,1
https://fbref.com/en/players/45e17712/Dimitri-Foulquier,31,19,17,8,6,20,28,8,19,3,16,14,45,40,0
https://fbref.com/en/players/4c2e9442/Maxi-Gomez,0,0,0,0,0,0,0,0,0,0,0,0,0,2,0
https://fbref.com/en/players/2c56a792/Nicolas-Gonzalez,27,15,11,13,3,9,25,16,21,7,14,19,46,16,0
https://fbref.com/en/players/3828f130/Javier-Guerra,16,13,7,4,5,9,20,11,8,1,7,11,27,9,0
https://fbref.com/en/players/f7c12fbf/Hugo-Guillamon,20,12,10,8,2,8,24,16,14,2,12,19,39,30,2
https://fbref.com/en/players/4c3a6744/Justin-Kluivert,17,14,7,4,6,6,12,6,4,0,4,7,24,4,0
https://fbref.com/en/players/8e088e04/Toni-Lato,23,11,9,12,2,9,21,12,10,1,9,6,29,14,0
https://fbref.com/en/players/b05e2dbd/Jose-Luis-Gaya,80,46,61,16,3,43,74,31,28,9,19,23,103,48,0
https://fbref.com/en/players/d4b73232/Giorgi-Mamardashvili,0,0,0,0,0,0,0,0,0,0,0,1,1,11,4
https://fbref.com/en/players/ae86d473/Maranhao,4,1,1,1,2,1,2,1,4,1,3,0,4,0,0
https://fbref.com/en/players/44330c36/Alberto-Mari,0,0,0,0,0,0,2,2,0,0,0,0,0,1,0
https://fbref.com/en/players/f4c69aa6/Ilaix-Moriba,35,16,14,17,4,14,24,10,11,1,10,4,39,12,0
https://fbref.com/en/players/dc1ce4f5/Cristhian-Mosquera,4,2,3,1,0,4,5,1,1,0,1,1,5,5,0
https://fbref.com/en/players/b51b1b9c/Yunus-Musah,48,35,17,23,8,20,30,10,20,1,19,11,59,16,2
https://fbref.com/en/players/c487901c/Diego-Noguerol,2,2,1,1,0,2,15,13,9,0,9,3,5,5,0
https://fbref.com/en/players/9a93efc9/Cenk-Ozkacar,27,20,17,10,0,14,19,5,14,2,12,12,39,47,4
https://fbref.com/en/players/b7ca5c51/Gabriel-Paulista,17,9,13,4,0,13,19,6,22,14,8,32,49,79,2
https://fbref.com/en/players/3d79a68c/Francisco-Perez,1,1,1,0,0,0,3,3,0,0,0,0,1,1,0
https://fbref.com/en/players/2a295d33/Samuel,66,43,17,37,12,26,72,46,34,0,34,18,84,16,0
https://fbref.com/en/players/fed17f5a/Carlos-Soler,2,0,0,1,1,2,3,1,1,0,1,0,2,2,0
https://fbref.com/en/players/106c142c/Jesus-Vazquez,13,8,9,1,3,6,11,5,4,0,4,1,14,8,0
https://fbref.com/en/players/be6faae0/Alvaro-Aceves,0,0,0,0,0,0,0,0,0,0,0,0,0,0,0
https://fbref.com/en/players/014aa7bd/Alvaro-Aguado,27,15,13,11,3,15,25,10,16,4,12,13,40,15,0
https://fbref.com/en/players/733aab44/Babatunde-Akinsola,1,1,0,0,1,0,0,0,0,0,0,0,1,0,0
https://fbref.com/en/players/00eba9c9/Selim-Amallah,15,9,7,8,0,5,8,3,2,0,2,5,20,2,0
https://fbref.com/en/players/c93231dc/Anuar,4,4,0,1,3,0,0,0,5,2,3,3,7,3,0
https://fbref.com/en/players/6091cf45/Roberto-Arroyo,1,1,0,1,0,1,1,0,0,0,0,0,1,0,0
https://fbref.com/en/players/9f0ea33f/Sergio-Asenjo,0,0,0,0,0,0,0,0,0,0,0,0,0,10,2
https://fbref.com/en/players/b0616e3d/Sergio-Escudero,33,19,21,8,4,15,35,20,26,6,20,26,59,46,0
https://fbref.com/en/players/89151b16/Zouhair-Feddal,4,2,1,3,0,3,4,1,9,9,0,5,9,27,0
https://fbref.com/en/players/b86a64b2/Joaquin-Fernandez,35,28,20,11,4,19,30,11,31,22,9,27,62,98,1
https://fbref.com/en/players/29d0f2ac/Ivan-Fresneda,48,34,31,13,4,29,47,18,32,8,24,15,63,60,0
https://fbref.com/en/players/475a738b/Sekou-Gassama,0,0,0,0,0,0,0,0,0,0,0,0,0,0,0
https://fbref.com/en/players/32974271/Sergi-Guardiola,12,7,6,5,1,2,4,2,6,0,6,2,14,7,0
https://fbref.com/en/players/b85bf253/Martin-Hongla,18,13,13,5,0,11,21,10,15,12,3,8,26,46,1
https://fbref.com/en/players/5eebbfdf/Kenedy,6,2,3,3,0,2,4,2,2,0,2,1,7,0,0
https://fbref.com/en/players/e7af9060/Cyle-Larin,9,3,2,4,3,3,7,4,6,3,3,0,9,15,0
https://fbref.com/en/players/0a0cc13c/Sergio-Leon,6,4,0,4,2,3,6,3,6,0,6,0,6,4,0
https://fbref.com/en/players/ed6ea4d9/Darwin-Machis,3,2,0,2,1,1,8,7,5,0,5,3,6,4,0
https://fbref.com/en/players/bbc19252/Mickael-Malsa,2,2,1,1,0,1,4,3,1,1,0,2,4,3,0
https://fbref.com/en/players/8fae77ea/Jordi-Masip,0,0,0,0,0,0,2,2,0,0,0,1,1,3,2
https://fbref.com/en/players/7c4243d4/Roque-Mesa,27,15,16,10,1,12,38,26,16,4,12,13,40,18,0
https://fbref.com/en/players/8ac501f5/Monchu,50,29,20,21,9,19,46,27,28,11,17,18,68,22,1
https://fbref.com/en/players/485e4939/Juanjo-Narvaez,1,1,1,0,0,1,1,0,2,0,2,0,1,0,0
https://fbref.com/en/players/4cee5954/Lucas-Olaza,24,14,12,10,2,17,26,9,20,8,12,14,38,34,0
https://fbref.com/en/players/5132b92c/Lucas-Oliveira-Rosa,39,18,23,10,6,12,20,8,12,2,10,15,54,24,0
https://fbref.com/en/players/237a3851/Kike-Perez,67,33,30,32,5,25,68,43,26,7,19,20,87,28,0
https://fbref.com/en/players/b7c04927/Luis-Perez,44,24,26,12,6,27,38,11,13,4,9,16,60,29,0
https://fbref.com/en/players/7c388b20/Oscar-Plano,40,25,9,17,14,12,37,25,26,2,24,29,69,23,0
https://fbref.com/en/players/54bcdeb0/Gonzalo-Plata,66,35,31,24,11,23,70,47,40,0,40,12,78,10,1
https://fbref.com/en/players/35440884/Manuel-Pozo,0,0,0,0,0,0,0,0,2,0,2,2,2,0,0
https://fbref.com/en/players/70107d4d/Ivan-Sanchez,20,14,8,8,4,10,27,17,14,1,13,8,28,4,0
https://fbref.com/en/players/60359288/Javi-Sanchez,43,26,27,15,1,17,26,9,32,22,10,46,89,116,0
https://fbref.com/en/players/381dbcfc/David-Torres,1,1,0,1,0,1,1,0,4,2,2,3,4,8,0
https://fbref.com/en/players/636eae97/Toni-Villa,6,3,2,3,1,4,9,5,0,0,0,0,6,0,0
https://fbref.com/en/players/379dc075/Shon-Weissman,2,1,1,1,0,0,4,4,8,0,8,1,3,7,0
https://fbref.com/en/players/f6f6b6e8/Jawad-El-Yamiq,17,11,10,7,0,6,11,5,27,19,8,37,54,101,0
https://fbref.com/en/players/4bd414c1/Raul-Albiol,25,17,17,6,2,14,18,4,17,13,4,14,39,111,0
https://fbref.com/en/players/518f2234/Alex-Baena,30,17,9,15,6,15,45,30,15,3,12,7,37,16,0
https://fbref.com/en/players/5acc4a10/Etienne-Capoue,21,12,6,13,2,10,18,8,12,5,7,19,40,20,1
https://fbref.com/en/players/b8a642fc/Samuel-Chukwueze,14,7,7,2,5,7,23,16,13,0,13,12,26,16,0
https://fbref.com/en/players/b3f62bfc/Diego-Collado,0,0,0,0,0,0,0,0,0,0,0,0,0,0,0
https://fbref.com/en/players/a6951bf8/Francis-Coquelin,18,13,7,9,2,7,7,0,8,2,6,9,27,7,0
https://fbref.com/en/players/0abc51f2/Jorge-Cuenca,9,7,7,2,0,4,7,3,10,8,2,6,15,44,0
https://fbref.com/en/players/f08490a6/Arnaut-Danjuma,3,3,1,0,2,1,2,1,0,0,0,0,3,1,1
https://fbref.com/en/players/84a85b48/Alberto-Del-Moral,0,0,0,0,0,0,0,0,0,0,0,0,0,0,0
https://fbref.com/en/players/805a2a11/Mamadou-Fall,0,0,0,0,0,0,0,0,1,0,1,0,0,1,0
https://fbref.com/en/players/e5d01ecf/Kiko-Femenia,18,9,14,3,1,13,18,5,15,6,9,20,38,22,0
https://fbref.com/en/players/6c7762c3/Juan-Foyth,73,48,49,22,2,41,57,16,32,11,21,20,93,68,0
https://fbref.com/en/players/e0979e74/Haissem-Hassan,0,0,0,0,0,0,2,2,0,0,0,1,1,0,0
https://fbref.com/en/players/9c36ed83/Nicolas-Jackson,14,11,2,10,2,2,8,6,18,2,16,2,16,4,0
https://fbref.com/en/players/0107757e/Filip-Jorgensen,0,0,0,0,0,0,1,1,0,0,0,0,0,0,0
https://fbref.com/en/players/d7553721/Giovani-Lo-Celso,32,28,7,15,10,12,21,9,14,2,12,6,38,5,0
https://fbref.com/en/players/4a478107/Jose-Luis-Morales,7,6,1,2,4,5,17,12,12,1,11,2,9,2,0
https://fbref.com/en/players/fbd6378b/Aissa-Mandi,18,10,14,3,1,6,12,6,19,14,5,21,39,58,0
https://fbref.com/en/players/608f2092/Johan-Mojica,13,9,9,3,1,5,9,4,8,3,5,4,17,14,1
https://fbref.com/en/players/11b9265b/Alberto-Moreno,23,12,10,10,3,11,24,13,12,1,11,23,46,26,0
https://fbref.com/en/players/81f0781e/Gerard-Moreno,11,6,0,6,5,3,6,3,6,2,4,5,16,10,0
https://fbref.com/en/players/a0255c67/Manu-Morlanes,3,2,2,1,0,3,3,0,3,2,1,1,4,2,0
https://fbref.com/en/players/81d5c497/Fernando-Nino,0,0,0,0,0,0,0,0,0,0,0,0,0,0,0
https://fbref.com/en/players/7460ca0d/Daniel-Parejo,71,40,32,23,16,30,75,45,40,12,28,29,100,31,2
https://fbref.com/en/players/a2d9cf74/Pascu,0,0,0,0,0,0,0,0,0,0,0,0,0,0,0
https://fbref.com/en/players/63f04c6c/Alfonso-Pedraza,35,26,20,10,5,19,29,10,19,1,18,18,53,31,0
https://fbref.com/en/players/540ec57b/Yeremi-Pino,62,38,25,20,17,21,56,35,41,4,37,15,77,36,0
https://fbref.com/en/players/e358587b/Pepe-Reina,0,0,0,0,0,0,1,1,0,0,0,1,1,4,4
https://fbref.com/en/players/625c144a/Geronimo-Rulli,0,0,0,0,0,0,0,0,1,0,1,1,1,6,2
https://fbref.com/en/players/f36016a5/Ramon-Terrats,15,10,3,8,4,9,17,8,11,4,7,8,23,6,2
https://fbref.com/en/players/532e1e4f/Pau-Torres,43,25,25,13,5,23,36,13,36,27,9,13,56,146,3
https://fbref.com/en/players/963829d0/Manu-Trigueros,20,14,9,5,6,9,22,13,9,2,7,5,25,4,0
https://fbref.com/en/players/cb6d81b3/Felix-Agu,1,0,0,1,0,0,0,0,1,1,0,0,1,0,0
https://fbref.com/en/players/dc62fbee/Leonardo-Bittencourt,53,28,20,25,8,25,62,37,13,0,13,10,63,15,0
https://fbref.com/en/players/45e95f21/Lee-Buchanan,14,10,2,11,1,6,12,6,5,0,5,12,26,21,0
https://fbref.com/en/players/f631c17f/Oliver-Burke,1,0,0,0,1,0,0,0,2,0,2,0,1,0,0
https://fbref.com/en/players/48780156/Fabio-Chiarodia,0,0,0,0,0,0,0,0,1,0,1,2,2,4,0
https://fbref.com/en/players/4ccd8957/Eren-Dinkci,5,5,2,1,2,2,6,4,2,0,2,0,5,2,0
https://fbref.com/en/players/638a4d71/Marvin-Ducksch,8,3,2,4,2,3,16,13,13,2,11,9,17,41,1
https://fbref.com/en/players/f86ad3f5/Marco-Friedl,62,46,40,22,0,41,68,27,46,17,29,58,120,127,1
https://fbref.com/en/players/4f16405e/Niclas-Fullkrug,9,4,0,6,3,3,13,10,13,4,9,1,10,24,0
https://fbref.com/en/players/14a7af33/Christian-Gross,56,25,20,34,2,29,60,31,20,5,15,23,79,38,1
https://fbref.com/en/players/1fc4f3d1/Ilia-Gruev,44,27,16,25,3,18,31,13,23,6,17,22,66,21,1
https://fbref.com/en/players/de838f86/Anthony-Jung,46,27,19,20,7,31,58,27,30,6,24,22,68,63,0
https://fbref.com/en/players/1a5d7cb9/Jean-Manuel-Mbom,0,0,0,0,0,0,1,1,0,0,0,0,0,0,0
https://fbref.com/en/players/0a1cb833/Jiri-Pavlenka,1,0,1,0,0,1,5,4,1,0,1,3,4,21,1
https://fbref.com/en/players/061e8e23/Maximilian-Philipp,6,5,3,2,1,1,9,8,7,1,6,3,9,4,0
https://fbref.com/en/players/526ea7cc/Amos-Pieper,46,28,25,19,2,24,40,16,23,11,12,30,76,94,1
https://fbref.com/en/players/c8b3a472/Nicolai-Rapp,3,1,3,0,0,0,3,3,0,0,0,0,3,1,0
https://fbref.com/en/players/e1830c52/Dikeni-Salifou,0,0,0,0,0,0,0,0,0,0,0,0,0,0,0
https://fbref.com/en/players/220ace7e/Romano-Schmid,24,15,5,13,6,10,22,12,21,3,18,7,31,12,0
https://fbref.com/en/players/b9ae8560/Niklas-Schmidt,25,10,12,11,2,13,28,15,10,0,10,5,30,12,0
https://fbref.com/en/players/1fffae99/Jens-Stage,34,17,15,18,1,10,37,27,34,11,23,16,50,37,0
https://fbref.com/en/players/aad48be9/Niklas-Stark,56,36,29,24,3,27,42,15,24,13,11,37,93,110,0
https://fbref.com/en/players/a5ae8f8e/Milos-Veljkovic,30,19,17,13,0,18,29,11,32,16,16,33,63,103,0
https://fbref.com/en/players/30c220c3/Mitchell-Weiser,71,43,38,24,9,38,75,37,50,7,43,28,99,38,1
https://fbref.com/en/players/9b688ae1/Michael-Zetterer,0,0,0,0,0,0,0,0,0,0,0,0,0,1,0
https://fbref.com/en/players/288e1e13/Nayef-Aguerd,27,18,18,8,1,13,20,7,26,24,2,18,45,79,2
https://fbref.com/en/players/ac05f970/Michail-Antonio,14,7,1,8,5,3,12,9,13,5,8,5,19,9,0
https://fbref.com/en/players/2f965a72/Alphonse-Areola,0,0,0,0,0,0,0,0,0,0,0,0,0,0,0
https://fbref.com/en/players/5a04fd92/Said-Benrahma,25,15,11,7,7,11,27,16,23,1,22,9,34,13,0
https://fbref.com/en/players/79c84d1c/Jarrod-Bowen,39,16,14,11,14,16,57,41,47,9,38,36,75,25,0
https://fbref.com/en/players/beb391dd/Maxwel-Cornet,7,3,5,0,2,4,6,2,6,0,6,2,9,3,0
https://fbref.com/en/players/fdf3cb77/Vladimir-Coufal,58,31,37,15,6,36,51,15,24,6,18,38,96,70,0
https://fbref.com/en/players/a5ca9127/Conor-Coventry,0,0,0,0,0,0,0,0,0,0,0,0,0,0,0
https://fbref.com/en/players/4f974391/Aaron-Cresswell,21,11,12,7,2,12,31,19,21,11,10,27,48,56,0
https://fbref.com/en/players/3e9e06cb/Craig-Dawson,10,6,8,2,0,4,6,2,9,6,3,6,16,26,0
https://fbref.com/en/players/69fdb896/Flynn-Downes,16,9,4,10,2,6,12,6,15,2,13,7,23,6,0
https://fbref.com/en/players/9328b835/Lukasz-Fabianski,2,0,2,0,0,1,2,1,1,0,1,0,2,10,1
https://fbref.com/en/players/82927de4/Pablo-Fornals,30,15,9,12,9,13,34,21,16,2,14,14,44,9,0
https://fbref.com/en/players/07802f7f/Danny-Ings,9,8,0,4,5,5,14,9,8,2,6,3,12,5,0
https://fbref.com/en/players/9319781b/Ben-Johnson,20,14,12,4,4,12,18,6,12,4,8,9,29,28,1
https://fbref.com/en/players/51dbeea9/Thilo-Kehrer,43,24,25,14,4,21,44,23,16,6,10,34,77,76,1
https://fbref.com/en/players/26f6dca8/Manuel-Lanzini,2,2,1,1,0,2,6,4,2,0,2,2,4,0,0
https://fbref.com/en/players/92868cb5/Divin-Mubama,1,1,1,0,0,0,0,0,0,0,0,0,1,0,0
https://fbref.com/en/players/74b2cd7e/Angelo-Ogbonna,11,4,7,4,0,5,10,5,11,7,4,17,28,74,1
https://fbref.com/en/players/e0bc6fdc/Emerson-Palmieri,26,14,9,15,2,12,24,12,17,4,13,15,41,36,0
https://fbref.com/en/players/9b6f7fd5/Lucas-Paqueta,71,53,23,36,12,27,66,39,41,4,37,16,87,31,0
https://fbref.com/en/players/1c7012b8/Declan-Rice,79,38,44,31,4,31,50,19,45,15,30,63,142,58,0
https://fbref.com/en/players/8790f988/Gianluca-Scamacca,10,5,1,3,6,2,2,0,3,0,3,4,14,5,0
https://fbref.com/en/players/6613c819/Tomas-Soucek,77,37,41,29,7,28,58,30,42,17,25,53,130,71,3
https://fbref.com/en/players/ce4246f5/Kurt-Zouma,9,4,4,5,0,5,8,3,17,14,3,30,39,120,1
https://fbref.com/en/players/cd682b6b/Lukas-Ambros,1,0,1,0,0,1,4,3,1,0,1,0,1,2,1
https://fbref.com/en/players/86e119e0/Maximilian-Arnold,62,31,25,28,9,28,54,26,34,11,23,26,88,65,2
https://fbref.com/en/players/442b56fa/Ridle-Baku,50,26,29,17,4,32,58,26,44,6,38,21,71,59,0
https://fbref.com/en/players/01834aa0/Sebastiaan-Bornauw,29,17,17,10,2,16,22,6,27,12,15,31,60,83,1
https://fbref.com/en/players/d4a2533d/Josip-Brekalo,2,1,2,0,0,0,4,4,0,0,0,2,4,2,0
https://fbref.com/en/players/db401046/Koen-Casteels,0,0,0,0,0,0,0,0,0,0,0,1,1,10,1
https://fbref.com/en/players/8f325097/Nicolas-Cozza,3,3,1,2,0,2,3,1,3,1,2,0,3,0,0
https://fbref.com/en/players/79f7302a/Kilian-Fischer,9,6,3,4,2,6,11,5,6,0,6,5,14,18,0
https://fbref.com/en/players/697dc00a/Bartol-Franjic,4,2,2,2,0,0,2,2,4,1,3,5,9,4,0
https://fbref.com/en/players/62ab9184/Yannick-Gerhardt,29,15,10,11,8,12,30,18,26,5,21,7,36,24,0
https://fbref.com/en/players/e6c43eec/Josuha-Guilavogui,18,11,7,10,1,6,17,11,19,13,6,23,41,52,0
https://fbref.com/en/players/202b3b68/Jakub-Kaminski,36,25,15,13,8,20,40,20,37,2,35,8,44,15,0
https://fbref.com/en/players/f9446dcd/Max-Kruse,1,1,0,1,0,0,1,1,2,1,1,0,1,1,0
https://fbref.com/en/players/277c49ed/Maxence-Lacroix,22,13,15,7,0,8,16,8,22,11,11,26,48,85,0
https://fbref.com/en/players/0e0102eb/Omar-Marmoush,16,10,8,2,6,4,16,12,21,1,20,7,23,4,0
https://fbref.com/en/players/091c86e2/Felix-Nmecha,41,24,11,23,7,16,34,18,26,10,16,25,66,31,0
https://fbref.com/en/players/0cc5f4a5/Lukas-Nmecha,5,3,0,2,3,3,3,0,5,1,4,3,8,4,0
https://fbref.com/en/players/1cbe4984/Paulo-Otavio,72,46,46,17,9,44,66,22,42,6,36,30,102,70,1
https://fbref.com/en/players/5c50fdbc/Kevin-Paredes,13,9,6,3,4,9,12,3,7,0,7,6,19,8,0
https://fbref.com/en/players/80f252f6/Dzenan-Pejcinovic,0,0,0,0,0,0,0,0,0,0,0,0,0,0,0
https://fbref.com/en/players/061e8e23/Maximilian-Philipp,2,1,1,1,0,1,1,0,1,0,1,0,2,0,0
https://fbref.com/en/players/13203c45/Jerome-Roussillon,0,0,0,0,0,0,0,0,0,0,0,0,0,0,0
https://fbref.com/en/players/92d83c27/Mattias-Svanberg,25,16,8,16,1,10,30,20,27,5,22,21,46,25,1
https://fbref.com/en/players/8fe2a392/Micky-van-de-Ven,45,30,26,18,1,28,39,11,42,24,18,26,71,108,2
https://fbref.com/en/players/f86cd5df/Aster-Vranckx,0,0,0,0,0,0,0,0,0,0,0,0,0,1,0
https://fbref.com/en/players/e5a35ae9/Luca-Waldschmidt,5,2,2,1,2,2,10,8,6,0,6,3,8,5,0
https://fbref.com/en/players/cb11b429/Patrick-Wimmer,39,26,18,11,10,12,38,26,27,2,25,15,54,15,0
https://fbref.com/en/players/2077ae86/Jonas-Wind,14,6,2,7,5,5,10,5,14,4,10,1,15,10,0
https://fbref.com/en/players/9b398aea/Rayan-Ait-Nouri,33,20,25,7,1,9,15,6,3,0,3,9,42,28,0
https://fbref.com/en/players/68db6358/Daniel-Bentley,1,1,1,0,0,1,1,0,0,0,0,0,1,0,0
https://fbref.com/en/players/bfc3b3a0/Hugo-Bueno,33,16,23,6,4,17,33,16,14,1,13,10,43,36,0
https://fbref.com/en/players/6f711f67/Chem-Campbell,2,1,1,1,0,0,1,1,2,0,2,1,3,0,0
https://fbref.com/en/players/e28868f3/Jonny-Castro,34,15,23,10,1,18,37,19,26,5,21,14,48,28,2
https://fbref.com/en/players/a8c19eb8/Nathan-Collins,27,15,19,8,0,15,24,9,35,28,7,21,48,84,0
https://fbref.com/en/players/a190d597/Diego-Costa,3,1,3,0,0,2,9,7,6,1,5,2,5,17,0
https://fbref.com/en/players/dc62b55d/Matheus-Cunha,7,4,0,5,2,2,10,8,15,3,12,9,16,11,0
https://fbref.com/en/players/3e9e06cb/Craig-Dawson,9,6,6,3,0,4,7,3,31,23,8,12,21,74,2
https://fbref.com/en/players/5a7301ae/Leander-Dendoncker,4,2,0,3,1,2,3,1,2,0,2,9,13,4,0
https://fbref.com/en/players/32f60ed8/Morgan-Gibbs-White,3,1,3,0,0,2,3,1,2,0,2,1,4,3,0
https://fbref.com/en/players/8b57ad2c/Joao-Gomes,29,13,14,14,1,13,23,10,12,3,9,4,33,11,0
https://fbref.com/en/players/f0caab96/Toti-Gomes,15,9,11,4,0,9,13,4,16,8,8,11,26,51,0
https://fbref.com/en/players/e6bc67d7/Goncalo-Guedes,8,6,4,3,1,5,8,3,4,0,4,1,9,2,0
https://fbref.com/en/players/169fd162/Hwang-Hee-chan,20,9,7,8,5,6,19,13,18,2,16,5,25,5,0
https://fbref.com/en/players/bd8a5d95/Joseph-Hodge,5,2,1,3,1,3,4,1,5,0,5,0,5,2,1
https://fbref.com/en/players/b561db50/Raul-Jimenez,9,6,3,5,1,3,6,3,9,0,9,0,9,8,0
https://fbref.com/en/players/15f24fe7/Sasa-Kalajdzic,0,0,0,0,0,0,0,0,0,0,0,1,1,0,0
https://fbref.com/en/players/d0f72bf1/Max-Kilman,36,20,26,9,1,16,30,14,70,42,28,19,55,164,1
https://fbref.com/en/players/0bdda685/Dexter-Lembikisa,0,0,0,0,0,0,0,0,0,0,0,0,0,0,0
https://fbref.com/en/players/2b471f99/Mario-Lemina,38,24,22,13,3,20,38,18,26,8,18,14,52,24,1
https://fbref.com/en/players/f5a00fa4/Joao-Moutinho,51,30,24,21,6,19,46,27,22,6,16,18,69,20,0
https://fbref.com/en/players/7ba2eaa9/Pedro-Neto,11,6,4,2,5,7,17,10,5,1,4,4,15,4,0
https://fbref.com/en/players/44bfb6c5/Ruben-Neves,79,43,31,33,15,32,74,42,59,22,37,50,129,85,1
https://fbref.com/en/players/e6af02e0/Matheus-Nunes,67,43,36,22,9,28,61,33,35,4,31,16,83,35,2
https://fbref.com/en/players/7fcc71d8/Daniel-Podence,27,17,13,9,5,6,31,25,19,0,19,7,34,6,0
https://fbref.com/en/players/1b804500/Connor-Ronan,0,0,0,0,0,0,0,0,0,0,0,0,0,0,0
https://fbref.com/en/players/903b6e8b/Jose-Sa,1,0,1,0,0,1,1,0,0,0,0,0,1,10,6
https://fbref.com/en/players/9744ff80/Pablo-Sarabia,12,6,4,5,3,6,15,9,7,0,7,2,14,4,0
https://fbref.com/en/players/d04b94db/Nelson-Semedo,71,42,48,19,4,33,64,31,42,15,27,29,100,83,2
https://fbref.com/en/players/9a28eba4/Adama-Traore,14,7,7,4,3,4,9,5,8,1,7,3,17,17,0
https://fbref.com/en/players/999ceb5f/Boubacar-Traore,12,5,4,5,3,3,7,4,4,2,2,7,19,1,0
