"Season_End_Year","Squad","Comp","Player","Nation","Pos","Age","Born","Mins_Per_90","Tkl_Tackles","TklW_Tackles","Def 3rd_Tackles","Mid 3rd_Tackles","Att 3rd_Tackles","Tkl_Challenges","Att_Challenges","Tkl_percent_Challenges","Lost_Challenges","Blocks_Blocks","Sh_Blocks","Pass_Blocks","Int","Tkl+Int","Clr","Err","Url"
2023,"Ajaccio","Ligue 1","Mickaël Alphonse","GLP","DF","33",1989,15.1,35,23,20,11,4,20,33,60.6,13,17,5,12,35,70,44,1,"https://fbref.com/en/players/0a63446f/Mickael-Alphonse"
2023,"Ajaccio","Ligue 1","Cédric Avinel","GLP","DF","35",1986,19.9,13,7,8,5,0,8,12,66.7,4,20,13,7,15,28,91,1,"https://fbref.com/en/players/a94d93be/Cedric-Avinel"
2023,"Ajaccio","Ligue 1","Mickaël Barreto","FRA","MF","31",1991,14.7,32,20,12,17,3,8,45,17.8,37,17,0,17,18,50,11,0,"https://fbref.com/en/players/e3844ecb/Mickael-Barreto"
2023,"Ajaccio","Ligue 1","Cyrille Bayala","BFA","MF","26",1996,22.3,53,37,16,20,17,23,47,48.9,24,20,3,17,25,78,21,0,"https://fbref.com/en/players/20e0dd86/Cyrille-Bayala"
2023,"Ajaccio","Ligue 1","Youcef Belaïli","ALG","MF,FW","30",1992,12.8,18,10,3,9,6,8,20,40,12,10,1,9,5,23,4,0,"https://fbref.com/en/players/1a248246/Youcef-Belaili"
2023,"Ajaccio","Ligue 1","Kouamé Botué","BFA","FW,MF","19",2002,2.5,4,2,2,1,1,0,2,0,2,1,0,1,0,4,1,0,"https://fbref.com/en/players/65fcf987/Kouame-Botue"
2023,"Ajaccio","Ligue 1","Florian Chabrolle","FRA","MF","24",1998,3.7,6,4,1,5,0,2,4,50,2,3,0,3,7,13,2,0,"https://fbref.com/en/players/5d9577aa/Florian-Chabrolle"
2023,"Ajaccio","Ligue 1","Ivane Chegra","FRA","MF,FW","18",2004,2.1,8,3,6,1,1,4,11,36.4,7,0,0,0,1,9,0,0,"https://fbref.com/en/players/1237c049/Ivane-Chegra"
2023,"Ajaccio","Ligue 1","Yanis Cimignani","FRA","MF,DF","20",2002,3.1,11,5,3,7,1,4,5,80,1,5,1,4,2,13,2,0,"https://fbref.com/en/players/7495aba7/Yanis-Cimignani"
2023,"Ajaccio","Ligue 1","Mathieu Coutadeur","FRA","MF","36",1986,21.6,23,13,13,10,0,8,28,28.6,20,19,3,16,19,42,21,0,"https://fbref.com/en/players/ef8ae23b/Mathieu-Coutadeur"
2023,"Ajaccio","Ligue 1","Ismael Diallo","CIV","DF","25",1997,24.2,46,33,35,9,2,35,63,55.6,28,26,12,14,30,76,46,1,"https://fbref.com/en/players/b3244eeb/Ismael-Diallo"
2023,"Ajaccio","Ligue 1","Moussa Djitte","SEN","FW","22",1999,1.5,1,0,0,0,1,1,2,50,1,0,0,0,0,1,1,0,"https://fbref.com/en/players/627b570a/Moussa-Djitte"
2023,"Ajaccio","Ligue 1","Oumar Gonzalez","CMR","DF","24",1998,28.6,51,28,34,13,4,23,37,62.2,14,32,11,21,52,103,82,0,"https://fbref.com/en/players/a9d4c241/Oumar-Gonzalez"
2023,"Ajaccio","Ligue 1","Ben Hamed Touré","CIV","FW","18",2003,2.3,4,4,2,2,0,1,5,20,4,2,0,2,1,5,4,0,"https://fbref.com/en/players/c7eebddf/Ben-Hamed-Toure"
2023,"Ajaccio","Ligue 1","Romain Hamouma","FRA","FW,MF","35",1987,12,8,3,3,3,2,3,6,50,3,8,0,8,2,10,2,0,"https://fbref.com/en/players/0b4d8274/Romain-Hamouma"
2023,"Ajaccio","Ligue 1","Mounaim El Idrissy","FRA","FW","23",1999,27.7,32,19,5,20,7,10,36,27.8,26,22,0,22,13,45,20,0,"https://fbref.com/en/players/fb0ee44e/Mounaim-El-Idrissy"
2023,"Ajaccio","Ligue 1","Anthony Khelifa","FRA","DF","16",2005,0.1,0,0,0,0,0,0,0,NA,0,0,0,0,0,0,0,0,"https://fbref.com/en/players/3670aa71/Anthony-Khelifa"
2023,"Ajaccio","Ligue 1","Youssouf Koné","MLI","DF","27",1995,10.2,28,19,24,4,0,18,25,72,7,9,2,7,12,40,32,1,"https://fbref.com/en/players/e6eadfb8/Youssouf-Kone"
2023,"Ajaccio","Ligue 1","Qazim Laçi","ALB","MF","26",1996,2.4,6,3,2,3,1,4,9,44.4,5,5,0,5,2,8,3,0,"https://fbref.com/en/players/eb0db257/Qazim-Laci"
2023,"Ajaccio","Ligue 1","Paolo Lebas","POR","MF","19",2003,0.6,0,0,0,0,0,0,0,NA,0,0,0,0,0,0,0,0,"https://fbref.com/en/players/5bf26efc/Paolo-Lebas"
2023,"Ajaccio","Ligue 1","Benjamin Leroy","FRA","GK","33",1989,31.1,0,0,0,0,0,0,2,0,2,0,0,0,1,1,16,2,"https://fbref.com/en/players/1e7aea56/Benjamin-Leroy"
2023,"Ajaccio","Ligue 1","Ruan Levine","BRA","MF,FW","23",1999,0.3,2,2,1,1,0,0,0,NA,0,1,0,1,2,4,0,0,"https://fbref.com/en/players/17e25e72/Ruan-Levine"
2023,"Ajaccio","Ligue 1","Thomas Mangani","FRA","MF","35",1987,14.8,32,17,14,15,3,18,47,38.3,29,22,3,19,24,56,22,1,"https://fbref.com/en/players/c801616a/Thomas-Mangani"
2023,"Ajaccio","Ligue 1","Vincent Marchetti","FRA","MF","25",1997,27.2,55,26,29,19,7,25,68,36.8,43,23,3,20,19,74,31,0,"https://fbref.com/en/players/740f00ac/Vincent-Marchetti"
2023,"Ajaccio","Ligue 1","Fernand Mayembo","CGO","DF","26",1996,7.9,8,5,6,2,0,4,9,44.4,5,2,0,2,11,19,36,0,"https://fbref.com/en/players/b20cc590/Fernand-Mayembo"
2023,"Ajaccio","Ligue 1","Bevic Moussiti-Oko","CGO","FW","27",1995,7.8,3,1,1,1,1,1,2,50,1,5,3,2,2,5,8,0,"https://fbref.com/en/players/71d10572/Bevic-Moussiti-Oko"
2023,"Ajaccio","Ligue 1","Riad Nouri","FRA","MF,FW","37",1985,18.8,21,12,7,10,4,12,29,41.4,17,8,1,7,15,36,11,0,"https://fbref.com/en/players/374fbf7d/Riad-Nouri"
2023,"Ajaccio","Ligue 1","Mehdi Puch Herrantz","FRA","MF","18",2004,0.5,2,2,0,1,1,1,2,50,1,1,0,1,3,5,0,0,"https://fbref.com/en/players/7be7c08b/Mehdi-Puch-Herrantz"
2023,"Ajaccio","Ligue 1","Ghjuvanni Quilichini","FRA","GK","19",2002,0.9,0,0,0,0,0,0,0,NA,0,0,0,0,0,0,1,0,"https://fbref.com/en/players/1b729a98/Ghjuvanni-Quilichini"
2023,"Ajaccio","Ligue 1","François-Joseph Sollacaro","FRA","GK","28",1994,6,0,0,0,0,0,0,0,NA,0,0,0,0,0,0,2,2,"https://fbref.com/en/players/f19f32b1/Francois-Joseph-Sollacaro"
2023,"Ajaccio","Ligue 1","Moussa Soumano","FRA","FW","17",2005,5.5,2,2,0,1,1,0,6,0,6,2,0,2,0,2,0,0,"https://fbref.com/en/players/86a49468/Moussa-Soumano"
2023,"Ajaccio","Ligue 1","Kevin Spadanuda","SUI","MF,FW","25",1997,11.8,29,18,15,9,5,12,33,36.4,21,18,0,18,11,40,5,0,"https://fbref.com/en/players/a45a5d95/Kevin-Spadanuda"
2023,"Ajaccio","Ligue 1","Tony Strata","FRA","MF,DF","17",2004,1.5,4,3,4,0,0,4,5,80,1,2,0,2,1,5,7,0,"https://fbref.com/en/players/4ca4f263/Tony-Strata"
2023,"Ajaccio","Ligue 1","Yoann Touzghar","TUN","FW","35",1986,5,3,2,0,2,1,0,1,0,1,0,0,0,0,3,1,0,"https://fbref.com/en/players/4e47507a/Yoann-Touzghar"
2023,"Ajaccio","Ligue 1","Clément Vidal","FRA","DF,MF","22",2000,21.1,25,15,14,11,0,18,38,47.4,20,27,16,11,27,52,73,1,"https://fbref.com/en/players/b2791a55/Clement-Vidal"
2023,"Ajaccio","Ligue 1","Mohamed Youssouf","COM","DF","34",1988,27.3,72,44,41,24,7,38,61,62.3,23,32,8,24,65,137,70,0,"https://fbref.com/en/players/1a85bcdb/Mohamed-Youssouf"
2023,"Almería","La Liga","Sergio Akieme","ESP","DF","24",1997,25.5,27,16,19,6,2,12,22,54.5,10,22,6,16,14,41,41,0,"https://fbref.com/en/players/06efa9dc/Sergio-Akieme"
2023,"Almería","La Liga","Srđan Babić","SRB","DF","26",1996,33.3,28,18,20,8,0,15,32,46.9,17,34,22,12,29,57,124,1,"https://fbref.com/en/players/075fe5a3/Srdjan-Babic"
2023,"Almería","La Liga","Léo Baptistão","BRA","FW,MF","29",1992,19.2,32,20,13,16,3,13,33,39.4,20,17,2,15,19,51,12,0,"https://fbref.com/en/players/35f6db55/Leo-Baptistao"
2023,"Almería","La Liga","El Bilal Touré","MLI","FW","20",2001,14,4,3,2,1,1,0,3,0,3,6,1,5,1,5,23,0,"https://fbref.com/en/players/47c609d5/El-Bilal-Toure"
2023,"Almería","La Liga","Juan Brandáriz","ESP","DF","23",1999,16.5,29,16,18,9,2,14,23,60.9,9,20,7,13,15,44,53,0,"https://fbref.com/en/players/2475cf9b/Juan-Brandariz"
2023,"Almería","La Liga","José Carlos Lazo","ESP","MF,FW","26",1996,0.2,0,0,0,0,0,0,0,NA,0,0,0,0,0,0,0,0,"https://fbref.com/en/players/5b93209a/Jose-Carlos-Lazo"
2023,"Almería","La Liga","Álex Centelles","ESP","DF","24",1997,12.5,22,14,16,3,3,16,22,72.7,6,13,2,11,11,33,40,0,"https://fbref.com/en/players/ae852b7d/Alex-Centelles"
2023,"Almería","La Liga","Samu Costa","POR","MF","21",2000,22.1,61,31,35,20,6,29,61,47.5,32,29,7,22,37,98,64,4,"https://fbref.com/en/players/76c2a023/Samu-Costa"
2023,"Almería","La Liga","Curro","ESP","MF","26",1996,0.5,2,0,1,1,0,1,2,50,1,0,0,0,0,2,0,0,"https://fbref.com/en/players/f9a225f5/Curro"
2023,"Almería","La Liga","Íñigo Eguaras","ESP","MF","30",1992,10.7,11,8,4,6,1,5,18,27.8,13,9,3,6,6,17,15,0,"https://fbref.com/en/players/3e93f8cf/Inigo-Eguaras"
2023,"Almería","La Liga","Rodrigo Ely","BRA","DF","28",1993,35.1,30,21,26,4,0,18,25,72,7,46,33,13,31,61,203,1,"https://fbref.com/en/players/fd47b4f2/Rodrigo-Ely"
2023,"Almería","La Liga","Adri Embarba","ESP","FW,MF","30",1992,16.4,50,27,21,26,3,22,46,47.8,24,23,0,23,9,59,9,0,"https://fbref.com/en/players/db8f0eba/Adri-Embarba"
2023,"Almería","La Liga","Fernando","ESP","GK","32",1990,36.5,0,0,0,0,0,0,2,0,2,2,0,2,1,1,20,3,"https://fbref.com/en/players/dabb2827/Fernando"
2023,"Almería","La Liga","Luis Javier Suárez","COL","FW","24",1997,16.6,17,11,5,6,6,6,26,23.1,20,13,3,10,3,20,10,0,"https://fbref.com/en/players/eeba07f8/Luis-Javier-Suarez"
2023,"Almería","La Liga","Kaiky","BRA","DF","18",2004,6.5,5,5,5,0,0,3,7,42.9,4,18,10,8,11,16,28,0,"https://fbref.com/en/players/55634fb8/Kaiky"
2023,"Almería","La Liga","César de la Hoz","ESP","MF","30",1992,18.6,37,20,17,18,2,19,37,51.4,18,26,6,20,13,50,37,0,"https://fbref.com/en/players/60abea75/Cesar-de-la-Hoz"
2023,"Almería","La Liga","Lázaro","BRA","FW,MF","20",2002,8,4,3,3,0,1,3,15,20,12,16,1,15,2,6,1,0,"https://fbref.com/en/players/86ff856b/Lazaro"
2023,"Almería","La Liga","Diego Mariño","ESP","GK","32",1990,0.5,0,0,0,0,0,0,0,NA,0,0,0,0,0,0,0,0,"https://fbref.com/en/players/d9235a45/Diego-Marino"
2023,"Almería","La Liga","Gonzalo Melero","ESP","MF","28",1994,20.6,32,16,9,18,5,11,39,28.2,28,23,2,21,7,39,19,1,"https://fbref.com/en/players/3902e91b/Gonzalo-Melero"
2023,"Almería","La Liga","Houboulang Mendes","FRA","DF","24",1998,9.8,19,11,16,3,0,11,27,40.7,16,12,2,10,7,26,23,1,"https://fbref.com/en/players/1545cf15/Houboulang-Mendes"
2023,"Almería","La Liga","Marko Milovanović","SRB","FW","18",2003,0.2,0,0,0,0,0,0,0,NA,0,0,0,0,0,0,0,0,"https://fbref.com/en/players/1fda2b14/Marko-Milovanovic"
2023,"Almería","La Liga","Fernando Pacheco","ESP","GK","30",1992,1,0,0,0,0,0,0,0,NA,0,0,0,0,0,0,1,0,"https://fbref.com/en/players/97852360/Fernando-Pacheco"
2023,"Almería","La Liga","Francisco Portillo","ESP","MF,FW","32",1990,8,13,6,4,5,4,3,16,18.8,13,7,1,6,7,20,8,0,"https://fbref.com/en/players/8e010ff4/Francisco-Portillo"
2023,"Almería","La Liga","Alejandro Pozo Pozo","ESP","DF","23",1999,20.9,37,19,17,17,3,27,53,50.9,26,30,5,25,26,63,45,1,"https://fbref.com/en/players/3c16d927/Alejandro-Pozo-Pozo"
2023,"Almería","La Liga","Arnau Puigmal","ESP","MF,FW","21",2001,8.5,22,14,10,7,5,12,17,70.6,5,7,0,7,11,33,6,0,"https://fbref.com/en/players/39352da2/Arnau-Puigmal"
2023,"Almería","La Liga","Largie Ramazani","BEL","FW,MF","21",2001,15.6,15,9,6,3,6,8,27,29.6,19,11,0,11,15,30,10,0,"https://fbref.com/en/players/cc9256ef/Largie-Ramazani"
2023,"Almería","La Liga","Lucas Robertone","ARG","MF","25",1997,31.6,50,28,20,21,9,28,64,43.8,36,45,7,38,46,96,46,1,"https://fbref.com/en/players/a8981944/Lucas-Robertone"
2023,"Almería","La Liga","Umar Sadiq","NGA","FW","25",1997,2.7,0,0,0,0,0,0,1,0,1,2,0,2,0,0,3,0,"https://fbref.com/en/players/686cbe7d/Umar-Sadiq"
2023,"Almería","La Liga","Dyego Sousa","POR","FW","32",1989,5.9,10,6,5,4,1,4,5,80,1,4,2,2,1,11,14,0,"https://fbref.com/en/players/e4738e91/Dyego-Sousa"
2023,"Angers","Ligue 1","Himad Abdelli","ALG","MF,FW","22",1999,23.7,64,38,22,32,10,31,67,46.3,36,30,1,29,28,92,15,0,"https://fbref.com/en/players/7978cbf0/Himad-Abdelli"
2023,"Angers","Ligue 1","Ibrahim Amadou","FRA","DF,MF","29",1993,4.7,10,7,6,3,1,7,11,63.6,4,7,3,4,10,20,20,0,"https://fbref.com/en/players/9260926b/Ibrahim-Amadou"
2023,"Angers","Ligue 1","Abdoulaye Bamba","CIV","DF","32",1990,15.2,22,12,15,5,2,16,19,84.2,3,7,3,4,18,40,38,0,"https://fbref.com/en/players/7fecbcdb/Abdoulaye-Bamba"
2023,"Angers","Ligue 1","Nabil Bentaleb","ALG","MF","27",1994,27.7,74,40,31,35,8,36,61,59,25,33,11,22,44,118,29,3,"https://fbref.com/en/players/3189f61a/Nabil-Bentaleb"
2023,"Angers","Ligue 1","Paul Bernardoni","FRA","GK","25",1997,27,2,0,2,0,0,2,3,66.7,1,1,0,1,1,3,12,1,"https://fbref.com/en/players/28dabd43/Paul-Bernardoni"
2023,"Angers","Ligue 1","Miha Blažič","SVN","DF","29",1993,22,8,6,8,0,0,7,15,46.7,8,25,19,6,22,30,80,1,"https://fbref.com/en/players/3cdfc63e/Miha-Blazic"
2023,"Angers","Ligue 1","Antonin Bobichon","FRA","MF","26",1995,0.2,0,0,0,0,0,0,0,NA,0,1,0,1,0,0,0,0,"https://fbref.com/en/players/7d937aa1/Antonin-Bobichon"
2023,"Angers","Ligue 1","Sofiane Boufal","MAR","FW,MF","28",1993,9.3,14,9,7,4,3,3,14,21.4,11,6,0,6,5,19,1,0,"https://fbref.com/en/players/b0c71810/Sofiane-Boufal"
2023,"Angers","Ligue 1","Ousmane Camara","FRA","DF","19",2003,5.8,10,6,5,5,0,5,12,41.7,7,4,2,2,11,21,15,0,"https://fbref.com/en/players/7d3dfdfd/Ousmane-Camara"
2023,"Angers","Ligue 1","Pierrick Capelle","FRA","MF,DF","35",1987,15.9,36,21,17,15,4,22,55,40,33,24,3,21,15,51,24,0,"https://fbref.com/en/players/79b2399c/Pierrick-Capelle"
2023,"Angers","Ligue 1","Ilyes Cheti","ALG","DF","27",1995,2.3,6,4,4,0,2,5,8,62.5,3,5,1,4,4,10,7,0,"https://fbref.com/en/players/9d498560/Ilyes-Cheti"
2023,"Angers","Ligue 1","Lois Diony","FRA","FW","29",1992,5.6,1,0,0,1,0,1,3,33.3,2,2,0,2,0,1,1,0,"https://fbref.com/en/players/4be0b467/Lois-Diony"
2023,"Angers","Ligue 1","Souleyman Doumbia","CIV","DF,FW","25",1996,19.9,45,31,31,13,1,17,31,54.8,14,20,3,17,27,72,27,1,"https://fbref.com/en/players/9daeac61/Souleyman-Doumbia"
2023,"Angers","Ligue 1","Yahia Fofana","FRA","GK","21",2000,11,0,0,0,0,0,0,0,NA,0,0,0,0,1,1,4,1,"https://fbref.com/en/players/9d420dad/Yahia-Fofana"
2023,"Angers","Ligue 1","Faouzi Ghoulam","ALG","DF","31",1991,5.3,3,3,1,1,1,3,5,60,2,4,2,2,4,7,12,1,"https://fbref.com/en/players/c5adc293/Faouzi-Ghoulam"
2023,"Angers","Ligue 1","Cédric Hountondji","BEN","DF","28",1994,34.4,50,36,31,17,2,19,29,65.5,10,44,22,22,59,109,132,1,"https://fbref.com/en/players/00891164/Cedric-Hountondji"
2023,"Angers","Ligue 1","Adrien Hunou","FRA","MF,FW","28",1994,24.8,39,20,17,16,6,16,45,35.6,29,35,0,35,7,46,7,0,"https://fbref.com/en/players/d14229f3/Adrien-Hunou"
2023,"Angers","Ligue 1","Marin Jakoliš","CRO","FW","25",1996,0.3,1,1,0,0,1,0,0,NA,0,0,0,0,0,1,0,0,"https://fbref.com/en/players/96f4ebc0/Marin-Jakolis"
2023,"Angers","Ligue 1","Justin-Noël Kalumba","FRA","DF","17",2004,6.1,9,5,5,2,2,5,16,31.3,11,4,1,3,4,13,5,0,"https://fbref.com/en/players/32e2163d/Justin-Noel-Kalumba"
2023,"Angers","Ligue 1","Jean Mattéo Bahoya","FRA","FW,MF","17",2005,3,7,3,1,3,3,4,7,57.1,3,4,0,4,0,7,0,0,"https://fbref.com/en/players/70d4c949/Jean-Matteo-Bahoya"
2023,"Angers","Ligue 1","Jason Mbock","FRA","MF,FW","22",1999,0.3,0,0,0,0,0,0,0,NA,0,0,0,0,0,0,0,0,"https://fbref.com/en/players/890bc029/Jason-Mbock"
2023,"Angers","Ligue 1","Farid El Melali","ALG","DF,FW","25",1997,9,21,12,7,12,2,11,22,50,11,16,0,16,8,29,7,0,"https://fbref.com/en/players/d21e361a/Farid-El-Melali"
2023,"Angers","Ligue 1","Batista Mendy","FRA","MF,DF","22",2000,31.8,70,30,34,28,8,37,53,69.8,16,38,6,32,21,91,29,2,"https://fbref.com/en/players/e472a6f6/Batista-Mendy"
2023,"Angers","Ligue 1","Ibrahima Niane","SEN","FW","23",1999,12.6,6,2,1,4,1,1,6,16.7,5,8,2,6,1,7,9,0,"https://fbref.com/en/players/46faabfa/Ibrahima-Niane"
2023,"Angers","Ligue 1","Zinédine Ould Khaled","FRA","MF,FW","22",2000,0.6,1,1,0,1,0,0,1,0,1,0,0,0,2,3,0,0,"https://fbref.com/en/players/6b4436ba/Zinedine-Ould-Khaled"
2023,"Angers","Ligue 1","Azzedine Ounahi","MAR","MF,FW","22",2000,12.5,19,8,5,13,1,10,20,50,10,8,0,8,15,34,4,1,"https://fbref.com/en/players/83299cc0/Azzedine-Ounahi"
2023,"Angers","Ligue 1","Lilian Raolisoa","FRA","DF,MF","22",2000,1.9,11,9,6,3,2,7,10,70,3,3,1,2,3,14,5,0,"https://fbref.com/en/players/79a793b7/Lilian-Raolisoa"
2023,"Angers","Ligue 1","Halid Šabanović","BIH","DF","22",1999,7.1,8,6,7,1,0,6,8,75,2,8,2,6,8,16,12,0,"https://fbref.com/en/players/8299e363/Halid-Sabanovic"
2023,"Angers","Ligue 1","Amine Salama","FRA","FW,MF","22",2000,13.9,11,9,3,7,1,2,12,16.7,10,8,2,6,10,21,2,0,"https://fbref.com/en/players/bc7cc472/Amine-Salama"
2023,"Angers","Ligue 1","Abdallah Sima","SEN","FW","21",2001,20.4,22,13,4,15,3,7,19,36.8,12,8,0,8,4,26,19,0,"https://fbref.com/en/players/fdbde523/Abdallah-Sima"
2023,"Angers","Ligue 1","Waniss Taibi","FRA","MF","20",2002,2.1,9,5,4,4,1,2,4,50,2,1,0,1,2,11,2,0,"https://fbref.com/en/players/95192fe4/Waniss-Taibi"
2023,"Angers","Ligue 1","Sada Thioub","SEN","DF,FW","27",1995,11.8,19,10,9,8,2,8,17,47.1,9,13,0,13,7,26,5,1,"https://fbref.com/en/players/f4bc42b1/Sada-Thioub"
2023,"Angers","Ligue 1","Yan Valery","TUN","DF","23",1999,27.7,54,39,28,20,6,20,37,54.1,17,35,15,20,34,88,82,0,"https://fbref.com/en/players/531a4aa8/Yan-Valery"
2023,"Arsenal","Premier League","Gabriel Dos Santos","BRA","DF","24",1997,37.9,48,30,29,15,4,18,27,66.7,9,49,26,23,32,80,125,2,"https://fbref.com/en/players/67ac5bb8/Gabriel-Dos-Santos"
2023,"Arsenal","Premier League","Mohamed Elneny","EGY","MF","30",1992,1.3,1,1,1,0,0,1,1,100,0,0,0,0,0,1,0,0,"https://fbref.com/en/players/47a34c4f/Mohamed-Elneny"
2023,"Arsenal","Premier League","Rob Holding","ENG","DF","26",1995,6.3,8,5,4,4,0,3,6,50,3,6,5,1,3,11,27,1,"https://fbref.com/en/players/d79a8c87/Rob-Holding"
2023,"Arsenal","Premier League","Gabriel Jesus","BRA","FW","25",1997,22.9,33,25,16,8,9,15,31,48.4,16,27,3,24,11,44,15,1,"https://fbref.com/en/players/b66315ae/Gabriel-Jesus"
2023,"Arsenal","Premier League","Jorginho","ITA","MF","30",1991,9.5,18,13,6,10,2,5,24,20.8,19,7,2,5,9,27,8,0,"https://fbref.com/en/players/45db685d/Jorginho"
2023,"Arsenal","Premier League","Jakub Kiwior","POL","DF","22",2000,4.7,7,5,6,1,0,5,8,62.5,3,5,3,2,6,13,10,0,"https://fbref.com/en/players/dc3e663e/Jakub-Kiwior"
2023,"Arsenal","Premier League","Marquinhos","BRA","MF","19",2003,0,0,0,0,0,0,0,0,NA,0,0,0,0,0,0,0,0,"https://fbref.com/en/players/59878425/Marquinhos"
2023,"Arsenal","Premier League","Martinelli","BRA","FW","21",2001,31,31,18,13,12,6,9,22,40.9,13,24,1,23,9,40,14,0,"https://fbref.com/en/players/48a5a5d6/Martinelli"
2023,"Arsenal","Premier League","Reiss Nelson","ENG","FW","22",1999,2.4,4,1,2,1,1,2,4,50,2,3,0,3,0,4,4,0,"https://fbref.com/en/players/c5bdb6e3/Reiss-Nelson"
2023,"Arsenal","Premier League","Eddie Nketiah","ENG","FW","23",1999,12.1,13,9,6,2,5,2,8,25,6,7,1,6,1,14,7,0,"https://fbref.com/en/players/a53649b7/Eddie-Nketiah"
2023,"Arsenal","Premier League","Ethan Nwaneri","ENG","FW","15",2007,0,0,0,0,0,0,0,0,NA,0,1,0,1,0,0,0,0,"https://fbref.com/en/players/7f94982c/Ethan-Nwaneri"
2023,"Arsenal","Premier League","Thomas Partey","GHA","MF","29",1993,27.6,70,40,20,35,15,25,52,48.1,27,26,5,21,28,98,41,1,"https://fbref.com/en/players/529f49ab/Thomas-Partey"
2023,"Arsenal","Premier League","Aaron Ramsdale","ENG","GK","24",1998,38,1,1,1,0,0,1,1,100,0,0,0,0,0,1,20,6,"https://fbref.com/en/players/466fb2c5/Aaron-Ramsdale"
2023,"Arsenal","Premier League","Bukayo Saka","ENG","FW","20",2001,35.3,63,34,22,15,26,20,44,45.5,24,38,0,38,14,77,19,0,"https://fbref.com/en/players/bc7dc64d/Bukayo-Saka"
2023,"Arsenal","Premier League","William Saliba","FRA","DF","21",2001,26.8,34,20,23,9,2,15,18,83.3,3,13,10,3,19,53,85,4,"https://fbref.com/en/players/972aeb2a/William-Saliba"
2023,"Arsenal","Premier League","Albert Sambi Lokonga","BEL","MF","22",1999,2.2,1,1,0,0,1,0,2,0,2,1,0,1,5,6,2,0,"https://fbref.com/en/players/1b4f1169/Albert-Sambi-Lokonga"
2023,"Arsenal","Premier League","Emile Smith Rowe","ENG","MF,FW","22",2000,1.9,1,1,1,0,0,1,3,33.3,2,1,0,1,0,1,2,0,"https://fbref.com/en/players/17695062/Emile-Smith-Rowe"
2023,"Arsenal","Premier League","Cédric Soares","POR","DF","30",1991,0.3,0,0,0,0,0,0,1,0,1,1,0,1,0,0,1,0,"https://fbref.com/en/players/839c14e1/Cedric-Soares"
2023,"Arsenal","Premier League","Kieran Tierney","SCO","DF","25",1997,8.8,20,11,9,9,2,12,16,75,4,8,2,6,11,31,25,0,"https://fbref.com/en/players/fce2302c/Kieran-Tierney"
2023,"Arsenal","Premier League","Takehiro Tomiyasu","JPN","DF","23",1998,7.4,27,18,12,10,5,13,18,72.2,5,7,0,7,14,41,15,1,"https://fbref.com/en/players/b3af9be1/Takehiro-Tomiyasu"
2023,"Arsenal","Premier League","Leandro Trossard","BEL","FW","27",1994,10.3,12,7,4,2,6,6,18,33.3,12,18,0,18,6,18,3,1,"https://fbref.com/en/players/38ceb24a/Leandro-Trossard"
2023,"Arsenal","Premier League","Fabio Vieira","POR","MF,FW","22",2000,5.7,6,4,3,0,3,3,5,60,2,5,0,5,4,10,2,0,"https://fbref.com/en/players/6412cc03/Fabio-Vieira"
2023,"Arsenal","Premier League","Ben White","ENG","DF","24",1997,33.9,60,31,23,30,7,42,70,60,28,47,11,36,22,82,79,1,"https://fbref.com/en/players/35e413f1/Ben-White"
2023,"Arsenal","Premier League","Granit Xhaka","SUI","MF","29",1992,33.3,34,27,11,18,5,16,41,39,25,28,10,18,15,49,45,1,"https://fbref.com/en/players/e61b8aee/Granit-Xhaka"
2023,"Arsenal","Premier League","Oleksandr Zinchenko","UKR","DF","25",1996,23.5,40,18,14,17,9,21,39,53.8,18,20,2,18,22,62,38,2,"https://fbref.com/en/players/51cf8561/Oleksandr-Zinchenko"
2023,"Arsenal","Premier League","Martin Ødegaard","NOR","MF","23",1998,34.7,36,23,12,14,10,14,47,29.8,33,20,5,15,6,42,12,1,"https://fbref.com/en/players/79300479/Martin-Odegaard"
2023,"Aston Villa","Premier League","Cameron Archer","ENG","FW,MF","21",2001,0.5,0,0,0,0,0,0,0,NA,0,0,0,0,0,0,0,0,"https://fbref.com/en/players/05e8ca6d/Cameron-Archer"
2023,"Aston Villa","Premier League","Ludwig Augustinsson","SWE","DF","28",1994,0.9,1,1,1,0,0,0,0,NA,0,0,0,0,0,1,1,0,"https://fbref.com/en/players/9fec8860/Ludwig-Augustinsson"
2023,"Aston Villa","Premier League","Leon Bailey","JAM","FW,MF","24",1997,21.9,14,6,6,7,1,5,20,25,15,13,0,13,6,20,12,0,"https://fbref.com/en/players/3a233281/Leon-Bailey"
2023,"Aston Villa","Premier League","Jan Bednarek","POL","DF","26",1996,1.1,3,3,0,3,0,1,1,100,0,3,1,2,2,5,5,0,"https://fbref.com/en/players/4115ce4e/Jan-Bednarek"
2023,"Aston Villa","Premier League","Emi Buendía","ARG","MF,FW","25",1996,26.8,52,23,20,20,12,21,74,28.4,53,20,2,18,20,72,17,0,"https://fbref.com/en/players/66b76d44/Emi-Buendia"
2023,"Aston Villa","Premier League","Diego Carlos","BRA","DF","29",1993,2.3,1,0,0,1,0,0,1,0,1,2,2,0,1,2,2,0,"https://fbref.com/en/players/b4a014b1/Diego-Carlos"
2023,"Aston Villa","Premier League","Matty Cash","POL","DF","24",1997,20.2,55,32,36,15,4,26,37,70.3,11,20,5,15,26,81,43,0,"https://fbref.com/en/players/2389cdc2/Matty-Cash"
2023,"Aston Villa","Premier League","Calum Chambers","ENG","DF,MF","27",1995,3.9,9,6,7,2,0,6,8,75,2,5,4,1,7,16,10,1,"https://fbref.com/en/players/dc6f5bdd/Calum-Chambers"
2023,"Aston Villa","Premier League","Philippe Coutinho","BRA","MF,FW","30",1992,8.8,19,14,8,8,3,9,15,60,6,11,1,10,4,23,2,0,"https://fbref.com/en/players/0ef89a37/Philippe-Coutinho"
2023,"Aston Villa","Premier League","Leander Dendoncker","BEL","MF","27",1995,7.7,19,9,11,6,2,11,21,52.4,10,19,4,15,10,29,12,0,"https://fbref.com/en/players/5a7301ae/Leander-Dendoncker"
2023,"Aston Villa","Premier League","Lucas Digne","FRA","DF","29",1993,16.7,30,12,20,9,1,20,33,60.6,13,18,5,13,18,48,45,0,"https://fbref.com/en/players/1b84dbe1/Lucas-Digne"
2023,"Aston Villa","Premier League","Jhon Durán","COL","FW,MF","18",2003,1.5,2,2,0,1,1,1,4,25,3,0,0,0,2,4,2,0,"https://fbref.com/en/players/414184f7/Jhon-Duran"
2023,"Aston Villa","Premier League","Danny Ings","ENG","FW","30",1992,9.2,10,5,1,6,3,1,6,16.7,5,12,1,11,1,11,11,0,"https://fbref.com/en/players/07802f7f/Danny-Ings"
2023,"Aston Villa","Premier League","Boubacar Kamara","FRA","MF","22",1999,19.7,58,25,25,23,10,27,56,48.2,29,38,12,26,19,77,24,2,"https://fbref.com/en/players/cc77354e/Boubacar-Kamara"
2023,"Aston Villa","Premier League","Ezri Konsa","ENG","DF","24",1997,36.9,42,20,25,15,2,18,26,69.2,8,41,23,18,26,68,120,3,"https://fbref.com/en/players/0313a347/Ezri-Konsa"
2023,"Aston Villa","Premier League","Douglas Luiz","BRA","MF","24",1998,32.5,73,42,31,32,10,30,63,47.6,33,36,7,29,40,113,27,2,"https://fbref.com/en/players/6f7d826d/Douglas-Luiz"
2023,"Aston Villa","Premier League","Emiliano Martínez","ARG","GK","29",1992,34.9,0,0,0,0,0,0,2,0,2,0,0,0,1,1,23,1,"https://fbref.com/en/players/7956236f/Emiliano-Martinez"
2023,"Aston Villa","Premier League","John McGinn","SCO","MF,FW","27",1994,29.9,66,36,27,29,10,34,71,47.9,37,43,4,39,24,90,19,0,"https://fbref.com/en/players/90f91999/John-McGinn"
2023,"Aston Villa","Premier League","Tyrone Mings","ENG","DF","29",1993,35,15,7,10,5,0,9,20,45,11,40,21,19,54,69,163,2,"https://fbref.com/en/players/8397a50c/Tyrone-Mings"
2023,"Aston Villa","Premier League","Álex Moreno","ESP","DF","29",1993,14.8,23,14,15,5,3,13,36,36.1,23,18,3,15,7,30,37,2,"https://fbref.com/en/players/16e9d0ea/Alex-Moreno"
2023,"Aston Villa","Premier League","Robin Olsen","SWE","GK","32",1990,3.1,0,0,0,0,0,0,2,0,2,0,0,0,0,0,1,0,"https://fbref.com/en/players/e7ee38c3/Robin-Olsen"
2023,"Aston Villa","Premier League","Jacob Ramsey","ENG","MF,FW","21",2001,29.3,69,39,23,35,11,32,69,46.4,37,48,8,40,23,92,34,0,"https://fbref.com/en/players/1544f145/Jacob-Ramsey"
2023,"Aston Villa","Premier League","Morgan Sanson","FRA","MF","27",1994,0.1,2,1,1,1,0,1,1,100,0,0,0,0,0,2,0,0,"https://fbref.com/en/players/6e7f1353/Morgan-Sanson"
2023,"Aston Villa","Premier League","Bertrand Traoré","BFA","FW,MF","26",1995,2.6,1,1,1,0,0,1,4,25,3,5,0,5,2,3,0,0,"https://fbref.com/en/players/c47541e0/Bertrand-Traore"
2023,"Aston Villa","Premier League","Ollie Watkins","ENG","FW","26",1995,34.7,19,13,3,13,3,10,27,37,17,21,4,17,10,29,39,0,"https://fbref.com/en/players/aed3a70f/Ollie-Watkins"
2023,"Aston Villa","Premier League","Ashley Young","ENG","DF","37",1985,22.6,50,27,34,15,1,37,49,75.5,12,25,11,14,21,71,65,0,"https://fbref.com/en/players/be927d03/Ashley-Young"
2023,"Atalanta","Serie A","Jeremie Boga","CIV","MF,FW","25",1997,8.7,9,5,3,2,4,2,5,40,3,6,0,6,1,10,1,0,"https://fbref.com/en/players/fe012aca/Jeremie-Boga"
2023,"Atalanta","Serie A","Tommaso De Nipoti","ITA","MF","19",2003,0,1,0,0,1,0,0,0,NA,0,0,0,0,0,1,0,0,"https://fbref.com/en/players/7f9d956a/Tommaso-De-Nipoti"
2023,"Atalanta","Serie A","Merih Demiral","TUR","DF","24",1998,17.1,41,29,30,11,0,26,36,72.2,10,24,7,17,24,65,57,1,"https://fbref.com/en/players/e3cceee6/Merih-Demiral"
2023,"Atalanta","Serie A","Berat Djimsiti","ALB","DF","29",1993,20,34,19,21,13,0,17,25,68,8,17,7,10,36,70,74,1,"https://fbref.com/en/players/6eee05f1/Berat-Djimsiti"
2023,"Atalanta","Serie A","Éderson","BRA","MF","23",1999,24.6,67,34,18,42,7,29,66,43.9,37,56,7,49,36,103,31,0,"https://fbref.com/en/players/a9202def/Ederson"
2023,"Atalanta","Serie A","Hans Hateboer","NED","DF","28",1994,15.5,21,13,11,8,2,11,27,40.7,16,23,4,19,12,33,25,0,"https://fbref.com/en/players/3b333ac3/Hans-Hateboer"
2023,"Atalanta","Serie A","Rasmus Højlund","DEN","FW","19",2003,20.4,4,3,0,2,2,1,6,16.7,5,9,1,8,1,5,5,0,"https://fbref.com/en/players/491a433d/Rasmus-Hojlund"
2023,"Atalanta","Serie A","Teun Koopmeiners","NED","MF","24",1998,31.8,46,26,15,24,7,28,55,50.9,27,41,5,36,19,65,36,2,"https://fbref.com/en/players/a26fb8aa/Teun-Koopmeiners"
2023,"Atalanta","Serie A","Ademola Lookman","NGA","FW,MF","24",1997,19.2,13,5,2,6,5,3,15,20,12,18,0,18,4,17,1,0,"https://fbref.com/en/players/7c104bb7/Ademola-Lookman"
2023,"Atalanta","Serie A","José Luis Palomino","ARG","DF","32",1990,8.4,23,14,16,7,0,11,19,57.9,8,11,4,7,28,51,20,0,"https://fbref.com/en/players/921f6058/Jose-Luis-Palomino"
2023,"Atalanta","Serie A","Ruslan Malinovskyi","UKR","MF,FW","29",1993,6.1,14,8,5,6,3,6,17,35.3,11,8,1,7,5,19,2,0,"https://fbref.com/en/players/48d5bd33/Ruslan-Malinovskyi"
2023,"Atalanta","Serie A","Luis Muriel","COL","FW,MF","31",1991,11.9,9,6,2,3,4,5,16,31.3,11,9,0,9,2,11,2,0,"https://fbref.com/en/players/eb2fe5b6/Luis-Muriel"
2023,"Atalanta","Serie A","Juan Musso","ARG","GK","28",1994,23.1,1,1,1,0,0,1,1,100,0,0,0,0,0,1,11,1,"https://fbref.com/en/players/a111cf41/Juan-Musso"
2023,"Atalanta","Serie A","Joakim Mæhle","DEN","DF,MF","25",1997,24.5,32,18,12,7,13,22,39,56.4,17,29,6,23,24,56,26,0,"https://fbref.com/en/players/c459a650/Joakim-Maehle"
2023,"Atalanta","Serie A","Caleb Okoli","ITA","DF","21",2001,10.7,21,17,14,6,1,10,25,40,15,10,5,5,30,51,44,3,"https://fbref.com/en/players/8ec109e6/Caleb-Okoli"
2023,"Atalanta","Serie A","Mario Pašalić","CRO","MF,FW","27",1995,19.7,22,10,6,14,2,6,23,26.1,17,22,4,18,21,43,13,0,"https://fbref.com/en/players/e599253a/Mario-Pasalic"
2023,"Atalanta","Serie A","Marten de Roon","NED","MF","31",1991,32.9,77,39,37,35,5,37,81,45.7,44,37,4,33,36,113,58,0,"https://fbref.com/en/players/2a1beb34/Marten-de-Roon"
2023,"Atalanta","Serie A","Francesco Rossi","ITA","GK","31",1991,0,0,0,0,0,0,0,0,NA,0,0,0,0,0,0,0,0,"https://fbref.com/en/players/7b5f516f/Francesco-Rossi"
2023,"Atalanta","Serie A","Matteo Ruggeri","ITA","DF,MF","20",2002,9.2,17,12,5,9,3,8,16,50,8,14,3,11,12,29,16,0,"https://fbref.com/en/players/ae9898c5/Matteo-Ruggeri"
2023,"Atalanta","Serie A","Giorgio Scalvini","ITA","DF","18",2003,25.9,54,29,30,18,6,29,55,52.7,26,36,13,23,56,110,57,2,"https://fbref.com/en/players/1e9aa637/Giorgio-Scalvini"
2023,"Atalanta","Serie A","Brandon Soppy","FRA","DF","20",2002,7.1,8,5,4,4,0,3,9,33.3,6,10,0,10,3,11,7,0,"https://fbref.com/en/players/28f66c2e/Brandon-Soppy"
2023,"Atalanta","Serie A","Marco Sportiello","ITA","GK","30",1992,14.9,1,0,1,0,0,1,3,33.3,2,0,0,0,0,1,2,0,"https://fbref.com/en/players/ac4003af/Marco-Sportiello"
2023,"Atalanta","Serie A","Rafael Tolói","ITA","DF","31",1990,30.9,69,44,37,32,0,35,64,54.7,29,42,18,24,57,126,88,1,"https://fbref.com/en/players/c56dc39e/Rafael-Toloi"
2023,"Atalanta","Serie A","Lukáš Vorlický","CZE","MF,FW","20",2002,0.3,0,0,0,0,0,0,0,NA,0,0,0,0,1,1,0,0,"https://fbref.com/en/players/f052fb01/Lukas-Vorlicky"
2023,"Atalanta","Serie A","Duván Zapata","COL","FW","31",1991,15.4,8,4,1,3,4,3,5,60,2,6,2,4,4,12,17,1,"https://fbref.com/en/players/d3de9af0/Duvan-Zapata"
2023,"Atalanta","Serie A","Davide Zappacosta","ITA","DF","30",1992,16.3,34,18,17,12,5,15,22,68.2,7,23,2,21,9,43,16,0,"https://fbref.com/en/players/7fe90ccd/Davide-Zappacosta"
2023,"Atalanta","Serie A","Nadir Zortea","ITA","DF,MF","23",1999,2.5,10,5,3,7,0,3,4,75,1,4,0,4,0,10,4,0,"https://fbref.com/en/players/82598b71/Nadir-Zortea"
2023,"Athletic Club","La Liga","Julen Agirrezabala","ESP","GK","21",2000,7.5,0,0,0,0,0,0,0,NA,0,0,0,0,0,0,2,0,"https://fbref.com/en/players/a2c1a8d3/Julen-Agirrezabala"
2023,"Athletic Club","La Liga","Yeray Álvarez","ESP","DF","27",1995,25.9,34,23,26,7,1,24,31,77.4,7,23,13,10,48,82,101,0,"https://fbref.com/en/players/3ecc11d8/Yeray-Alvarez"
2023,"Athletic Club","La Liga","Mikel Balenziaga","ESP","DF","34",1988,1.3,4,4,1,2,1,4,4,100,0,0,0,0,1,5,2,0,"https://fbref.com/en/players/1fe67e86/Mikel-Balenziaga"
2023,"Athletic Club","La Liga","Yuri Berchiche","ESP","DF","32",1990,26.7,56,32,28,20,8,35,59,59.3,24,37,12,25,40,96,59,1,"https://fbref.com/en/players/b6e50615/Yuri-Berchiche"
2023,"Athletic Club","La Liga","Álex Berenguer","ESP","FW","27",1995,25.5,58,37,17,25,16,23,60,38.3,37,37,4,33,10,68,6,0,"https://fbref.com/en/players/dc1c2fce/Alex-Berenguer"
2023,"Athletic Club","La Liga","Ander Capa","ESP","DF","30",1992,1.2,1,1,1,0,0,1,5,20,4,5,0,5,0,1,2,0,"https://fbref.com/en/players/37f1cf47/Ander-Capa"
2023,"Athletic Club","La Liga","Malcom Abdulai Ares Djalo","ESP","FW,MF","20",2001,0.9,4,2,2,1,1,4,4,100,0,1,0,1,2,6,1,0,"https://fbref.com/en/players/a461f098/Malcom-Abdulai-Ares-Djalo"
2023,"Athletic Club","La Liga","Dani García","ESP","MF","32",1990,16.5,46,27,17,25,4,29,47,61.7,18,21,6,15,19,65,21,1,"https://fbref.com/en/players/240d3a0b/Dani-Garcia"
2023,"Athletic Club","La Liga","Raúl García","ESP","FW,MF","36",1986,10.7,12,8,3,4,5,5,15,33.3,10,13,1,12,6,18,9,0,"https://fbref.com/en/players/b418dbd4/Raul-Garcia"
2023,"Athletic Club","La Liga","Gorka Guruzeta","ESP","FW","25",1996,15.8,24,20,6,12,6,11,24,45.8,13,23,2,21,4,28,8,0,"https://fbref.com/en/players/6b5ea2f4/Gorka-Guruzeta"
2023,"Athletic Club","La Liga","Ander Herrera","ESP","MF","32",1989,7.7,18,10,8,7,3,6,18,33.3,12,12,3,9,11,29,12,0,"https://fbref.com/en/players/436a9dd0/Ander-Herrera"
2023,"Athletic Club","La Liga","Iñigo Lekue","ESP","DF","29",1993,14.7,24,17,20,4,0,12,19,63.2,7,16,2,14,13,37,31,1,"https://fbref.com/en/players/59b7d823/Inigo-Lekue"
2023,"Athletic Club","La Liga","Óscar de Marcos","ESP","DF","33",1989,31.3,67,33,34,22,11,40,76,52.6,36,42,6,36,29,96,59,0,"https://fbref.com/en/players/9f323c71/Oscar-de-Marcos"
2023,"Athletic Club","La Liga","Iñigo Martínez","ESP","DF","31",1991,14.9,18,8,11,7,0,6,9,66.7,3,17,11,6,18,36,55,0,"https://fbref.com/en/players/3fc45c73/Inigo-Martinez"
2023,"Athletic Club","La Liga","Jon Morcillo","ESP","FW,MF","23",1998,0.8,1,0,1,0,0,0,1,0,1,0,0,0,1,2,0,0,"https://fbref.com/en/players/b7d7f3bf/Jon-Morcillo"
2023,"Athletic Club","La Liga","Iker Muniain","ESP","MF,FW","29",1992,18.8,21,16,7,11,3,6,17,35.3,11,10,1,9,4,25,2,0,"https://fbref.com/en/players/c05dfb74/Iker-Muniain"
2023,"Athletic Club","La Liga","Aitor Paredes","ESP","DF","22",2000,9.5,7,6,4,2,1,6,11,54.5,5,11,7,4,14,21,26,0,"https://fbref.com/en/players/b906757a/Aitor-Paredes"
2023,"Athletic Club","La Liga","Oihan Sancet","ESP","MF","22",2000,28.1,27,16,2,19,6,11,37,29.7,26,10,0,10,4,31,9,1,"https://fbref.com/en/players/bdb624a3/Oihan-Sancet"
2023,"Athletic Club","La Liga","Unai Simón","ESP","GK","25",1997,30.5,2,0,2,0,0,1,1,100,0,1,0,1,0,2,9,3,"https://fbref.com/en/players/5dcf3e90/Unai-Simon"
2023,"Athletic Club","La Liga","Unai Vencedor Paris","ESP","MF","21",2000,2.1,3,1,0,3,0,1,6,16.7,5,5,0,5,1,4,1,0,"https://fbref.com/en/players/4112ace5/Unai-Vencedor-Paris"
2023,"Athletic Club","La Liga","Mikel Vesga","ESP","MF","29",1993,28.6,57,35,21,31,5,25,68,36.8,43,39,8,31,36,93,39,3,"https://fbref.com/en/players/b0fce72c/Mikel-Vesga"
2023,"Athletic Club","La Liga","Asier Villalibre","ESP","FW","24",1997,1.1,0,0,0,0,0,0,0,NA,0,0,0,0,0,0,1,0,"https://fbref.com/en/players/57be54ec/Asier-Villalibre"
2023,"Athletic Club","La Liga","Daniel Vivian","ESP","DF","23",1999,26.4,57,32,36,16,5,36,45,80,9,27,14,13,24,81,90,3,"https://fbref.com/en/players/ab7bf91d/Daniel-Vivian"
2023,"Athletic Club","La Liga","Iñaki Williams","GHA","FW","28",1994,31.5,22,16,5,14,3,9,24,37.5,15,18,3,15,7,29,34,0,"https://fbref.com/en/players/6a99e0b1/Inaki-Williams"
2023,"Athletic Club","La Liga","Nico Williams","ESP","FW","20",2002,29.5,31,16,10,15,6,19,41,46.3,22,40,2,38,8,39,14,1,"https://fbref.com/en/players/afdc14d7/Nico-Williams"
2023,"Athletic Club","La Liga","Oier Zarraga","ESP","MF","23",1999,9.5,14,9,5,7,2,8,20,40,12,7,0,7,10,24,5,0,"https://fbref.com/en/players/968a1c2f/Oier-Zarraga"
2023,"Atlético Madrid","La Liga","Pablo Barrios","ESP","MF","19",2003,8,19,10,3,10,6,8,15,53.3,7,12,2,10,9,28,6,1,"https://fbref.com/en/players/45736cec/Pablo-Barrios"
2023,"Atlético Madrid","La Liga","Yannick Carrasco","BEL","DF,MF","28",1993,25.7,35,14,21,10,4,23,54,42.6,31,23,1,22,12,47,19,0,"https://fbref.com/en/players/de39485a/Yannick-Carrasco"
2023,"Atlético Madrid","La Liga","Ángel Correa","ARG","FW,MF","27",1995,16.2,12,6,6,3,3,5,16,31.3,11,17,0,17,10,22,6,1,"https://fbref.com/en/players/01eb744d/Angel-Correa"
2023,"Atlético Madrid","La Liga","Matheus Cunha","BRA","FW,MF","23",1999,4.2,4,1,1,3,0,0,3,0,3,4,1,3,2,6,3,0,"https://fbref.com/en/players/dc62b55d/Matheus-Cunha"
2023,"Atlético Madrid","La Liga","Rodrigo De Paul","ARG","MF","28",1994,21.4,35,21,11,18,6,18,35,51.4,17,20,3,17,8,43,7,0,"https://fbref.com/en/players/162efffd/Rodrigo-De-Paul"
2023,"Atlético Madrid","La Liga","Matt Doherty","IRL","DF","30",1992,0.2,0,0,0,0,0,0,0,NA,0,2,0,2,0,0,0,0,"https://fbref.com/en/players/d557d734/Matt-Doherty"
2023,"Atlético Madrid","La Liga","Felipe","BRA","DF","33",1989,2.2,3,2,1,2,0,2,4,50,2,2,2,0,0,3,7,0,"https://fbref.com/en/players/51a3c4c8/Felipe"
2023,"Atlético Madrid","La Liga","João Félix","POR","FW,MF","22",1999,7.2,10,7,2,3,5,1,6,16.7,5,1,0,1,3,13,2,0,"https://fbref.com/en/players/8aafd64f/Joao-Felix"
2023,"Atlético Madrid","La Liga","Antonio Gomis","ESP","GK","19",2003,0.1,0,0,0,0,0,0,0,NA,0,0,0,0,0,0,0,0,"https://fbref.com/en/players/f0f4671c/Antonio-Gomis"
2023,"Atlético Madrid","La Liga","Ivo Grbić","CRO","GK","26",1996,10.2,0,0,0,0,0,0,0,NA,0,0,0,0,0,0,9,1,"https://fbref.com/en/players/3f034750/Ivo-Grbic"
2023,"Atlético Madrid","La Liga","Antoine Griezmann","FRA","FW,MF","31",1991,31.8,49,34,15,23,11,20,66,30.3,46,34,3,31,24,73,31,0,"https://fbref.com/en/players/df69b544/Antoine-Griezmann"
2023,"Atlético Madrid","La Liga","Mario Hermoso","ESP","DF","27",1995,23.4,22,15,14,6,2,9,30,30,21,19,9,10,19,41,85,1,"https://fbref.com/en/players/555f3a0b/Mario-Hermoso"
2023,"Atlético Madrid","La Liga","Koke","ESP","MF","30",1992,28.3,55,38,23,25,7,28,72,38.9,44,35,13,22,20,75,19,0,"https://fbref.com/en/players/55126f3b/Koke"
2023,"Atlético Madrid","La Liga","Geoffrey Kondogbia","CTA","MF","29",1993,11.2,40,23,19,20,1,17,25,68,8,9,1,8,26,66,12,1,"https://fbref.com/en/players/cce181df/Geoffrey-Kondogbia"
2023,"Atlético Madrid","La Liga","Thomas Lemar","FRA","MF","26",1995,13.9,30,18,10,13,7,10,28,35.7,18,12,3,9,7,37,12,0,"https://fbref.com/en/players/4dbd0916/Thomas-Lemar"
2023,"Atlético Madrid","La Liga","Marcos Llorente","ESP","MF,DF","27",1995,18.9,32,15,16,10,6,17,30,56.7,13,26,2,24,17,49,19,0,"https://fbref.com/en/players/02c15616/Marcos-Llorente"
2023,"Atlético Madrid","La Liga","Reinildo Mandava","MOZ","DF","28",1994,20.6,66,43,46,19,1,38,49,77.6,11,27,12,15,30,96,59,0,"https://fbref.com/en/players/c20bdcd7/Reinildo-Mandava"
2023,"Atlético Madrid","La Liga","José María Giménez","URU","DF","27",1995,26.9,43,25,28,14,1,24,35,68.6,11,37,17,20,24,67,138,1,"https://fbref.com/en/players/f0da930c/Jose-Maria-Gimenez"
2023,"Atlético Madrid","La Liga","Carlos Martín","ESP","FW,MF","20",2002,0.3,2,2,0,2,0,2,3,66.7,1,0,0,0,1,3,0,0,"https://fbref.com/en/players/64035864/Carlos-Martin"
2023,"Atlético Madrid","La Liga","Memphis","NED","FW","28",1994,3,1,0,0,0,1,0,1,0,1,0,0,0,0,1,0,0,"https://fbref.com/en/players/8f696594/Memphis"
2023,"Atlético Madrid","La Liga","Nahuel Molina","ARG","DF","24",1998,31.9,69,43,38,18,13,39,91,42.9,52,38,7,31,18,87,63,1,"https://fbref.com/en/players/23610943/Nahuel-Molina"
2023,"Atlético Madrid","La Liga","Álvaro Morata","ESP","FW","29",1992,21.1,16,11,4,8,4,3,8,37.5,5,11,3,8,0,16,23,0,"https://fbref.com/en/players/129af0db/Alvaro-Morata"
2023,"Atlético Madrid","La Liga","Saúl Ñíguez","ESP","MF,DF","27",1994,12.2,42,27,18,18,6,22,37,59.5,15,27,5,22,15,57,29,0,"https://fbref.com/en/players/c14bc029/Saul-Niguez"
2023,"Atlético Madrid","La Liga","Jan Oblak","SVN","GK","29",1993,27.7,0,0,0,0,0,0,0,NA,0,0,0,0,1,1,8,0,"https://fbref.com/en/players/ee8508c0/Jan-Oblak"
2023,"Atlético Madrid","La Liga","Sergio Reguilón","ESP","DF","25",1996,3.4,7,5,5,2,0,5,7,71.4,2,3,0,3,2,9,4,0,"https://fbref.com/en/players/3353737a/Sergio-Reguilon"
2023,"Atlético Madrid","La Liga","Stefan Savić","MNE","DF","31",1991,21.6,39,26,29,7,3,26,39,66.7,13,17,8,9,33,72,67,2,"https://fbref.com/en/players/f6ac68c1/Stefan-Savic"
2023,"Atlético Madrid","La Liga","Axel Witsel","BEL","DF,MF","33",1989,25.1,36,22,22,11,3,17,31,54.8,14,20,11,9,23,59,76,0,"https://fbref.com/en/players/5dfc6ad5/Axel-Witsel"
2023,"Augsburg","Bundesliga","Maximilian Bauer","GER","DF","22",2000,20.5,31,17,18,12,1,17,34,50,17,25,9,16,23,54,79,1,"https://fbref.com/en/players/44a20f0c/Maximilian-Bauer"
2023,"Augsburg","Bundesliga","Julian Baumgartlinger","AUT","MF","34",1988,6.2,15,4,5,6,4,6,19,31.6,13,4,2,2,4,19,15,0,"https://fbref.com/en/players/69374ff5/Julian-Baumgartlinger"
2023,"Augsburg","Bundesliga","Noah Joel Sarenren Bazee","NGA","MF,FW","25",1996,0.2,0,0,0,0,0,0,1,0,1,1,0,1,0,0,0,0,"https://fbref.com/en/players/fbbc8e15/Noah-Joel-Sarenren-Bazee"
2023,"Augsburg","Bundesliga","Mergim Berisha","GER","FW","24",1998,18.7,11,6,4,3,4,4,14,28.6,10,16,1,15,0,11,19,0,"https://fbref.com/en/players/eb6e14be/Mergim-Berisha"
2023,"Augsburg","Bundesliga","Daniel Caligiuri","ITA","DF,MF","34",1988,3.2,8,5,5,3,0,4,5,80,1,3,2,1,3,11,2,0,"https://fbref.com/en/players/d1273f09/Daniel-Caligiuri"
2023,"Augsburg","Bundesliga","Irvin Cardona","FRA","MF,FW","24",1997,3.5,1,1,1,0,0,1,5,20,4,3,0,3,4,5,8,0,"https://fbref.com/en/players/5e080f73/Irvin-Cardona"
2023,"Augsburg","Bundesliga","David Čolina","CRO","DF,FW","22",2000,1.8,4,1,1,1,2,2,2,100,0,8,0,8,4,8,3,0,"https://fbref.com/en/players/dd5bbe0d/David-Colina"
2023,"Augsburg","Bundesliga","Ermedin Demirović","BIH","FW,MF","24",1998,26.3,31,14,9,12,10,9,22,40.9,13,31,4,27,14,45,37,0,"https://fbref.com/en/players/ed79b7d3/Ermedin-Demirovic"
2023,"Augsburg","Bundesliga","Niklas Dorsch","GER","MF","24",1998,5.4,21,12,8,11,2,9,16,56.3,7,9,3,6,6,27,9,0,"https://fbref.com/en/players/7f73bdf4/Niklas-Dorsch"
2023,"Augsburg","Bundesliga","Dion Drena Beljo","CRO","FW","20",2002,12.5,7,6,3,2,2,2,13,15.4,11,15,2,13,1,8,14,0,"https://fbref.com/en/players/9a2e3a23/Dion-Drena-Beljo"
2023,"Augsburg","Bundesliga","Arne Engels","BEL","MF","18",2003,16,20,9,9,10,1,8,19,42.1,11,17,5,12,15,35,12,1,"https://fbref.com/en/players/554bcc91/Arne-Engels"
2023,"Augsburg","Bundesliga","Ohis Felix Uduokhai","GER","DF","24",1997,16.1,30,20,14,13,3,15,29,51.7,14,27,14,13,29,59,61,1,"https://fbref.com/en/players/677da306/Ohis-Felix-Uduokhai"
2023,"Augsburg","Bundesliga","Raphael Framberger","GER","DF,FW","26",1995,2,10,6,6,4,0,3,5,60,2,2,1,1,2,12,5,0,"https://fbref.com/en/players/626fab5f/Raphael-Framberger"
2023,"Augsburg","Bundesliga","Rafał Gikiewicz","POL","GK","34",1987,23,2,2,2,0,0,2,3,66.7,1,0,0,0,0,2,15,5,"https://fbref.com/en/players/17376543/Rafal-Gikiewicz"
2023,"Augsburg","Bundesliga","Jeffrey Gouweleeuw","NED","DF","31",1991,31.1,42,27,19,17,6,24,49,49,25,41,23,18,50,92,141,2,"https://fbref.com/en/players/1025db8e/Jeffrey-Gouweleeuw"
2023,"Augsburg","Bundesliga","Carlos Gruezo","ECU","MF","27",1995,10.7,21,12,12,9,0,9,16,56.3,7,13,4,9,10,31,15,0,"https://fbref.com/en/players/f2dd9a21/Carlos-Gruezo"
2023,"Augsburg","Bundesliga","Robert Gumny","POL","DF","24",1998,22.4,34,24,13,15,6,11,27,40.7,16,21,7,14,26,60,62,1,"https://fbref.com/en/players/1df0c0b9/Robert-Gumny"
2023,"Augsburg","Bundesliga","André Hahn","GER","FW,MF","31",1990,4.3,9,5,4,4,1,8,12,66.7,4,9,2,7,4,13,14,0,"https://fbref.com/en/players/cd82452e/Andre-Hahn"
2023,"Augsburg","Bundesliga","Iago","BRA","DF,MF","25",1997,17.8,34,16,20,10,4,11,29,37.9,18,18,5,13,17,51,53,0,"https://fbref.com/en/players/054849d2/Iago"
2023,"Augsburg","Bundesliga","Fredrik Jensen","FIN","FW,MF","24",1997,10.3,15,10,8,3,4,5,10,50,5,12,5,7,4,19,12,0,"https://fbref.com/en/players/3eeb80e0/Fredrik-Jensen"
2023,"Augsburg","Bundesliga","Tomáš Koubek","CZE","GK","29",1992,11,0,0,0,0,0,0,0,NA,0,0,0,0,0,0,7,0,"https://fbref.com/en/players/dc366c36/Tomas-Koubek"
2023,"Augsburg","Bundesliga","Arne Maier","GER","MF","23",1999,21.8,31,22,17,11,3,10,18,55.6,8,21,0,21,15,46,22,0,"https://fbref.com/en/players/ab700320/Arne-Maier"
2023,"Augsburg","Bundesliga","Nathanael Mbuku","FRA","MF,FW","20",2002,0.4,1,0,0,1,0,0,0,NA,0,0,0,0,0,1,0,0,"https://fbref.com/en/players/46750e9c/Nathanael-Mbuku"
2023,"Augsburg","Bundesliga","Florian Niederlechner","GER","FW,MF","31",1990,10.1,10,5,5,4,1,4,7,57.1,3,16,2,14,1,11,9,0,"https://fbref.com/en/players/d6862409/Florian-Niederlechner"
2023,"Augsburg","Bundesliga","Reece Oxford","ENG","DF","23",1998,1,1,1,1,0,0,0,0,NA,0,4,3,1,1,2,5,0,"https://fbref.com/en/players/8b6e0db2/Reece-Oxford"
2023,"Augsburg","Bundesliga","Mads Pedersen","DEN","DF,MF","25",1996,20.4,44,23,31,11,2,22,33,66.7,11,32,9,23,20,64,41,1,"https://fbref.com/en/players/582a5247/Mads-Pedersen"
2023,"Augsburg","Bundesliga","Ricardo Pepi","USA","FW","19",2003,1.1,1,1,1,0,0,1,1,100,0,1,0,1,0,1,1,0,"https://fbref.com/en/players/a2b1ed42/Ricardo-Pepi"
2023,"Augsburg","Bundesliga","Lukas Petkov","GER","MF,FW","21",2000,1.6,5,1,4,1,0,2,3,66.7,1,4,1,3,1,6,0,0,"https://fbref.com/en/players/f503ef6e/Lukas-Petkov"
2023,"Augsburg","Bundesliga","Elvis Rexhbeçaj","GER","MF","24",1997,28,51,30,18,24,9,29,59,49.2,30,40,13,27,17,68,40,0,"https://fbref.com/en/players/1ae836b1/Elvis-Rexhbecaj"
2023,"Augsburg","Bundesliga","Ruben Vargas","SUI","MF,FW","23",1998,12.6,15,7,6,7,2,5,11,45.5,6,8,2,6,6,21,16,1,"https://fbref.com/en/players/6ecbddf6/Ruben-Vargas"
2023,"Augsburg","Bundesliga","Renato Veiga","POR","DF","19",2003,7.1,9,6,4,3,2,7,9,77.8,2,20,6,14,7,16,29,1,"https://fbref.com/en/players/fc8fcbd1/Renato-Veiga"
2023,"Augsburg","Bundesliga","Frederik Winther","DEN","DF","21",2001,1,2,2,1,1,0,0,2,0,2,1,1,0,0,2,7,0,"https://fbref.com/en/players/a1257b5e/Frederik-Winther"
2023,"Augsburg","Bundesliga","Kelvin Yeboah","ITA","FW,MF","22",2000,3.9,6,4,2,4,0,2,5,40,3,7,0,7,1,7,2,0,"https://fbref.com/en/players/ea0893d6/Kelvin-Yeboah"
2023,"Augsburg","Bundesliga","Aaron Zehnter","GER","DF","17",2004,0,0,0,0,0,0,0,1,0,1,0,0,0,1,1,0,0,"https://fbref.com/en/players/65bf7e2b/Aaron-Zehnter"
2023,"Auxerre","Ligue 1","Matthis Abline","FRA","FW,MF","19",2003,9,4,2,0,3,1,0,5,0,5,6,1,5,1,5,1,0,"https://fbref.com/en/players/0e46fa2f/Matthis-Abline"
2023,"Auxerre","Ligue 1","Mathias Autret","FRA","MF,FW","31",1991,14.3,22,10,10,10,2,7,16,43.8,9,14,2,12,12,34,13,0,"https://fbref.com/en/players/7dfbba27/Mathias-Autret"
2023,"Auxerre","Ligue 1","Dénys Bain","FRA","DF","29",1993,1.4,4,3,3,1,0,1,2,50,1,2,1,1,2,6,4,0,"https://fbref.com/en/players/5065d67d/Denys-Bain"
2023,"Auxerre","Ligue 1","Quentin Bernard","FRA","DF","33",1989,7,9,7,4,2,3,7,15,46.7,8,9,1,8,15,24,17,0,"https://fbref.com/en/players/3916b09c/Quentin-Bernard"
2023,"Auxerre","Ligue 1","Kenji-Van Boto","MAD","DF","26",1996,2,3,2,2,0,1,2,4,50,2,0,0,0,1,4,3,0,"https://fbref.com/en/players/c03b7266/Kenji-Van-Boto"
2023,"Auxerre","Ligue 1","Ousmane Camara","GUI","FW,MF","20",2001,0.3,1,1,0,0,1,0,0,NA,0,0,0,0,0,1,0,0,"https://fbref.com/en/players/5a6b06cd/Ousmane-Camara"
2023,"Auxerre","Ligue 1","Gaëtan Charbonnier","FRA","FW,MF","33",1988,2.8,2,1,0,2,0,0,4,0,4,2,0,2,0,2,5,0,"https://fbref.com/en/players/18ebca4b/Gaetan-Charbonnier"
2023,"Auxerre","Ligue 1","Alexandre Coeff","FRA","DF","30",1992,6.5,10,5,6,4,0,4,9,44.4,5,9,4,5,8,18,35,1,"https://fbref.com/en/players/c4065f40/Alexandre-Coeff"
2023,"Auxerre","Ligue 1","Nuno da Costa","CPV","FW,MF","31",1991,22.3,45,23,14,23,8,11,46,23.9,35,21,1,20,20,65,15,0,"https://fbref.com/en/players/909222de/Nuno-da-Costa"
2023,"Auxerre","Ligue 1","Benoît Costil","FRA","GK","35",1987,19,2,0,2,0,0,2,4,50,2,0,0,0,0,2,5,0,"https://fbref.com/en/players/2434f24a/Benoit-Costil"
2023,"Auxerre","Ligue 1","Kévin Danois","FRA","MF","18",2004,0,1,1,0,1,0,0,0,NA,0,0,0,0,1,2,0,0,"https://fbref.com/en/players/e76f6fbe/Kevin-Danois"
2023,"Auxerre","Ligue 1","Siriki Dembélé","CIV","MF,FW","25",1996,4.1,10,6,4,3,3,4,12,33.3,8,2,0,2,1,11,2,0,"https://fbref.com/en/players/11f54bd5/Siriki-Dembele"
2023,"Auxerre","Ligue 1","Rémy Dugimont","FRA","FW,MF","36",1986,1.3,2,1,0,1,1,1,2,50,1,3,0,3,0,2,5,0,"https://fbref.com/en/players/6d7ede84/Remy-Dugimont"
2023,"Auxerre","Ligue 1","Gauthier Hein","FRA","MF,FW","25",1996,20.8,27,20,13,11,3,18,48,37.5,30,10,0,10,6,33,10,0,"https://fbref.com/en/players/563fcd6b/Gauthier-Hein"
2023,"Auxerre","Ligue 1","Julian Jeanvier","GUI","DF","30",1992,19.6,32,17,24,8,0,13,22,59.1,9,24,17,7,27,59,96,1,"https://fbref.com/en/players/5cb215fc/Julian-Jeanvier"
2023,"Auxerre","Ligue 1","Paul Joly","FRA","DF","22",2000,9.6,33,21,21,10,2,19,35,54.3,16,13,2,11,24,57,29,2,"https://fbref.com/en/players/5b4bc323/Paul-Joly"
2023,"Auxerre","Ligue 1","Jubal","BRA","DF","28",1993,35.7,41,26,29,11,1,19,38,50,19,57,34,23,53,94,193,0,"https://fbref.com/en/players/56ae428b/Jubal"
2023,"Auxerre","Ligue 1","Donovan Léon","GUF","GK","29",1992,2,0,0,0,0,0,0,0,NA,0,0,0,0,0,0,1,0,"https://fbref.com/en/players/51c83a90/Donovan-Leon"
2023,"Auxerre","Ligue 1","Youssouf M'Changama","COM","MF","31",1990,12,22,11,7,12,3,7,13,53.8,6,6,0,6,15,37,6,1,"https://fbref.com/en/players/e05082d1/Youssouf-MChangama"
2023,"Auxerre","Ligue 1","Han-Noah Massengo","FRA","MF","21",2001,12.4,27,15,10,15,2,7,16,43.8,9,12,3,9,14,41,7,0,"https://fbref.com/en/players/eba1e557/Han-Noah-Massengo"
2023,"Auxerre","Ligue 1","Gideon Mensah","GHA","DF","24",1998,25.1,80,44,43,32,5,44,77,57.1,33,33,10,23,38,118,41,0,"https://fbref.com/en/players/9bdd8118/Gideon-Mensah"
2023,"Auxerre","Ligue 1","M'Baye Niang","SEN","FW","27",1994,16.5,13,7,1,8,4,3,13,23.1,10,22,1,21,1,14,20,0,"https://fbref.com/en/players/2054d037/MBaye-Niang"
2023,"Auxerre","Ligue 1","Théo Pellenard","FRA","DF","28",1994,1.1,1,0,1,0,0,1,1,100,0,3,1,2,2,3,2,0,"https://fbref.com/en/players/97fb4608/Theo-Pellenard"
2023,"Auxerre","Ligue 1","Brayann Pereira","FRA","DF","19",2003,2,6,5,5,1,0,1,5,20,4,2,2,0,2,8,8,1,"https://fbref.com/en/players/5c42e7ce/Brayann-Pereira"
2023,"Auxerre","Ligue 1","Gaëtan Perrin","FRA","MF,FW","26",1996,15.5,17,8,5,6,6,8,30,26.7,22,15,0,15,10,27,9,0,"https://fbref.com/en/players/10dd88f9/Gaetan-Perrin"
2023,"Auxerre","Ligue 1","Ionuț Radu","ROU","GK","25",1997,17,0,0,0,0,0,0,0,NA,0,0,0,0,0,0,3,2,"https://fbref.com/en/players/67f649be/Ionut-Radu"
2023,"Auxerre","Ligue 1","Rayan Raveloson","MAD","DF,MF","25",1997,27,38,23,21,16,1,23,33,69.7,10,43,12,31,39,77,70,0,"https://fbref.com/en/players/fb3236a7/Rayan-Raveloson"
2023,"Auxerre","Ligue 1","Kays Ruiz","MAR","MF","19",2002,0.7,1,1,1,0,0,0,1,0,1,2,1,1,3,4,0,0,"https://fbref.com/en/players/90a9cc01/Kays-Ruiz"
2023,"Auxerre","Ligue 1","Hamza Sakhi","MAR","MF","26",1996,18.4,44,22,22,17,5,22,42,52.4,20,16,1,15,25,69,9,0,"https://fbref.com/en/players/c9151d66/Hamza-Sakhi"
2023,"Auxerre","Ligue 1","Lassine Sinayoko","MLI","MF,FW","22",1999,17.4,33,15,14,12,7,21,40,52.5,19,12,0,12,18,51,17,0,"https://fbref.com/en/players/5e5249c8/Lassine-Sinayoko"
2023,"Auxerre","Ligue 1","Birama Touré","MLI","MF","30",1992,37.8,80,47,35,35,10,34,93,36.6,59,54,9,45,67,147,49,0,"https://fbref.com/en/players/a4b798a9/Birama-Toure"
2023,"Auxerre","Ligue 1","Souleymane Touré","FRA","DF","19",2003,17.6,29,13,19,9,1,16,20,80,4,32,12,20,26,55,56,1,"https://fbref.com/en/players/01fd01e8/Souleymane-Toure"
2023,"Auxerre","Ligue 1","Akim Zedadka","ALG","DF","27",1995,17.8,35,21,21,10,4,18,32,56.3,14,17,3,14,23,58,51,1,"https://fbref.com/en/players/0ff630d0/Akim-Zedadka"
2023,"Barcelona","La Liga","Ángel Alarcón","ESP","FW","18",2004,0.3,NA,0,NA,NA,NA,NA,NA,NA,NA,NA,NA,NA,0,NA,NA,NA,"https://fbref.com/en/players/455c26a4/Angel-Alarcon"
2023,"Barcelona","La Liga","Jordi Alba","ESP","DF","33",1989,15.8,25,18,13,11,1,12,28,42.9,16,12,5,7,11,36,23,0,"https://fbref.com/en/players/4601e194/Jordi-Alba"
2023,"Barcelona","La Liga","Marcos Alonso","ESP","DF","31",1990,13,15,10,10,5,0,9,12,75,3,14,10,4,11,26,32,0,"https://fbref.com/en/players/f4290206/Marcos-Alonso"
2023,"Barcelona","La Liga","Ronald Araújo","URU","DF","23",1999,20,26,18,12,13,1,6,9,66.7,3,15,7,8,12,38,41,1,"https://fbref.com/en/players/2bef2bca/Ronald-Araujo"
2023,"Barcelona","La Liga","Pierre-Emerick Aubameyang","GAB","FW","33",1989,0.1,0,0,0,0,0,0,0,NA,0,0,0,0,0,0,0,0,"https://fbref.com/en/players/d5dd5f1f/Pierre-Emerick-Aubameyang"
2023,"Barcelona","La Liga","Alejandro Balde","ESP","DF","18",2003,27.5,42,30,22,16,4,24,41,58.5,17,25,3,22,12,54,17,1,"https://fbref.com/en/players/5ccc9672/Alejandro-Balde"
2023,"Barcelona","La Liga","Héctor Bellerín","ESP","DF","27",1995,1.6,2,0,0,2,0,2,3,66.7,1,2,0,2,3,5,2,0,"https://fbref.com/en/players/f874dd44/Hector-Bellerin"
2023,"Barcelona","La Liga","Sergio Busquets","ESP","MF","34",1988,26,58,26,24,26,8,29,51,56.9,22,32,6,26,27,85,36,2,"https://fbref.com/en/players/5ab0ea87/Sergio-Busquets"
2023,"Barcelona","La Liga","Andreas Christensen","DEN","DF","26",1996,19.6,20,15,9,11,0,10,16,62.5,6,14,12,2,21,41,47,0,"https://fbref.com/en/players/1cb49278/Andreas-Christensen"
2023,"Barcelona","La Liga","Ousmane Dembélé","FRA","FW","25",1997,15.7,19,12,4,8,7,4,15,26.7,11,10,1,9,0,19,2,0,"https://fbref.com/en/players/b19db005/Ousmane-Dembele"
2023,"Barcelona","La Liga","Ansu Fati","ESP","FW","19",2002,15.5,16,9,8,4,4,5,18,27.8,13,19,0,19,5,21,6,0,"https://fbref.com/en/players/0ba976e4/Ansu-Fati"
2023,"Barcelona","La Liga","Eric García","ESP","DF,MF","21",2001,15.7,24,16,16,5,3,9,20,45,11,23,10,13,19,43,36,1,"https://fbref.com/en/players/2bed3eab/Eric-Garcia"
2023,"Barcelona","La Liga","Aleix Garrido","ESP","FW","18",2004,0.1,2,1,1,0,1,1,1,100,0,1,0,1,0,2,0,0,"https://fbref.com/en/players/5757adc3/Aleix-Garrido"
2023,"Barcelona","La Liga","Gavi","ESP","MF,FW","17",2004,28.1,47,31,7,30,10,21,55,38.2,34,32,5,27,18,65,22,0,"https://fbref.com/en/players/19cae58d/Gavi"
2023,"Barcelona","La Liga","Frenkie de Jong","NED","MF","25",1997,28.2,46,26,16,21,9,17,41,41.5,24,11,1,10,35,81,22,1,"https://fbref.com/en/players/1bacc518/Frenkie-de-Jong"
2023,"Barcelona","La Liga","Franck Kessié","CIV","MF","25",1996,11,15,9,6,6,3,8,18,44.4,10,10,2,8,12,27,11,2,"https://fbref.com/en/players/05e19d6a/Franck-Kessie"
2023,"Barcelona","La Liga","Jules Koundé","FRA","DF","23",1998,27,37,23,18,13,6,21,31,67.7,10,24,9,15,19,56,61,3,"https://fbref.com/en/players/4d1666ff/Jules-Kounde"
2023,"Barcelona","La Liga","Robert Lewandowski","POL","FW","33",1988,31.6,17,11,2,5,10,7,14,50,7,20,0,20,2,19,14,0,"https://fbref.com/en/players/8d78e732/Robert-Lewandowski"
2023,"Barcelona","La Liga","Memphis","NED","FW","28",1994,1.3,1,1,1,0,0,0,1,0,1,0,0,0,0,1,0,0,"https://fbref.com/en/players/8f696594/Memphis"
2023,"Barcelona","La Liga","Pedri","ESP","MF","19",2002,22,39,22,15,17,7,13,45,28.9,32,27,0,27,13,52,8,1,"https://fbref.com/en/players/0d9b2d31/Pedri"
2023,"Barcelona","La Liga","Iñaki Peña","ESP","GK","23",1999,0.8,0,0,0,0,0,0,0,NA,0,0,0,0,0,0,0,1,"https://fbref.com/en/players/cc1c5035/Inaki-Pena"
2023,"Barcelona","La Liga","Gerard Piqué","ESP","DF","35",1987,4.3,5,4,1,4,0,4,4,100,0,2,1,1,2,7,19,0,"https://fbref.com/en/players/adfc9123/Gerard-Pique"
2023,"Barcelona","La Liga","Raphinha","BRA","FW","25",1996,23,29,19,10,7,12,11,31,35.5,20,33,1,32,14,43,11,1,"https://fbref.com/en/players/3423f250/Raphinha"
2023,"Barcelona","La Liga","Chadi Riad","MAR","MF","19",2003,0,0,0,0,0,0,0,0,NA,0,0,0,0,0,0,0,0,"https://fbref.com/en/players/b3b9b8b8/Chadi-Riad"
2023,"Barcelona","La Liga","Sergi Roberto","ESP","DF,MF","30",1992,14.5,22,15,12,6,4,7,18,38.9,11,15,7,8,11,33,16,0,"https://fbref.com/en/players/335fa267/Sergi-Roberto"
2023,"Barcelona","La Liga","Marc-André ter Stegen","GER","GK","30",1992,37.2,0,0,0,0,0,0,0,NA,0,0,0,0,1,1,7,3,"https://fbref.com/en/players/6f51e382/Marc-Andre-ter-Stegen"
2023,"Barcelona","La Liga","Pablo Torre","ESP","FW,MF","19",2003,1.6,2,1,0,1,1,2,4,50,2,1,0,1,2,4,1,0,"https://fbref.com/en/players/04e531b6/Pablo-Torre"
2023,"Barcelona","La Liga","Ferrán Torres","ESP","FW,MF","22",2000,15.5,13,7,4,5,4,5,20,25,15,11,2,9,3,16,5,0,"https://fbref.com/en/players/9e1035f8/Ferran-Torres"
2023,"Barcelona","La Liga","Lamine Yamal","ESP","FW","15",2007,0.1,0,0,0,0,0,0,0,NA,0,0,0,0,0,0,0,0,"https://fbref.com/en/players/82ec26c1/Lamine-Yamal"
2023,"Bayern Munich","Bundesliga","Daley Blind","NED","DF,MF","32",1990,1.5,2,0,2,0,0,0,1,0,1,4,2,2,2,4,6,0,"https://fbref.com/en/players/691bef82/Daley-Blind"
2023,"Bayern Munich","Bundesliga","João Cancelo","POR","DF,FW","28",1994,11.2,23,14,9,10,4,10,23,43.5,13,14,2,12,15,38,22,0,"https://fbref.com/en/players/bd6351cd/Joao-Cancelo"
2023,"Bayern Munich","Bundesliga","Kingsley Coman","FRA","FW,MF","26",1996,15.7,11,8,3,5,3,7,17,41.2,10,19,1,18,2,13,7,0,"https://fbref.com/en/players/042e8a49/Kingsley-Coman"
2023,"Bayern Munich","Bundesliga","Alphonso Davies","CAN","DF","21",2000,22.7,45,28,25,13,7,18,39,46.2,21,28,4,24,24,69,24,4,"https://fbref.com/en/players/d781d855/Alphonso-Davies"
2023,"Bayern Munich","Bundesliga","Serge Gnabry","GER","FW,MF","27",1995,21.6,35,23,11,14,10,17,43,39.5,26,24,1,23,11,46,5,1,"https://fbref.com/en/players/88e357ef/Serge-Gnabry"
2023,"Bayern Munich","Bundesliga","Leon Goretzka","GER","MF","27",1995,19.2,43,24,21,16,6,27,48,56.3,21,40,3,37,30,73,32,0,"https://fbref.com/en/players/cc86b9a3/Leon-Goretzka"
2023,"Bayern Munich","Bundesliga","Ryan Gravenberch","NED","MF","20",2002,6.4,17,8,4,10,3,7,13,53.8,6,9,1,8,9,26,10,0,"https://fbref.com/en/players/b8e740fb/Ryan-Gravenberch"
2023,"Bayern Munich","Bundesliga","Lucas Hernández","FRA","DF","26",1996,5.3,6,4,3,3,0,5,6,83.3,1,2,1,1,5,11,7,0,"https://fbref.com/en/players/c3ee18ef/Lucas-Hernandez"
2023,"Bayern Munich","Bundesliga","Arijon Ibrahimović","GER","MF","16",2005,0.2,1,1,1,0,0,0,0,NA,0,0,0,0,0,1,0,0,"https://fbref.com/en/players/f5c4fd91/Arijon-Ibrahimovic"
2023,"Bayern Munich","Bundesliga","Joshua Kimmich","GER","MF","27",1995,31.2,78,49,24,46,8,38,72,52.8,34,36,7,29,41,119,39,2,"https://fbref.com/en/players/49296448/Joshua-Kimmich"
2023,"Bayern Munich","Bundesliga","Matthijs de Ligt","NED","DF","22",1999,26.7,32,23,15,16,1,15,24,62.5,9,31,20,11,23,55,85,0,"https://fbref.com/en/players/d6e53a3a/Matthijs-de-Ligt"
2023,"Bayern Munich","Bundesliga","Sadio Mané","SEN","FW,MF","30",1992,15.8,11,5,3,3,5,1,9,11.1,8,15,2,13,0,11,4,0,"https://fbref.com/en/players/c691bfe2/Sadio-Mane"
2023,"Bayern Munich","Bundesliga","Eric Maxim Choupo-Moting","CMR","FW","33",1989,12.4,10,7,2,6,2,1,2,50,1,8,0,8,0,10,5,0,"https://fbref.com/en/players/0e6bc38c/Eric-Maxim-Choupo-Moting"
2023,"Bayern Munich","Bundesliga","Noussair Mazraoui","MAR","DF","24",1997,11.9,29,21,9,9,11,15,24,62.5,9,13,2,11,10,39,25,0,"https://fbref.com/en/players/b74277a0/Noussair-Mazraoui"
2023,"Bayern Munich","Bundesliga","Thomas Müller","GER","FW,MF","32",1989,18.5,21,12,5,9,7,6,16,37.5,10,19,3,16,4,25,16,0,"https://fbref.com/en/players/3c6089ab/Thomas-Muller"
2023,"Bayern Munich","Bundesliga","Jamal Musiala","GER","MF,FW","19",2003,24.4,34,23,9,16,9,13,35,37.1,22,30,3,27,19,53,3,0,"https://fbref.com/en/players/2c0558b8/Jamal-Musiala"
2023,"Bayern Munich","Bundesliga","Manuel Neuer","GER","GK","36",1986,12,0,0,0,0,0,0,0,NA,0,0,0,0,0,0,4,1,"https://fbref.com/en/players/8778c910/Manuel-Neuer"
2023,"Bayern Munich","Bundesliga","Benjamin Pavard","FRA","DF","26",1996,27,70,41,36,26,8,36,48,75,12,35,16,19,44,114,83,0,"https://fbref.com/en/players/45a03961/Benjamin-Pavard"
2023,"Bayern Munich","Bundesliga","Marcel Sabitzer","AUT","MF","28",1994,7,27,14,11,10,6,10,17,58.8,7,3,0,3,10,37,9,0,"https://fbref.com/en/players/e280527c/Marcel-Sabitzer"
2023,"Bayern Munich","Bundesliga","Leroy Sané","GER","MF,FW","26",1996,22.3,38,30,11,19,8,18,36,50,18,11,1,10,3,41,1,2,"https://fbref.com/en/players/2b114be3/Leroy-Sane"
2023,"Bayern Munich","Bundesliga","Bouna Sarr","SEN","FW","30",1992,0,0,0,0,0,0,0,0,NA,0,0,0,0,0,0,0,0,"https://fbref.com/en/players/1a4b9094/Bouna-Sarr"
2023,"Bayern Munich","Bundesliga","Yann Sommer","SUI","GK","33",1988,19,0,0,0,0,0,0,0,NA,0,0,0,0,1,1,5,1,"https://fbref.com/en/players/420c18a1/Yann-Sommer"
2023,"Bayern Munich","Bundesliga","Josip Stanišić","CRO","DF","22",2000,6.4,19,11,14,2,3,12,17,70.6,5,9,1,8,7,26,11,3,"https://fbref.com/en/players/7ed08d5c/Josip-Stanisic"
2023,"Bayern Munich","Bundesliga","Mathys Tel","FRA","FW","17",2005,4.6,2,2,0,1,1,1,1,100,0,5,1,4,0,2,2,0,"https://fbref.com/en/players/829aa60c/Mathys-Tel"
2023,"Bayern Munich","Bundesliga","Sven Ulreich","GER","GK","33",1988,3,1,1,1,0,0,1,1,100,0,0,0,0,0,1,0,1,"https://fbref.com/en/players/7d3e7da6/Sven-Ulreich"
2023,"Bayern Munich","Bundesliga","Dayot Upamecano","FRA","DF","23",1998,26.1,65,37,43,22,0,28,45,62.2,17,26,6,20,27,92,71,4,"https://fbref.com/en/players/d248cd8f/Dayot-Upamecano"
2023,"Bayern Munich","Bundesliga","Gabriel Vidovic","CRO","FW","18",2003,0.2,0,0,0,0,0,0,0,NA,0,0,0,0,0,0,0,0,"https://fbref.com/en/players/5360a956/Gabriel-Vidovic"
2023,"Bayern Munich","Bundesliga","Paul Wanner","GER","MF","16",2005,0.3,3,1,1,2,0,1,1,100,0,0,0,0,0,3,1,0,"https://fbref.com/en/players/cb64672e/Paul-Wanner"
2023,"Betis","La Liga","Abner","BRA","DF","22",2000,6.7,12,9,9,2,1,7,16,43.8,9,8,2,6,8,20,24,0,"https://fbref.com/en/players/7f9c5d2d/Abner"
2023,"Betis","La Liga","Paul Akouokou","CIV","MF,DF","24",1997,5,16,9,13,3,0,13,20,65,7,2,2,0,12,28,17,1,"https://fbref.com/en/players/31f5b89b/Paul-Akouokou"
2023,"Betis","La Liga","Claudio Bravo","CHI","GK","39",1983,12,0,0,0,0,0,0,0,NA,0,0,0,0,2,2,1,1,"https://fbref.com/en/players/10072610/Claudio-Bravo"
2023,"Betis","La Liga","Sergio Canales","ESP","FW,MF","31",1991,26.7,25,14,10,8,7,14,33,42.4,19,18,0,18,14,39,8,0,"https://fbref.com/en/players/a6de370d/Sergio-Canales"
2023,"Betis","La Liga","William Carvalho","POR","MF","30",1992,27.1,43,27,18,23,2,17,44,38.6,27,27,6,21,16,59,22,0,"https://fbref.com/en/players/dee86451/William-Carvalho"
2023,"Betis","La Liga","Juan Cruz","ESP","FW","22",2000,2,1,0,0,1,0,1,3,33.3,2,1,0,1,0,1,0,0,"https://fbref.com/en/players/cc2dd8a5/Juan-Cruz"
2023,"Betis","La Liga","Fran Delgado","ESP","DF","21",2001,0.1,0,0,0,0,0,0,0,NA,0,0,0,0,0,0,0,0,"https://fbref.com/en/players/e7d2a50b/Fran-Delgado"
2023,"Betis","La Liga","Nabil Fekir","FRA","MF","29",1993,10.7,11,5,3,3,5,2,9,22.2,7,6,2,4,1,12,0,0,"https://fbref.com/en/players/bece776f/Nabil-Fekir"
2023,"Betis","La Liga","Luiz Felipe","ITA","DF","25",1997,19.6,34,23,23,11,0,18,34,52.9,16,43,24,19,28,62,106,0,"https://fbref.com/en/players/15d0c248/Luiz-Felipe"
2023,"Betis","La Liga","Felix Garreta","ESP","DF","18",2004,1,1,0,0,1,0,0,0,NA,0,1,1,0,1,2,4,0,"https://fbref.com/en/players/9a26fa06/Felix-Garreta"
2023,"Betis","La Liga","Édgar González","ESP","DF","25",1997,19.7,28,19,18,7,3,14,27,51.9,13,12,9,3,21,49,120,0,"https://fbref.com/en/players/49d028db/Edgar-Gonzalez"
2023,"Betis","La Liga","Roberto González","ESP","FW,MF","21",2001,0.6,0,0,0,0,0,0,1,0,1,0,0,0,1,1,0,0,"https://fbref.com/en/players/56545648/Roberto-Gonzalez"
2023,"Betis","La Liga","Andrés Guardado","MEX","MF","35",1986,15.3,41,25,17,20,4,18,43,41.9,25,14,5,9,23,64,29,0,"https://fbref.com/en/players/ef322658/Andres-Guardado"
2023,"Betis","La Liga","Luiz Henrique","BRA","FW","21",2001,20.1,48,34,27,15,6,20,44,45.5,24,22,0,22,14,62,17,0,"https://fbref.com/en/players/8059806f/Luiz-Henrique"
2023,"Betis","La Liga","Borja Iglesias","ESP","FW","29",1993,26.3,8,4,3,3,2,2,13,15.4,11,9,1,8,1,9,17,0,"https://fbref.com/en/players/75645f0e/Borja-Iglesias"
2023,"Betis","La Liga","Joaquín","ESP","MF,FW","41",1981,5.5,3,3,2,1,0,1,3,33.3,2,7,2,5,4,7,5,0,"https://fbref.com/en/players/4c5b14d2/Joaquin"
2023,"Betis","La Liga","Willian José","BRA","FW","30",1991,8.1,9,6,6,3,0,4,9,44.4,5,4,0,4,1,10,15,0,"https://fbref.com/en/players/d87e2cae/Willian-Jose"
2023,"Betis","La Liga","Juanmi","ESP","FW","29",1993,10.3,14,10,4,7,3,7,31,22.6,24,10,0,10,4,18,4,0,"https://fbref.com/en/players/84399660/Juanmi"
2023,"Betis","La Liga","Juan Miranda","ESP","DF","22",2000,16.4,23,16,16,6,1,14,29,48.3,15,20,7,13,20,43,63,0,"https://fbref.com/en/players/ead61f73/Juan-Miranda"
2023,"Betis","La Liga","Martín Montoya","ESP","DF","31",1991,5,13,8,9,4,0,10,12,83.3,2,6,1,5,9,22,14,1,"https://fbref.com/en/players/5cec2487/Martin-Montoya"
2023,"Betis","La Liga","Álex Moreno","ESP","DF","29",1993,15,29,22,19,10,0,18,36,50,18,17,4,13,17,46,39,0,"https://fbref.com/en/players/16e9d0ea/Alex-Moreno"
2023,"Betis","La Liga","Loren Morón","ESP","FW","28",1993,0.2,2,2,0,1,1,0,0,NA,0,0,0,0,0,2,1,0,"https://fbref.com/en/players/3aa4a3be/Loren-Moron"
2023,"Betis","La Liga","Ayoze Pérez","ESP","FW,MF","29",1993,15.4,31,15,9,16,6,10,40,25,30,22,0,22,13,44,5,0,"https://fbref.com/en/players/819aa8e7/Ayoze-Perez"
2023,"Betis","La Liga","Germán Pezzella","ARG","DF","31",1991,27.9,41,28,32,9,0,26,38,68.4,12,32,15,17,50,91,129,1,"https://fbref.com/en/players/8c725b43/German-Pezzella"
2023,"Betis","La Liga","Rodri","ESP","FW,MF","22",2000,17.8,16,11,5,9,2,8,17,47.1,9,10,0,10,13,29,2,0,"https://fbref.com/en/players/85bed4ee/Rodri"
2023,"Betis","La Liga","Guido Rodríguez","ARG","MF","28",1994,31.9,115,75,59,50,6,54,101,53.5,47,58,14,44,42,157,76,1,"https://fbref.com/en/players/34e393f2/Guido-Rodriguez"
2023,"Betis","La Liga","Aitor Ruibal","ESP","DF,FW","26",1996,16.2,47,29,35,9,3,31,58,53.4,27,17,2,15,24,71,41,0,"https://fbref.com/en/players/a55d8df5/Aitor-Ruibal"
2023,"Betis","La Liga","Víctor Ruiz","ESP","DF","33",1989,6.2,5,3,3,2,0,3,3,100,0,10,7,3,6,11,34,0,"https://fbref.com/en/players/b3dc6eca/Victor-Ruiz"
2023,"Betis","La Liga","Youssouf Sabaly","SEN","DF","29",1993,18.7,45,23,29,14,2,22,33,66.7,11,35,8,27,19,64,52,1,"https://fbref.com/en/players/fbbb9269/Youssouf-Sabaly"
2023,"Betis","La Liga","Rui Silva","POR","GK","28",1994,26,4,1,4,0,0,4,4,100,0,0,0,0,0,4,12,1,"https://fbref.com/en/players/ea83bfa6/Rui-Silva"
2023,"Bochum","Bundesliga","Christopher Antwi-Adjei","GHA","FW,MF","28",1994,22,23,15,7,8,8,10,29,34.5,19,17,0,17,5,28,16,0,"https://fbref.com/en/players/0a3f6cde/Christopher-Antwi-Adjei"
2023,"Bochum","Bundesliga","Takuma Asano","JPN","FW,MF","27",1994,19,14,9,4,4,6,7,16,43.8,9,17,1,16,8,22,8,0,"https://fbref.com/en/players/13ddc856/Takuma-Asano"
2023,"Bochum","Bundesliga","Moritz Broschinski","GER","FW,MF","21",2000,2.4,0,0,0,0,0,0,5,0,5,1,0,1,0,0,6,0,"https://fbref.com/en/players/bbd79358/Moritz-Broschinski"
2023,"Bochum","Bundesliga","Philipp Förster","GER","MF","27",1995,14.5,31,19,11,15,5,12,40,30,28,22,0,22,6,37,6,0,"https://fbref.com/en/players/76fa965f/Philipp-Forster"
2023,"Bochum","Bundesliga","Cristian Gamboa","CRC","DF","32",1989,16.4,42,24,27,14,1,21,31,67.7,10,20,7,13,16,58,34,1,"https://fbref.com/en/players/f27680d9/Cristian-Gamboa"
2023,"Bochum","Bundesliga","Silvère Ganvoula M'Boussy","CGO","FW,MF","26",1996,2.7,2,2,0,1,1,0,0,NA,0,0,0,0,0,2,3,0,"https://fbref.com/en/players/6c731625/Silvere-Ganvoula-MBoussy"
2023,"Bochum","Bundesliga","Jacek Góralski","POL","MF","29",1992,1.6,6,3,3,3,0,4,6,66.7,2,4,0,4,3,9,5,0,"https://fbref.com/en/players/83b9c48f/Jacek-Goralski"
2023,"Bochum","Bundesliga","Dominique Heintz","GER","DF","28",1993,8.8,13,9,5,7,1,6,17,35.3,11,11,7,4,12,25,34,0,"https://fbref.com/en/players/699fb8db/Dominique-Heintz"
2023,"Bochum","Bundesliga","Philipp Hofmann","GER","FW","29",1993,29.2,18,11,0,13,5,5,12,41.7,7,20,8,12,6,24,48,0,"https://fbref.com/en/players/877bc844/Philipp-Hofmann"
2023,"Bochum","Bundesliga","Gerrit Holtmann","PHI","FW,MF","27",1995,10.5,14,7,6,7,1,12,21,57.1,9,15,1,14,2,16,4,0,"https://fbref.com/en/players/2979c05a/Gerrit-Holtmann"
2023,"Bochum","Bundesliga","Jannes Horn","GER","DF,FW","25",1997,0.7,2,1,1,1,0,1,1,100,0,1,0,1,3,5,2,0,"https://fbref.com/en/players/2b83fa49/Jannes-Horn"
2023,"Bochum","Bundesliga","Saidy Janko","GAM","DF","26",1995,12.6,23,15,13,8,2,12,20,60,8,24,10,14,11,34,33,1,"https://fbref.com/en/players/689c9cf4/Saidy-Janko"
2023,"Bochum","Bundesliga","Pierre Kunde","CMR","MF,FW","27",1995,4.2,12,6,3,8,1,6,14,42.9,8,7,1,6,7,19,9,0,"https://fbref.com/en/players/9ceb7642/Pierre-Kunde"
2023,"Bochum","Bundesliga","Vassilis Lambropoulos","GRE","DF","32",1990,7,10,8,7,3,0,6,9,66.7,3,5,3,2,13,23,41,0,"https://fbref.com/en/players/591477c9/Vassilis-Lambropoulos"
2023,"Bochum","Bundesliga","Anthony Losilla","FRA","MF","36",1986,30.2,76,49,32,34,10,38,77,49.4,39,39,12,27,37,113,67,0,"https://fbref.com/en/players/07c7eb0c/Anthony-Losilla"
2023,"Bochum","Bundesliga","Erhan Mašović","SRB","DF,MF","23",1998,24.2,50,31,28,21,1,30,51,58.8,21,30,14,16,27,77,79,0,"https://fbref.com/en/players/a396fb61/Erhan-Masovic"
2023,"Bochum","Bundesliga","Tim Oermann","GER","DF","18",2003,2.2,2,1,2,0,0,1,1,100,0,3,2,1,1,3,8,1,"https://fbref.com/en/players/57ec75bf/Tim-Oermann"
2023,"Bochum","Bundesliga","Ivan Ordets","UKR","DF","30",1992,27.2,31,19,21,9,1,16,28,57.1,12,34,17,17,57,88,139,0,"https://fbref.com/en/players/86c75897/Ivan-Ordets"
2023,"Bochum","Bundesliga","Jordi Osei-Tutu","ENG","DF,FW","23",1998,8.3,23,18,13,5,5,12,23,52.2,11,12,5,7,10,33,8,0,"https://fbref.com/en/players/0a16eb36/Jordi-Osei-Tutu"
2023,"Bochum","Bundesliga","Patrick Osterhage","GER","MF","22",2000,11.4,20,17,8,10,2,11,16,68.8,5,17,6,11,12,32,25,0,"https://fbref.com/en/players/9662c9ec/Patrick-Osterhage"
2023,"Bochum","Bundesliga","Manuel Riemann","GER","GK","33",1988,34,3,2,3,0,0,3,5,60,2,1,0,1,5,8,23,7,"https://fbref.com/en/players/9f941969/Manuel-Riemann"
2023,"Bochum","Bundesliga","Keven Schlotterbeck","GER","DF","25",1997,8.2,17,9,12,5,0,9,11,81.8,2,11,5,6,14,31,49,0,"https://fbref.com/en/players/f6bdc830/Keven-Schlotterbeck"
2023,"Bochum","Bundesliga","Danilo Soares","BRA","DF","30",1991,19.6,72,46,42,23,7,43,72,59.7,29,29,6,23,30,102,56,1,"https://fbref.com/en/players/c05f2f8c/Danilo-Soares"
2023,"Bochum","Bundesliga","Kostas Stafylidis","GRE","DF,MF","28",1993,11.6,27,16,13,8,6,10,24,41.7,14,21,8,13,20,47,31,1,"https://fbref.com/en/players/861e0116/Kostas-Stafylidis"
2023,"Bochum","Bundesliga","Kevin Stöger","AUT","MF","28",1993,28.9,84,45,38,32,14,31,94,33,63,27,4,23,26,110,21,1,"https://fbref.com/en/players/e5649a78/Kevin-Stoger"
2023,"Bochum","Bundesliga","Simon Zoller","GER","FW","31",1991,16.2,11,4,2,8,1,4,12,33.3,8,14,1,13,6,17,21,0,"https://fbref.com/en/players/29f7cfd9/Simon-Zoller"
2023,"Bologna","Serie A","Michel Aebischer","SUI","FW,MF","25",1997,17.1,12,6,3,6,3,2,18,11.1,16,14,2,12,7,19,9,0,"https://fbref.com/en/players/f9c927de/Michel-Aebischer"
2023,"Bologna","Serie A","Marko Arnautović","AUT","FW","33",1989,17,9,6,2,5,2,1,6,16.7,5,11,1,10,2,11,10,0,"https://fbref.com/en/players/00459419/Marko-Arnautovic"
2023,"Bologna","Serie A","Francesco Bardi","ITA","GK","30",1992,1,0,0,0,0,0,0,0,NA,0,0,0,0,0,0,0,0,"https://fbref.com/en/players/0acda699/Francesco-Bardi"
2023,"Bologna","Serie A","Musa Barrow","GAM","FW,MF","23",1998,21.8,21,4,10,6,5,8,14,57.1,6,25,1,24,1,22,7,0,"https://fbref.com/en/players/e5bf73f3/Musa-Barrow"
2023,"Bologna","Serie A","Kevin Bonifazi","ITA","DF","26",1996,10,13,8,7,6,0,6,12,50,6,11,8,3,12,25,39,0,"https://fbref.com/en/players/fb77bfef/Kevin-Bonifazi"
2023,"Bologna","Serie A","Andrea Cambiaso","ITA","DF","22",2000,24.1,57,34,34,20,3,28,65,43.1,37,26,2,24,26,83,33,1,"https://fbref.com/en/players/247ed022/Andrea-Cambiaso"
2023,"Bologna","Serie A","Lorenzo De Silvestri","ITA","DF","34",1988,7.5,3,2,2,0,1,3,7,42.9,4,6,5,1,3,6,20,0,"https://fbref.com/en/players/e74f0e59/Lorenzo-De-Silvestri"
2023,"Bologna","Serie A","Nicolás Domínguez","ARG","MF","24",1998,25.6,79,49,34,33,12,39,76,51.3,37,29,3,26,21,100,29,1,"https://fbref.com/en/players/20b3a502/Nicolas-Dominguez"
2023,"Bologna","Serie A","Lewis Ferguson","SCO","MF,FW","22",1999,25.7,44,25,16,20,8,20,40,50,20,22,7,15,19,63,25,0,"https://fbref.com/en/players/ee64a822/Lewis-Ferguson"
2023,"Bologna","Serie A","Denso Kasius","NED","DF","19",2002,3.8,12,6,7,4,1,8,10,80,2,6,3,3,3,15,6,0,"https://fbref.com/en/players/7ae36711/Denso-Kasius"
2023,"Bologna","Serie A","Giorgos Kyriakopoulos","GRE","DF,FW","26",1996,7.8,13,6,4,5,4,10,23,43.5,13,14,2,12,4,17,10,0,"https://fbref.com/en/players/0a483542/Giorgos-Kyriakopoulos"
2023,"Bologna","Serie A","Jhon Lucumí","COL","DF","24",1998,32.2,53,37,39,13,1,24,43,55.8,19,43,26,17,35,88,100,1,"https://fbref.com/en/players/80490d7f/Jhon-Lucumi"
2023,"Bologna","Serie A","Charalambos Lykogiannis","GRE","DF","28",1993,12.3,16,8,5,6,5,5,13,38.5,8,9,4,5,15,31,30,0,"https://fbref.com/en/players/5efc5389/Charalambos-Lykogiannis"
2023,"Bologna","Serie A","Gary Medel","CHI","MF,DF","34",1987,16.4,25,15,16,7,2,9,16,56.3,7,17,10,7,28,53,34,0,"https://fbref.com/en/players/563a68ad/Gary-Medel"
2023,"Bologna","Serie A","Nikola Moro","CRO","MF","24",1998,13.6,32,21,11,15,6,14,36,38.9,22,15,2,13,8,40,18,0,"https://fbref.com/en/players/ff579c7e/Nikola-Moro"
2023,"Bologna","Serie A","Riccardo Orsolini","ITA","FW","25",1997,23.6,30,19,15,10,5,17,41,41.5,24,29,3,26,8,38,18,0,"https://fbref.com/en/players/e14ec482/Riccardo-Orsolini"
2023,"Bologna","Serie A","Stefan Posch","AUT","DF","25",1997,28.1,81,43,41,29,11,44,75,58.7,31,44,15,29,35,116,69,0,"https://fbref.com/en/players/7f609bfc/Stefan-Posch"
2023,"Bologna","Serie A","Niklas Pyyhtiä","FIN","MF","18",2003,1.2,1,0,0,1,0,0,1,0,1,1,1,0,1,2,4,0,"https://fbref.com/en/players/88f53b75/Niklas-Pyyhtia"
2023,"Bologna","Serie A","Antonio Raimondo","ITA","FW","18",2004,0.2,0,0,0,0,0,0,0,NA,0,0,0,0,0,0,1,0,"https://fbref.com/en/players/ce1a6c7e/Antonio-Raimondo"
2023,"Bologna","Serie A","Nicola Sansone","ITA","FW","30",1991,8.2,12,4,6,4,2,5,10,50,5,0,0,0,0,12,4,0,"https://fbref.com/en/players/7eb97a8e/Nicola-Sansone"
2023,"Bologna","Serie A","Jerdy Schouten","NED","MF","25",1997,27.9,63,38,28,33,2,27,49,55.1,22,40,17,23,40,103,43,1,"https://fbref.com/en/players/2cfae697/Jerdy-Schouten"
2023,"Bologna","Serie A","Łukasz Skorupski","POL","GK","31",1991,37,2,1,2,0,0,1,2,50,1,0,0,0,0,2,19,2,"https://fbref.com/en/players/ab4449d6/Lukasz-Skorupski"
2023,"Bologna","Serie A","Roberto Soriano","ITA","FW,MF","31",1991,14.7,31,16,9,16,6,13,25,52,12,23,2,21,6,37,14,0,"https://fbref.com/en/players/9d4c45d6/Roberto-Soriano"
2023,"Bologna","Serie A","Joaquin Sosa","URU","DF","20",2002,7.6,6,2,5,1,0,4,18,22.2,14,5,3,2,6,12,31,0,"https://fbref.com/en/players/50841bef/Joaquin-Sosa"
2023,"Bologna","Serie A","Adama Soumaoro","FRA","DF","30",1992,20.7,25,17,11,12,2,5,7,71.4,2,18,13,5,15,40,75,1,"https://fbref.com/en/players/7b075c75/Adama-Soumaoro"
2023,"Bologna","Serie A","Emanuel Vignato","ITA","MF,FW","21",2000,2.7,4,4,2,2,0,2,4,50,2,2,0,2,3,7,0,0,"https://fbref.com/en/players/ec5dae45/Emanuel-Vignato"
2023,"Bologna","Serie A","Joshua Zirkzee","NED","FW","21",2001,9.1,4,2,1,1,2,2,7,28.6,5,4,1,3,4,8,4,0,"https://fbref.com/en/players/028e70b9/Joshua-Zirkzee"
2023,"Bournemouth","Premier League","Jaidon Anthony","ENG","MF,FW","22",1999,14,30,17,15,9,6,8,24,33.3,16,30,3,27,10,40,19,0,"https://fbref.com/en/players/e4238fb1/Jaidon-Anthony"
2023,"Bournemouth","Premier League","Owen Bevan","WAL","DF","18",2003,0.1,0,0,0,0,0,0,0,NA,0,0,0,0,0,0,0,0,"https://fbref.com/en/players/87966294/Owen-Bevan"
2023,"Bournemouth","Premier League","Philip Billing","DEN","MF,FW","26",1996,30.7,63,36,21,33,9,11,40,27.5,29,48,8,40,31,94,58,1,"https://fbref.com/en/players/d328a254/Philip-Billing"
2023,"Bournemouth","Premier League","David Brooks","WAL","FW,MF","25",1997,1.9,1,0,1,0,0,0,1,0,1,2,0,2,2,3,5,0,"https://fbref.com/en/players/dc4cae05/David-Brooks"
2023,"Bournemouth","Premier League","Ryan Christie","SCO","MF,FW","27",1995,20.4,34,22,10,23,1,14,49,28.6,35,16,4,12,26,60,20,0,"https://fbref.com/en/players/26ce2263/Ryan-Christie"
2023,"Bournemouth","Premier League","Lewis Cook","ENG","MF","25",1997,19.1,37,22,10,22,5,18,42,42.9,24,29,10,19,23,60,31,0,"https://fbref.com/en/players/2afc7272/Lewis-Cook"
2023,"Bournemouth","Premier League","Siriki Dembélé","CIV","FW,MF","25",1996,1.2,3,1,2,1,0,0,1,0,1,1,0,1,1,4,1,0,"https://fbref.com/en/players/11f54bd5/Siriki-Dembele"
2023,"Bournemouth","Premier League","Ryan Fredericks","ENG","DF","29",1992,5.9,3,2,2,0,1,1,4,25,3,7,2,5,1,4,27,0,"https://fbref.com/en/players/c067631c/Ryan-Fredericks"
2023,"Bournemouth","Premier League","Hamed Junior Traorè","CIV","FW,MF","22",2000,4.7,17,11,5,9,3,6,18,33.3,12,9,0,9,2,19,1,0,"https://fbref.com/en/players/570bb4b9/Hamed-Junior-Traore"
2023,"Bournemouth","Premier League","Lloyd Kelly","ENG","DF","23",1998,22.7,33,18,23,9,1,13,19,68.4,6,26,15,11,26,59,101,1,"https://fbref.com/en/players/f31def1e/Lloyd-Kelly"
2023,"Bournemouth","Premier League","Jefferson Lerma","COL","MF","27",1994,36.1,50,30,23,23,4,20,45,44.4,25,32,15,17,47,97,91,1,"https://fbref.com/en/players/9b5ce51a/Jefferson-Lerma"
2023,"Bournemouth","Premier League","Jamal Lowe","JAM","MF,FW","28",1994,0.1,0,0,0,0,0,0,0,NA,0,0,0,0,0,0,0,0,"https://fbref.com/en/players/b2856bc0/Jamal-Lowe"
2023,"Bournemouth","Premier League","Emiliano Marcondes","DEN","MF","27",1995,0.1,0,0,0,0,0,0,0,NA,0,0,0,0,0,0,1,0,"https://fbref.com/en/players/4d960fc3/Emiliano-Marcondes"
2023,"Bournemouth","Premier League","Chris Mepham","WAL","DF","24",1997,24.4,45,22,37,8,0,19,30,63.3,11,40,27,13,30,75,152,0,"https://fbref.com/en/players/fed96827/Chris-Mepham"
2023,"Bournemouth","Premier League","Kieffer Moore","WAL","FW","29",1992,14.2,14,11,2,9,3,5,16,31.3,11,12,5,7,1,15,26,0,"https://fbref.com/en/players/01ce9e70/Kieffer-Moore"
2023,"Bournemouth","Premier League","Neto","BRA","GK","33",1989,26.5,3,1,3,0,0,3,3,100,0,0,0,0,0,3,10,3,"https://fbref.com/en/players/a9dc785c/Neto"
2023,"Bournemouth","Premier League","Dango Ouattara","BFA","MF,FW","20",2002,13.8,28,15,20,6,2,13,32,40.6,19,20,3,17,13,41,29,1,"https://fbref.com/en/players/2f9e4435/Dango-Ouattara"
2023,"Bournemouth","Premier League","Ben Pearson","ENG","MF","27",1995,3.2,7,3,3,3,1,1,3,33.3,2,4,0,4,2,9,6,0,"https://fbref.com/en/players/a6b461e7/Ben-Pearson"
2023,"Bournemouth","Premier League","Joe Rothwell","ENG","MF","27",1995,11.3,20,13,7,12,1,7,21,33.3,14,14,3,11,9,29,7,0,"https://fbref.com/en/players/10a10454/Joe-Rothwell"
2023,"Bournemouth","Premier League","Antoine Semenyo","GHA","FW,MF","22",2000,2.9,1,0,0,0,1,1,6,16.7,5,10,1,9,2,3,4,0,"https://fbref.com/en/players/efd2ec23/Antoine-Semenyo"
2023,"Bournemouth","Premier League","Marcos Senesi","ARG","DF","25",1997,27.7,50,35,28,22,0,23,43,53.5,20,38,20,18,43,93,146,2,"https://fbref.com/en/players/35141f4c/Marcos-Senesi"
2023,"Bournemouth","Premier League","Adam Smith","ENG","DF","31",1991,32.7,49,29,27,19,3,29,60,48.3,31,30,13,17,25,74,81,1,"https://fbref.com/en/players/20b104bc/Adam-Smith"
2023,"Bournemouth","Premier League","Dominic Solanke","ENG","FW,MF","24",1997,31.8,15,9,8,3,4,5,22,22.7,17,26,7,19,6,21,46,0,"https://fbref.com/en/players/e77dc3b2/Dominic-Solanke"
2023,"Bournemouth","Premier League","Jack Stacey","ENG","DF","26",1996,3.3,5,4,3,1,1,2,5,40,3,3,1,2,5,10,15,0,"https://fbref.com/en/players/558807c0/Jack-Stacey"
2023,"Bournemouth","Premier League","Junior Stanislas","ENG","MF","32",1989,0.7,0,0,0,0,0,0,0,NA,0,2,1,1,0,0,0,0,"https://fbref.com/en/players/6992791d/Junior-Stanislas"
2023,"Bournemouth","Premier League","Jack Stephens","ENG","DF","28",1994,13,15,11,10,4,1,6,10,60,4,23,16,7,16,31,53,0,"https://fbref.com/en/players/6adbc307/Jack-Stephens"
2023,"Bournemouth","Premier League","Marcus Tavernier","ENG","MF,FW","23",1999,19.4,33,22,19,11,3,11,32,34.4,21,25,4,21,9,42,23,0,"https://fbref.com/en/players/5c0da4a4/Marcus-Tavernier"
2023,"Bournemouth","Premier League","Mark Travers","IRL","GK","23",1999,11.5,0,0,0,0,0,0,0,NA,0,1,0,1,0,0,6,0,"https://fbref.com/en/players/fe558029/Mark-Travers"
2023,"Bournemouth","Premier League","Matías Viña","URU","DF","24",1997,5.1,19,11,9,8,2,14,30,46.7,16,13,1,12,4,23,22,0,"https://fbref.com/en/players/08eb3b58/Matias-Vina"
2023,"Bournemouth","Premier League","Illia Zabarnyi","UKR","DF","19",2002,3.3,4,2,4,0,0,3,7,42.9,4,7,2,5,3,7,14,0,"https://fbref.com/en/players/88968486/Illia-Zabarnyi"
2023,"Bournemouth","Premier League","Jordan Zemura","ZIM","DF","22",1999,16.2,39,24,24,14,1,23,43,53.5,20,31,9,22,16,55,32,0,"https://fbref.com/en/players/e8271ad9/Jordan-Zemura"
2023,"Brentford","Premier League","Kristoffer Ajer","NOR","DF","24",1998,8.5,11,8,5,4,2,9,16,56.3,7,6,5,1,7,18,22,0,"https://fbref.com/en/players/a8c0acb7/Kristoffer-Ajer"
2023,"Brentford","Premier League","Shandon Baptiste","GRN","MF","24",1998,6.9,15,9,6,6,3,7,17,41.2,10,10,2,8,7,22,10,0,"https://fbref.com/en/players/2886c9b5/Shandon-Baptiste"
2023,"Brentford","Premier League","Mads Bech Sørensen","DEN","DF,MF","23",1999,0.2,0,0,0,0,0,0,0,NA,0,0,0,0,1,1,1,0,"https://fbref.com/en/players/30db8574/Mads-Bech-Sorensen"
2023,"Brentford","Premier League","Sergi Canós","ESP","FW,DF","25",1997,0.9,0,0,0,0,0,0,2,0,2,3,1,2,0,0,1,0,"https://fbref.com/en/players/1137759d/Sergi-Canos"
2023,"Brentford","Premier League","Mikkel Damsgaard","DEN","MF,FW","22",2000,11,31,21,13,13,5,15,42,35.7,27,20,2,18,10,41,14,0,"https://fbref.com/en/players/215f3907/Mikkel-Damsgaard"
2023,"Brentford","Premier League","Josh Dasilva","ENG","MF","23",1998,15.4,18,9,6,6,6,6,16,37.5,10,22,6,16,5,23,7,1,"https://fbref.com/en/players/60344e4f/Josh-Dasilva"
2023,"Brentford","Premier League","Halil Dervişoğlu","TUR","MF","22",1999,0.1,0,0,0,0,0,0,1,0,1,0,0,0,0,0,0,0,"https://fbref.com/en/players/9d8cf204/Halil-Dervisoglu"
2023,"Brentford","Premier League","Saman Ghoddos","IRN","MF,FW","28",1993,1.5,2,1,0,1,1,1,3,33.3,2,5,1,4,4,6,2,0,"https://fbref.com/en/players/f7b1d4e0/Saman-Ghoddos"
2023,"Brentford","Premier League","Rico Henry","ENG","DF","25",1997,36,57,31,20,28,9,22,41,53.7,19,29,8,21,30,87,84,1,"https://fbref.com/en/players/8a3c1dc7/Rico-Henry"
2023,"Brentford","Premier League","Aaron Hickey","SCO","DF","20",2002,21.3,38,26,27,11,0,18,32,56.3,14,18,7,11,17,55,32,1,"https://fbref.com/en/players/1780bb4a/Aaron-Hickey"
2023,"Brentford","Premier League","Vitaly Janelt","GER","MF,DF","24",1998,24.5,54,27,20,24,10,21,49,42.9,28,29,9,20,29,83,26,0,"https://fbref.com/en/players/8449d35e/Vitaly-Janelt"
2023,"Brentford","Premier League","Pontus Jansson","SWE","DF","31",1991,8,5,3,4,1,0,3,5,60,2,13,9,4,9,14,38,0,"https://fbref.com/en/players/172e52d8/Pontus-Jansson"
2023,"Brentford","Premier League","Mathias Jensen","DEN","MF","26",1996,31.1,70,35,28,30,12,34,97,35.1,63,54,5,49,32,102,24,1,"https://fbref.com/en/players/0f134faf/Mathias-Jensen"
2023,"Brentford","Premier League","Mathias Jørgensen","DEN","DF","32",1990,12.3,17,8,9,8,0,9,21,42.9,12,19,12,7,16,33,39,1,"https://fbref.com/en/players/0db5d2c8/Mathias-Jorgensen"
2023,"Brentford","Premier League","Keane Lewis-Potter","ENG","FW,MF","21",2001,3.6,1,0,0,1,0,0,0,NA,0,5,1,4,0,1,2,0,"https://fbref.com/en/players/41f08ac8/Keane-Lewis-Potter"
2023,"Brentford","Premier League","Bryan Mbeumo","CMR","FW","22",1999,32.3,26,18,5,13,8,8,42,19,34,24,1,23,13,39,21,0,"https://fbref.com/en/players/6afaebf2/Bryan-Mbeumo"
2023,"Brentford","Premier League","Ben Mee","ENG","DF","32",1989,36.3,45,24,28,13,4,20,37,54.1,17,54,42,12,48,93,122,1,"https://fbref.com/en/players/8df7a2fb/Ben-Mee"
2023,"Brentford","Premier League","Christian Nørgaard","DEN","MF","28",1994,19.6,52,30,21,29,2,18,48,37.5,30,32,9,23,34,86,41,2,"https://fbref.com/en/players/df0a4c90/Christian-Norgaard"
2023,"Brentford","Premier League","Frank Onyeka","NGA","MF","24",1998,9.4,19,14,11,7,1,10,25,40,15,16,3,13,10,29,16,0,"https://fbref.com/en/players/2944f86f/Frank-Onyeka"
2023,"Brentford","Premier League","Ethan Pinnock","JAM","DF","29",1993,30,52,28,33,12,7,18,24,75,6,41,31,10,35,87,215,2,"https://fbref.com/en/players/e541326e/Ethan-Pinnock"
2023,"Brentford","Premier League","David Raya","ESP","GK","26",1995,38,0,0,0,0,0,0,2,0,2,1,0,1,1,1,10,2,"https://fbref.com/en/players/98ea5115/David-Raya"
2023,"Brentford","Premier League","Mads Roerslev","DEN","DF","23",1999,12.3,22,12,19,3,0,16,33,48.5,17,14,5,9,9,31,38,0,"https://fbref.com/en/players/57c94db2/Mads-Roerslev"
2023,"Brentford","Premier League","Kevin Schade","GER","FW","20",2001,8.1,12,8,7,2,3,5,10,50,5,7,0,7,4,16,6,0,"https://fbref.com/en/players/52afb588/Kevin-Schade"
2023,"Brentford","Premier League","Ivan Toney","ENG","FW","26",1996,32.8,23,13,4,9,10,7,23,30.4,16,24,9,15,14,37,36,0,"https://fbref.com/en/players/e09f279b/Ivan-Toney"
2023,"Brentford","Premier League","Yoane Wissa","COD","FW","25",1996,17.8,17,12,4,7,6,6,13,46.2,7,10,0,10,6,23,15,0,"https://fbref.com/en/players/2500cef9/Yoane-Wissa"
2023,"Brest","Ligue 1","Taïryk Arconte","FRA","FW","18",2003,1.4,1,1,0,0,1,0,3,0,3,1,0,1,0,1,2,0,"https://fbref.com/en/players/c5e6c017/Tairyk-Arconte"
2023,"Brest","Ligue 1","Youcef Belaïli","ALG","FW,MF","30",1992,4,5,2,3,2,0,2,7,28.6,5,2,0,2,1,6,1,0,"https://fbref.com/en/players/1a248246/Youcef-Belaili"
2023,"Brest","Ligue 1","Haris Belkebla","ALG","MF","28",1994,29.5,80,48,35,40,5,44,85,51.8,41,32,6,26,52,132,21,3,"https://fbref.com/en/players/2b1bed19/Haris-Belkebla"
2023,"Brest","Ligue 1","Marco Bizot","NED","GK","31",1991,37,0,0,0,0,0,0,1,0,1,1,0,1,0,0,24,4,"https://fbref.com/en/players/3d214e5f/Marco-Bizot"
2023,"Brest","Ligue 1","Joaquín Blázquez","ARG","GK","21",2001,1,0,0,0,0,0,0,0,NA,0,0,0,0,0,0,2,0,"https://fbref.com/en/players/6a9e4913/Joaquin-Blazquez"
2023,"Brest","Ligue 1","Lilian Brassier","FRA","DF","22",1999,34.4,42,30,31,8,3,23,32,71.9,9,42,19,23,53,95,132,1,"https://fbref.com/en/players/5b146df3/Lilian-Brassier"
2023,"Brest","Ligue 1","Mahdi Camara","FRA","MF","24",1998,20.2,63,36,18,38,7,25,43,58.1,18,35,4,31,40,103,16,0,"https://fbref.com/en/players/8577e60a/Mahdi-Camara"
2023,"Brest","Ligue 1","Axel Camblan","FRA","FW,MF","18",2003,0.8,2,2,1,1,0,0,1,0,1,0,0,0,0,2,0,0,"https://fbref.com/en/players/9f4a940f/Axel-Camblan"
2023,"Brest","Ligue 1","Irvin Cardona","FRA","FW,MF","24",1997,2.6,2,0,1,1,0,0,3,0,3,3,0,3,2,4,2,0,"https://fbref.com/en/players/5e080f73/Irvin-Cardona"
2023,"Brest","Ligue 1","Brendan Chardonnet","FRA","DF","27",1994,27.7,45,27,27,18,0,20,38,52.6,18,40,19,21,63,108,86,1,"https://fbref.com/en/players/16aa7d4c/Brendan-Chardonnet"
2023,"Brest","Ligue 1","Achraf Dari","MAR","DF","23",1999,14.6,21,14,15,5,1,14,20,70,6,16,10,6,19,40,65,2,"https://fbref.com/en/players/5069b796/Achraf-Dari"
2023,"Brest","Ligue 1","Romain Del Castillo","FRA","MF,FW","26",1996,15.8,39,24,13,17,9,16,36,44.4,20,14,1,13,11,50,5,0,"https://fbref.com/en/players/0be95d34/Romain-Del-Castillo"
2023,"Brest","Ligue 1","Karamoko Dembele","SCO","FW,MF","19",2003,2,2,0,1,1,0,2,2,100,0,1,0,1,1,3,0,0,"https://fbref.com/en/players/7304f3b1/Karamoko-Dembele"
2023,"Brest","Ligue 1","Jean-Kevin Duverne","FRA","DF","25",1997,27.9,72,38,44,24,4,42,73,57.5,31,33,5,28,28,100,65,1,"https://fbref.com/en/players/0cbc8baa/Jean-Kevin-Duverne"
2023,"Brest","Ligue 1","Alberth Elis","HON","MF,FW","26",1996,2.9,4,3,1,2,1,1,7,14.3,6,1,0,1,1,5,2,0,"https://fbref.com/en/players/104b4ad3/Alberth-Elis"
2023,"Brest","Ligue 1","Noah Fadiga","SEN","DF","22",1999,14.5,30,21,18,9,3,14,26,53.8,12,17,7,10,26,56,18,0,"https://fbref.com/en/players/83f03b07/Noah-Fadiga"
2023,"Brest","Ligue 1","Christophe Hérelle","MTQ","DF","29",1992,11.8,10,4,7,2,1,4,13,30.8,9,16,11,5,20,30,48,0,"https://fbref.com/en/players/3681cfff/Christophe-Herelle"
2023,"Brest","Ligue 1","Franck Honorat","FRA","FW,MF","25",1996,28.2,41,29,20,8,13,19,34,55.9,15,22,2,20,21,62,18,0,"https://fbref.com/en/players/db7849ca/Franck-Honorat"
2023,"Brest","Ligue 1","Kenny Lala","FRA","DF","30",1991,15.7,36,19,19,15,2,22,38,57.9,16,15,5,10,21,57,28,0,"https://fbref.com/en/players/770d7eb8/Kenny-Lala"
2023,"Brest","Ligue 1","Jérémy Le Douaron","FRA","MF,FW","24",1998,23,15,9,5,9,1,3,27,11.1,24,29,2,27,11,26,30,0,"https://fbref.com/en/players/88c4d190/Jeremy-Le-Douaron"
2023,"Brest","Ligue 1","Pierre Lees-Melou","FRA","MF","29",1993,30.7,97,55,55,37,5,57,123,46.3,66,48,13,35,52,149,46,1,"https://fbref.com/en/players/f5044e54/Pierre-Lees-Melou"
2023,"Brest","Ligue 1","Félix Lemaréchal","CIV","MF","18",2003,3.2,5,5,2,1,2,0,3,0,3,6,0,6,1,6,2,0,"https://fbref.com/en/players/8ca9415f/Felix-Lemarechal"
2023,"Brest","Ligue 1","Banzouzi Locko","FRA","DF","20",2002,3,4,3,2,1,1,2,3,66.7,1,4,0,4,2,6,13,0,"https://fbref.com/en/players/40221fa7/Banzouzi-Locko"
2023,"Brest","Ligue 1","Hugo Magnetti","FRA","MF","24",1998,18.8,43,27,18,23,2,23,63,36.5,40,21,1,20,25,68,12,0,"https://fbref.com/en/players/d4d35152/Hugo-Magnetti"
2023,"Brest","Ligue 1","Hianga Mananga Mbock","FRA","MF","22",1999,0.2,0,0,0,0,0,0,1,0,1,0,0,0,0,0,0,0,"https://fbref.com/en/players/0f86995c/Hianga-Mananga-Mbock"
2023,"Brest","Ligue 1","Steve Mounié","BEN","FW","27",1994,18.4,13,5,1,7,5,5,14,35.7,9,18,7,11,3,16,20,0,"https://fbref.com/en/players/19ba6c6d/Steve-Mounie"
2023,"Brest","Ligue 1","Mathias Pereira Lage","POR","MF,FW","25",1996,14,20,7,5,14,1,11,29,37.9,18,10,1,9,14,34,12,0,"https://fbref.com/en/players/8846a40f/Mathias-Pereira-Lage"
2023,"Brest","Ligue 1","Islam Slimani","ALG","FW","34",1988,11,5,3,2,2,1,0,3,0,3,2,0,2,1,6,11,0,"https://fbref.com/en/players/ffec9769/Islam-Slimani"
2023,"Brest","Ligue 1","Jere Uronen","FIN","DF","28",1994,3.3,8,5,4,4,0,7,12,58.3,5,6,2,4,7,15,5,0,"https://fbref.com/en/players/d75f3980/Jere-Uronen"
2023,"Brighton","Premier League","Yasin Ayari","SWE","MF","18",2003,0.7,2,2,1,1,0,0,4,0,4,1,0,1,0,2,0,0,"https://fbref.com/en/players/f173303a/Yasin-Ayari"
2023,"Brighton","Premier League","Facundo Buonanotte","ARG","FW,MF","17",2004,6.3,2,1,1,1,0,1,22,4.5,21,5,2,3,4,6,3,0,"https://fbref.com/en/players/468a7a91/Facundo-Buonanotte"
2023,"Brighton","Premier League","Moisés Caicedo","ECU","MF","20",2001,34.9,100,50,41,47,12,40,68,58.8,28,43,7,36,56,156,31,3,"https://fbref.com/en/players/16264a81/Moises-Caicedo"
2023,"Brighton","Premier League","Julio César Enciso","PAR","FW,MF","18",2004,9,13,4,3,6,4,8,13,61.5,5,9,0,9,4,17,2,0,"https://fbref.com/en/players/9cfbad36/Julio-Cesar-Enciso"
2023,"Brighton","Premier League","Levi Colwill","ENG","DF","19",2003,13.6,8,7,4,4,0,4,9,44.4,5,5,3,2,15,23,37,1,"https://fbref.com/en/players/700783e7/Levi-Colwill"
2023,"Brighton","Premier League","Lewis Dunk","ENG","DF","30",1991,36,30,19,19,9,2,18,41,43.9,23,37,27,10,34,64,81,1,"https://fbref.com/en/players/282f75f3/Lewis-Dunk"
2023,"Brighton","Premier League","Pervis Estupiñán","ECU","DF","24",1998,29.7,61,31,36,19,6,35,60,58.3,25,30,8,22,37,98,37,1,"https://fbref.com/en/players/d38fdf53/Pervis-Estupinan"
2023,"Brighton","Premier League","Evan Ferguson","IRL","FW","17",2004,10.6,6,3,1,3,2,1,7,14.3,6,11,1,10,2,8,6,0,"https://fbref.com/en/players/4596da74/Evan-Ferguson"
2023,"Brighton","Premier League","Billy Gilmour","SCO","MF","21",2001,5.6,5,2,2,2,1,2,8,25,6,5,2,3,6,11,5,0,"https://fbref.com/en/players/df10e27c/Billy-Gilmour"
2023,"Brighton","Premier League","Pascal Groß","GER","MF,DF","31",1991,36,59,38,23,27,9,25,55,45.5,30,32,10,22,13,72,21,1,"https://fbref.com/en/players/8aec0537/Pascal-Gross"
2023,"Brighton","Premier League","Jan Paul van Hecke","NED","DF","22",2000,3.3,8,6,3,4,1,5,5,100,0,8,5,3,6,14,9,0,"https://fbref.com/en/players/4fd08daa/Jan-Paul-van-Hecke"
2023,"Brighton","Premier League","Jack Hinshelwood","ENG","FW","17",2005,0,1,0,1,0,0,0,0,NA,0,0,0,0,0,1,0,0,"https://fbref.com/en/players/e98211e7/Jack-Hinshelwood"
2023,"Brighton","Premier League","Adam Lallana","ENG","MF,FW","34",1988,8,9,4,6,2,1,0,7,0,7,6,0,6,2,11,1,0,"https://fbref.com/en/players/99813635/Adam-Lallana"
2023,"Brighton","Premier League","Tariq Lamptey","GHA","DF","21",2000,5,11,6,6,4,1,5,7,71.4,2,7,3,4,7,18,2,0,"https://fbref.com/en/players/f4e433d4/Tariq-Lamptey"
2023,"Brighton","Premier League","Alexis Mac Allister","ARG","MF","23",1998,32.1,70,39,22,40,8,34,70,48.6,36,26,2,24,22,92,10,1,"https://fbref.com/en/players/83d074ff/Alexis-Mac-Allister"
2023,"Brighton","Premier League","Solly March","ENG","FW,DF","28",1994,30.2,53,31,16,17,20,8,28,28.6,20,34,3,31,24,77,32,0,"https://fbref.com/en/players/bb5fbd2b/Solly-March"
2023,"Brighton","Premier League","Kaoru Mitoma","JPN","FW,MF","25",1997,25.8,44,27,15,16,13,20,41,48.8,21,25,0,25,17,61,10,0,"https://fbref.com/en/players/74618572/Kaoru-Mitoma"
2023,"Brighton","Premier League","Andrew Moran","IRL","FW","18",2003,0.1,0,0,0,0,0,0,0,NA,0,1,0,1,0,0,0,0,"https://fbref.com/en/players/c4720845/Andrew-Moran"
2023,"Brighton","Premier League","Enock Mwepu","ZAM","FW,MF","24",1998,2.4,10,5,1,6,3,3,4,75,1,3,1,2,1,11,1,0,"https://fbref.com/en/players/1d5cab82/Enock-Mwepu"
2023,"Brighton","Premier League","Odeluga Offiah","ENG","DF","19",2002,0.3,1,1,1,0,0,0,2,0,2,0,0,0,0,1,1,0,"https://fbref.com/en/players/65c3efa2/Odeluga-Offiah"
2023,"Brighton","Premier League","Cameron Peupion","AUS","MF","19",2002,0.1,0,0,0,0,0,0,0,NA,0,0,0,0,0,0,0,0,"https://fbref.com/en/players/0bdeb013/Cameron-Peupion"
2023,"Brighton","Premier League","Robert Sánchez","ESP","GK","24",1997,23,1,0,1,0,0,0,0,NA,0,0,0,0,3,4,9,2,"https://fbref.com/en/players/6a713852/Robert-Sanchez"
2023,"Brighton","Premier League","Jeremy Sarmiento","ECU","MF","20",2002,2,6,3,4,1,1,2,5,40,3,2,0,2,1,7,0,0,"https://fbref.com/en/players/ac0d576d/Jeremy-Sarmiento"
2023,"Brighton","Premier League","Jason Steele","ENG","GK","31",1990,15,0,0,0,0,0,0,1,0,1,0,0,0,0,0,6,1,"https://fbref.com/en/players/28300a16/Jason-Steele"
2023,"Brighton","Premier League","Leandro Trossard","BEL","FW,MF","27",1994,14.6,10,6,7,1,2,1,8,12.5,7,17,0,17,6,16,1,0,"https://fbref.com/en/players/38ceb24a/Leandro-Trossard"
2023,"Brighton","Premier League","Deniz Undav","GER","FW,MF","26",1996,7,7,4,2,2,3,2,8,25,6,4,1,3,0,7,1,0,"https://fbref.com/en/players/dd549382/Deniz-Undav"
2023,"Brighton","Premier League","Joël Veltman","NED","DF","30",1992,24.3,62,32,44,14,4,37,57,64.9,20,27,8,19,19,81,51,0,"https://fbref.com/en/players/dad4b285/Joel-Veltman"
2023,"Brighton","Premier League","Adam Webster","ENG","DF","27",1995,22.1,22,12,10,9,3,11,19,57.9,8,30,19,11,19,41,55,4,"https://fbref.com/en/players/c40b6180/Adam-Webster"
2023,"Brighton","Premier League","Danny Welbeck","ENG","FW","31",1990,20.6,15,7,0,7,8,4,11,36.4,7,24,2,22,5,20,20,0,"https://fbref.com/en/players/ce5143da/Danny-Welbeck"
2023,"Celta Vigo","La Liga","Joseph Aidoo","GHA","DF","26",1995,34.7,51,36,33,17,1,16,28,57.1,12,26,14,12,31,82,150,0,"https://fbref.com/en/players/18abe173/Joseph-Aidoo"
2023,"Celta Vigo","La Liga","Iago Aspas","ESP","FW","34",1987,31.9,8,4,0,4,4,3,22,13.6,19,10,1,9,7,15,23,0,"https://fbref.com/en/players/7dcf86f6/Iago-Aspas"
2023,"Celta Vigo","La Liga","Fran Beltrán","ESP","MF","23",1999,31.7,34,22,15,14,5,14,55,25.5,41,29,5,24,53,87,35,2,"https://fbref.com/en/players/ed5c5fa3/Fran-Beltran"
2023,"Celta Vigo","La Liga","Franco Cervi","ARG","MF,DF","28",1994,21,76,46,29,36,11,33,66,50,33,33,1,32,36,112,16,0,"https://fbref.com/en/players/5e1028e5/Franco-Cervi"
2023,"Celta Vigo","La Liga","Carlos Dominguez","ESP","DF","21",2001,1.2,1,1,0,1,0,1,2,50,1,1,1,0,0,1,7,0,"https://fbref.com/en/players/3521abfe/Carlos-Dominguez"
2023,"Celta Vigo","La Liga","Pablo Durán","ESP","MF,DF","21",2001,0.4,0,0,0,0,0,0,0,NA,0,2,1,1,1,1,2,0,"https://fbref.com/en/players/6db116ec/Pablo-Duran"
2023,"Celta Vigo","La Liga","Javi Galán","ESP","DF","27",1994,35.1,104,72,60,40,4,48,98,49,50,54,5,49,41,145,63,1,"https://fbref.com/en/players/a4b00319/Javi-Galan"
2023,"Celta Vigo","La Liga","Luca de la Torre","USA","MF","24",1998,16.5,28,19,11,14,3,12,32,37.5,20,22,1,21,9,37,6,0,"https://fbref.com/en/players/e9241b40/Luca-de-la-Torre"
2023,"Celta Vigo","La Liga","Hugo Mallo","ESP","DF","31",1991,24,53,29,34,14,5,28,42,66.7,14,28,7,21,24,77,73,0,"https://fbref.com/en/players/cb574619/Hugo-Mallo"
2023,"Celta Vigo","La Liga","Agustín Marchesín","ARG","GK","34",1988,19,0,0,0,0,0,0,1,0,1,0,0,0,0,0,7,0,"https://fbref.com/en/players/853b7c48/Agustin-Marchesin"
2023,"Celta Vigo","La Liga","Fernando Medrano","ESP","DF","22",2000,0.1,2,1,2,0,0,1,1,100,0,0,0,0,1,3,1,0,"https://fbref.com/en/players/d854c9d0/Fernando-Medrano"
2023,"Celta Vigo","La Liga","Óscar Mingueza","ESP","DF","23",1999,14.3,37,21,27,9,1,25,32,78.1,7,10,4,6,12,49,25,0,"https://fbref.com/en/players/056269d7/Oscar-Mingueza"
2023,"Celta Vigo","La Liga","Unai Núñez","ESP","DF","25",1997,35,47,35,29,15,3,18,34,52.9,16,27,17,10,72,119,135,1,"https://fbref.com/en/players/be170419/Unai-Nunez"
2023,"Celta Vigo","La Liga","Gonçalo Paciência","POR","FW,MF","27",1994,7.4,8,5,0,5,3,2,7,28.6,5,9,1,8,0,8,4,0,"https://fbref.com/en/players/962e54cb/Goncalo-Paciencia"
2023,"Celta Vigo","La Liga","Carles Pérez","ESP","MF,FW","24",1998,23.8,39,23,12,17,10,22,66,33.3,44,29,3,26,6,45,9,0,"https://fbref.com/en/players/a8f21b9f/Carles-Perez"
2023,"Celta Vigo","La Liga","Óscar Rodríguez Arnaiz","ESP","MF","24",1998,19.7,32,25,12,15,5,13,28,46.4,15,16,2,14,24,56,15,0,"https://fbref.com/en/players/19709006/Oscar-Rodriguez-Arnaiz"
2023,"Celta Vigo","La Liga","Miguel Rodríguez","ESP","MF,FW","19",2003,2.8,7,5,4,3,0,4,11,36.4,7,6,0,6,1,8,3,0,"https://fbref.com/en/players/958d67bb/Miguel-Rodriguez"
2023,"Celta Vigo","La Liga","Haris Seferović","SUI","FW","30",1992,9.9,6,3,1,4,1,3,8,37.5,5,7,1,6,1,7,6,1,"https://fbref.com/en/players/a45eac1f/Haris-Seferovic"
2023,"Celta Vigo","La Liga","Augusto Solari","ARG","MF","30",1992,2.9,10,6,6,3,1,3,11,27.3,8,5,0,5,4,14,3,0,"https://fbref.com/en/players/3ca6106c/Augusto-Solari"
2023,"Celta Vigo","La Liga","Hugo Sotelo","ESP","MF","18",2003,0.2,0,0,0,0,0,0,0,NA,0,0,0,0,0,0,0,0,"https://fbref.com/en/players/3aa74860/Hugo-Sotelo"
2023,"Celta Vigo","La Liga","Jørgen Strand Larsen","NOR","FW","22",2000,18.9,15,7,3,5,7,7,30,23.3,23,14,5,9,3,18,24,0,"https://fbref.com/en/players/f553b2b3/Jorgen-Strand-Larsen"
2023,"Celta Vigo","La Liga","Williot Swedberg","SWE","MF","18",2004,0.6,3,1,1,0,2,0,0,NA,0,2,0,2,0,3,1,0,"https://fbref.com/en/players/184fe4b2/Williot-Swedberg"
2023,"Celta Vigo","La Liga","Renato Tapia","PER","MF,DF","27",1995,16.1,47,25,21,21,5,18,37,48.6,19,29,11,18,19,66,37,0,"https://fbref.com/en/players/34269bdf/Renato-Tapia"
2023,"Celta Vigo","La Liga","Kevin Vázquez","ESP","DF,MF","29",1993,4.9,13,8,5,7,1,8,12,66.7,4,4,1,3,2,15,8,0,"https://fbref.com/en/players/ee923664/Kevin-Vazquez"
2023,"Celta Vigo","La Liga","Gabriel Veiga","ESP","MF","20",2002,25.5,43,19,14,25,4,16,52,30.8,36,30,3,27,21,64,6,0,"https://fbref.com/en/players/35a6e5c7/Gabriel-Veiga"
2023,"Celta Vigo","La Liga","Iván Villar","ESP","GK","25",1997,19,0,0,0,0,0,0,1,0,1,0,0,0,0,0,7,0,"https://fbref.com/en/players/cde52ef5/Ivan-Villar"
2023,"Chelsea","Premier League","Kepa Arrizabalaga","ESP","GK","27",1994,28.5,2,2,2,0,0,2,3,66.7,1,0,0,0,1,3,16,2,"https://fbref.com/en/players/28d596a0/Kepa-Arrizabalaga"
2023,"Chelsea","Premier League","Pierre-Emerick Aubameyang","GAB","FW","33",1989,6.2,1,0,1,0,0,0,1,0,1,2,0,2,2,3,4,2,"https://fbref.com/en/players/d5dd5f1f/Pierre-Emerick-Aubameyang"
2023,"Chelsea","Premier League","César Azpilicueta","ESP","DF","32",1989,17,43,25,23,15,5,22,37,59.5,15,26,5,21,19,62,54,1,"https://fbref.com/en/players/53cad200/Cesar-Azpilicueta"
2023,"Chelsea","Premier League","Benoît Badiashile","FRA","DF","21",2001,10.1,14,8,10,4,0,9,14,64.3,5,5,2,3,16,30,34,1,"https://fbref.com/en/players/06df8256/Benoit-Badiashile"
2023,"Chelsea","Premier League","Armando Broja","ALB","FW","20",2001,3.3,4,1,0,3,1,1,1,100,0,10,1,9,1,5,1,0,"https://fbref.com/en/players/97220da2/Armando-Broja"
2023,"Chelsea","Premier League","Trevoh Chalobah","ENG","DF","23",1999,17.9,31,20,22,6,3,24,34,70.6,10,17,7,10,24,55,56,1,"https://fbref.com/en/players/5515376c/Trevoh-Chalobah"
2023,"Chelsea","Premier League","Ben Chilwell","ENG","DF,MF","25",1996,15.6,21,17,12,8,1,13,25,52,12,21,2,19,18,39,26,0,"https://fbref.com/en/players/d2424d1b/Ben-Chilwell"
2023,"Chelsea","Premier League","Carney Chukwuemeka","ENG","MF,FW","18",2003,3.9,13,7,7,6,0,3,5,60,2,7,0,7,6,19,1,0,"https://fbref.com/en/players/b2f9c73e/Carney-Chukwuemeka"
2023,"Chelsea","Premier League","Marc Cucurella","ESP","DF","24",1998,18.6,66,33,40,15,11,30,60,50,30,28,8,20,16,82,48,1,"https://fbref.com/en/players/1daec722/Marc-Cucurella"
2023,"Chelsea","Premier League","David Datro Fofana","CIV","FW","19",2002,0.8,3,1,1,1,1,1,1,100,0,1,0,1,0,3,0,0,"https://fbref.com/en/players/e82900ef/David-Datro-Fofana"
2023,"Chelsea","Premier League","João Félix","POR","FW,MF","22",1999,10.5,14,7,5,6,3,4,12,33.3,8,3,0,3,1,15,1,1,"https://fbref.com/en/players/8aafd64f/Joao-Felix"
2023,"Chelsea","Premier League","Enzo Fernández","ARG","MF","21",2001,17.2,45,27,25,17,3,21,56,37.5,35,32,2,30,16,61,12,1,"https://fbref.com/en/players/5ff4ab71/Enzo-Fernandez"
2023,"Chelsea","Premier League","Wesley Fofana","FRA","DF","21",2000,13.1,30,18,19,7,4,13,26,50,13,17,10,7,20,50,33,2,"https://fbref.com/en/players/132a82f1/Wesley-Fofana"
2023,"Chelsea","Premier League","Conor Gallagher","ENG","MF","22",2000,18,46,33,17,19,10,10,37,27,27,41,10,31,23,69,18,1,"https://fbref.com/en/players/c2731c10/Conor-Gallagher"
2023,"Chelsea","Premier League","Lewis Hall","ENG","DF","17",2004,7.3,23,12,19,4,0,15,22,68.2,7,8,0,8,11,34,11,1,"https://fbref.com/en/players/da011f18/Lewis-Hall"
2023,"Chelsea","Premier League","Kai Havertz","GER","FW,MF","23",1999,28.5,34,16,4,20,10,10,30,33.3,20,28,0,28,7,41,41,0,"https://fbref.com/en/players/fed7cb61/Kai-Havertz"
2023,"Chelsea","Premier League","Omari Hutchinson","ENG","FW","18",2003,0.3,0,0,0,0,0,0,0,NA,0,0,0,0,1,1,0,0,"https://fbref.com/en/players/bd9553e6/Omari-Hutchinson"
2023,"Chelsea","Premier League","Reece James","ENG","DF,MF","22",1999,13.8,31,20,10,18,3,15,19,78.9,4,17,2,15,12,43,23,0,"https://fbref.com/en/players/1265a93a/Reece-James"
2023,"Chelsea","Premier League","Jorginho","ITA","MF","30",1991,14.2,42,23,22,14,6,22,46,47.8,24,18,3,15,21,63,7,0,"https://fbref.com/en/players/45db685d/Jorginho"
2023,"Chelsea","Premier League","N'Golo Kanté","FRA","MF","31",1991,5.8,16,10,4,10,2,4,8,50,4,11,0,11,6,22,2,0,"https://fbref.com/en/players/b9fbae28/NGolo-Kante"
2023,"Chelsea","Premier League","Kalidou Koulibaly","SEN","DF","31",1991,20,45,31,34,8,3,26,40,65,14,30,13,17,29,74,77,0,"https://fbref.com/en/players/da974c7b/Kalidou-Koulibaly"
2023,"Chelsea","Premier League","Mateo Kovačić","CRO","MF","28",1994,19,36,24,16,14,6,14,36,38.9,22,10,1,9,19,55,16,0,"https://fbref.com/en/players/79c0821a/Mateo-Kovacic"
2023,"Chelsea","Premier League","Ruben Loftus-Cheek","ENG","MF,DF","26",1996,17.1,25,14,8,14,3,12,21,57.1,9,15,2,13,12,37,23,0,"https://fbref.com/en/players/e97fd090/Ruben-Loftus-Cheek"
2023,"Chelsea","Premier League","Noni Madueke","ENG","FW","20",2002,7.1,12,8,5,4,3,6,13,46.2,7,13,2,11,4,16,7,0,"https://fbref.com/en/players/bf34eebd/Noni-Madueke"
2023,"Chelsea","Premier League","Edouard Mendy","SEN","GK","30",1992,9.5,0,0,0,0,0,0,0,NA,0,0,0,0,0,0,3,3,"https://fbref.com/en/players/33887998/Edouard-Mendy"
2023,"Chelsea","Premier League","Mason Mount","ENG","MF,FW","23",1999,18.3,33,19,6,16,11,14,27,51.9,13,24,6,18,8,41,9,0,"https://fbref.com/en/players/9674002f/Mason-Mount"
2023,"Chelsea","Premier League","Mykhailo Mudryk","UKR","FW,MF","21",2001,7.3,11,9,2,4,5,4,13,30.8,9,7,1,6,0,11,3,0,"https://fbref.com/en/players/049a888d/Mykhailo-Mudryk"
2023,"Chelsea","Premier League","Christian Pulisic","USA","FW,DF","23",1998,9.1,11,6,3,6,2,3,5,60,2,8,1,7,4,15,4,0,"https://fbref.com/en/players/1bf33a9a/Christian-Pulisic"
2023,"Chelsea","Premier League","Thiago Silva","BRA","DF","37",1984,26.1,41,27,24,17,0,21,31,67.7,10,38,29,9,34,75,111,2,"https://fbref.com/en/players/86e7deaf/Thiago-Silva"
2023,"Chelsea","Premier League","Raheem Sterling","ENG","FW,MF","27",1994,21,18,10,5,4,9,8,14,57.1,6,17,0,17,2,20,5,0,"https://fbref.com/en/players/b400bde0/Raheem-Sterling"
2023,"Chelsea","Premier League","Denis Zakaria","SUI","MF","25",1996,4.6,9,5,5,2,2,2,8,25,6,4,1,3,3,12,10,0,"https://fbref.com/en/players/384d58d9/Denis-Zakaria"
2023,"Chelsea","Premier League","Hakim Ziyech","MAR","FW,MF","29",1993,7.3,20,12,12,5,3,4,9,44.4,5,8,0,8,5,25,5,1,"https://fbref.com/en/players/6622454d/Hakim-Ziyech"
2023,"Clermont Foot","Ligue 1","Jim Allevinah","GAB","DF,FW","27",1995,24.9,39,24,24,11,4,19,62,30.6,43,24,2,22,24,63,26,1,"https://fbref.com/en/players/1956b948/Jim-Allevinah"
2023,"Clermont Foot","Ligue 1","Komnen Andrić","SRB","FW","27",1995,16.1,13,5,2,7,4,2,15,13.3,13,8,1,7,8,21,13,0,"https://fbref.com/en/players/af3ddb2e/Komnen-Andric"
2023,"Clermont Foot","Ligue 1","Brandon Baiye","BEL","MF","21",2000,0.6,3,2,2,1,0,2,3,66.7,1,1,0,1,1,4,3,0,"https://fbref.com/en/players/7e3e825e/Brandon-Baiye"
2023,"Clermont Foot","Ligue 1","Jérémie Bela","ANG","DF,MF","29",1993,8.3,6,4,2,1,3,3,4,75,1,10,1,9,9,15,8,0,"https://fbref.com/en/players/5680bf3f/Jeremie-Bela"
2023,"Clermont Foot","Ligue 1","Jason Berthomier","FRA","MF","32",1990,0.3,0,0,0,0,0,0,0,NA,0,0,0,0,0,0,0,0,"https://fbref.com/en/players/03e91055/Jason-Berthomier"
2023,"Clermont Foot","Ligue 1","Jean-Claude Billong","CMR","MF","28",1993,0.3,0,0,0,0,0,0,0,NA,0,1,1,0,1,1,0,0,"https://fbref.com/en/players/a3e1d20d/Jean-Claude-Billong"
2023,"Clermont Foot","Ligue 1","Neto Borges","BRA","DF","25",1996,31.5,75,45,45,20,10,46,75,61.3,29,45,11,34,41,116,62,1,"https://fbref.com/en/players/9f936061/Neto-Borges"
2023,"Clermont Foot","Ligue 1","Maximiliano Caufriez","BEL","DF","25",1997,24.7,40,24,31,8,1,20,28,71.4,8,33,18,15,34,74,70,0,"https://fbref.com/en/players/c92c24f0/Maximiliano-Caufriez"
2023,"Clermont Foot","Ligue 1","Souleymane Cissé","FRA","DF","19",2002,0.4,1,1,1,0,0,1,1,100,0,1,1,0,1,2,2,0,"https://fbref.com/en/players/ff4d0258/Souleymane-Cisse"
2023,"Clermont Foot","Ligue 1","Baila Diallo","FRA","DF,MF","21",2001,1,1,0,1,0,0,0,0,NA,0,1,1,0,0,1,1,0,"https://fbref.com/en/players/fb55f63a/Baila-Diallo"
2023,"Clermont Foot","Ligue 1","Mory Diaw","SEN","GK","29",1993,37,0,0,0,0,0,0,4,0,4,0,0,0,2,2,13,5,"https://fbref.com/en/players/f41a69e6/Mory-Diaw"
2023,"Clermont Foot","Ligue 1","Ouparine Djoco","SEN","GK","24",1998,1,0,0,0,0,0,0,0,NA,0,0,0,0,0,0,1,0,"https://fbref.com/en/players/62124972/Ouparine-Djoco"
2023,"Clermont Foot","Ligue 1","Jodel Dossou","BEN","MF,DF","30",1992,2.9,7,4,3,2,2,4,4,100,0,2,1,1,1,8,0,0,"https://fbref.com/en/players/a1dbfcb1/Jodel-Dossou"
2023,"Clermont Foot","Ligue 1","Johan Gastien","FRA","MF","34",1988,28.9,62,34,30,23,9,38,111,34.2,73,37,7,30,36,98,25,1,"https://fbref.com/en/players/868eaba0/Johan-Gastien"
2023,"Clermont Foot","Ligue 1","Maxime Gonalons","FRA","MF","33",1989,16.1,52,32,25,21,6,25,53,47.2,28,21,1,20,20,72,7,1,"https://fbref.com/en/players/b8c1de25/Maxime-Gonalons"
2023,"Clermont Foot","Ligue 1","Saîf-Eddine Khaoui","TUN","MF","27",1995,22.5,47,28,14,25,8,15,47,31.9,32,17,2,15,33,80,8,0,"https://fbref.com/en/players/796b1c41/Saif-Eddine-Khaoui"
2023,"Clermont Foot","Ligue 1","Cheick Konaté","CIV","DF","18",2004,6.4,19,12,10,7,2,13,22,59.1,9,7,1,6,13,32,8,1,"https://fbref.com/en/players/1361e5bc/Cheick-Konate"
2023,"Clermont Foot","Ligue 1","Grejohn Kyei","FRA","FW","26",1995,24.8,16,7,2,9,5,4,13,30.8,9,14,3,11,6,22,22,0,"https://fbref.com/en/players/397ba086/Grejohn-Kyei"
2023,"Clermont Foot","Ligue 1","Yohann Magnin","FRA","MF","25",1997,26.7,89,54,37,45,7,54,106,50.9,52,50,12,38,25,114,46,0,"https://fbref.com/en/players/caa7aaea/Yohann-Magnin"
2023,"Clermont Foot","Ligue 1","Yanis Massolin","FRA","MF","19",2002,0.7,2,1,1,0,1,0,1,0,1,1,0,1,2,4,0,0,"https://fbref.com/en/players/6ea05ca7/Yanis-Massolin"
2023,"Clermont Foot","Ligue 1","Aïman Maurer","MAR","MF","17",2004,5.6,2,1,1,1,0,1,10,10,9,1,0,1,3,5,5,0,"https://fbref.com/en/players/87d31635/Aiman-Maurer"
2023,"Clermont Foot","Ligue 1","Arial Mendy","SEN","DF","27",1994,2.5,4,2,3,0,1,2,2,100,0,2,0,2,4,8,4,0,"https://fbref.com/en/players/9f0f4b49/Arial-Mendy"
2023,"Clermont Foot","Ligue 1","Florent Ogier","FRA","DF","33",1989,18.9,33,16,20,12,1,22,39,56.4,17,22,13,9,18,51,64,1,"https://fbref.com/en/players/6993927b/Florent-Ogier"
2023,"Clermont Foot","Ligue 1","Elba Rashani","KVX","MF,FW","29",1993,24,39,26,13,19,7,13,39,33.3,26,27,2,25,21,60,19,0,"https://fbref.com/en/players/25749008/Elba-Rashani"
2023,"Clermont Foot","Ligue 1","Muhammed Saracevic Cham","AUT","MF","21",2000,21.9,30,15,15,4,11,13,35,37.1,22,13,0,13,7,37,5,0,"https://fbref.com/en/players/f527a32c/Muhammed-Saracevic-Cham"
2023,"Clermont Foot","Ligue 1","Alidu Seidu","GHA","DF","22",2000,27.3,52,31,35,14,3,31,51,60.8,20,28,14,14,52,104,50,2,"https://fbref.com/en/players/cea59f02/Alidu-Seidu"
2023,"Clermont Foot","Ligue 1","Mateusz Wieteska","POL","DF","25",1997,34.6,41,23,28,13,0,19,33,57.6,14,44,28,16,56,97,97,4,"https://fbref.com/en/players/3ecc8c5f/Mateusz-Wieteska"
2023,"Clermont Foot","Ligue 1","Mehdi Zeffane","ALG","DF,MF","30",1992,7.3,12,7,5,7,0,4,21,19,17,14,6,8,22,34,12,0,"https://fbref.com/en/players/c8c02ac7/Mehdi-Zeffane"
2023,"Cremonese","Serie A","Christian Acella","ITA","MF","20",2002,0.2,1,0,1,0,0,0,2,0,2,0,0,0,0,1,0,0,"https://fbref.com/en/players/771a2cfe/Christian-Acella"
2023,"Cremonese","Serie A","Felix Afena-Gyan","GHA","FW,MF","19",2003,9.1,7,3,4,1,2,2,10,20,8,5,1,4,1,8,6,0,"https://fbref.com/en/players/0154d290/Felix-Afena-Gyan"
2023,"Cremonese","Serie A","Emanuel Aiwum","AUT","DF","21",2000,18.4,55,34,36,17,2,33,47,70.2,14,28,16,12,25,80,52,3,"https://fbref.com/en/players/d810c13b/Emanuel-Aiwum"
2023,"Cremonese","Serie A","Santiago Ascacíbar","ARG","MF","25",1997,8.1,29,14,17,10,2,14,35,40,21,14,2,12,13,42,11,0,"https://fbref.com/en/players/e26fcca3/Santiago-Ascacibar"
2023,"Cremonese","Serie A","Jaime Báez","URU","DF","27",1995,1.1,4,2,3,0,1,3,6,50,3,0,0,0,0,4,2,1,"https://fbref.com/en/players/dfd24c07/Jaime-Baez"
2023,"Cremonese","Serie A","Alberto Basso","ITA","MF","18",2004,0.2,0,0,0,0,0,0,0,NA,0,0,0,0,0,0,0,0,"https://fbref.com/en/players/2ce215f2/Alberto-Basso"
2023,"Cremonese","Serie A","Marco Benassi","ITA","MF","27",1994,11.1,26,15,9,11,6,15,24,62.5,9,13,1,12,12,38,19,0,"https://fbref.com/en/players/0000acda/Marco-Benassi"
2023,"Cremonese","Serie A","Matteo Bianchetti","ITA","DF","29",1993,23.7,32,19,21,9,2,20,32,62.5,12,31,17,14,20,52,111,0,"https://fbref.com/en/players/b3a20f18/Matteo-Bianchetti"
2023,"Cremonese","Serie A","Cristian Buonaiuto","ITA","MF,FW","29",1992,10.9,25,16,8,11,6,12,26,46.2,14,11,0,11,14,39,7,0,"https://fbref.com/en/players/f3a9fa26/Cristian-Buonaiuto"
2023,"Cremonese","Serie A","Marco Carnesecchi","ITA","GK","22",2000,27,1,1,1,0,0,1,2,50,1,0,0,0,0,1,11,2,"https://fbref.com/en/players/8ec56e62/Marco-Carnesecchi"
2023,"Cremonese","Serie A","Michele Castagnetti","ITA","MF","32",1989,15.7,46,21,20,24,2,18,54,33.3,36,14,4,10,15,61,22,0,"https://fbref.com/en/players/ad92526f/Michele-Castagnetti"
2023,"Cremonese","Serie A","Vlad Chiricheș","ROU","DF","32",1989,10.9,35,20,27,7,1,16,24,66.7,8,36,23,13,22,57,44,0,"https://fbref.com/en/players/c316607a/Vlad-Chiriches"
2023,"Cremonese","Serie A","Daniel Ciofani","ITA","FW","37",1985,11.8,6,3,1,2,3,4,7,57.1,3,7,1,6,2,8,10,0,"https://fbref.com/en/players/b09a3ecc/Daniel-Ciofani"
2023,"Cremonese","Serie A","Cyriel Dessers","NGA","FW","27",1994,17.6,11,4,4,4,3,2,6,33.3,4,14,2,12,3,14,5,0,"https://fbref.com/en/players/dcb38abe/Cyriel-Dessers"
2023,"Cremonese","Serie A","Samuel Di Carmine","ITA","FW,MF","33",1988,0.3,0,0,0,0,0,0,0,NA,0,0,0,0,0,0,0,0,"https://fbref.com/en/players/ef94dc2f/Samuel-Di-Carmine"
2023,"Cremonese","Serie A","Gonzalo Escalante","ARG","MF","29",1993,6.2,16,8,8,8,0,10,13,76.9,3,7,1,6,10,26,4,0,"https://fbref.com/en/players/3f79a1c8/Gonzalo-Escalante"
2023,"Cremonese","Serie A","Alex Ferrari","ITA","DF","28",1994,11.2,40,23,32,7,1,28,42,66.7,14,19,4,15,25,65,45,1,"https://fbref.com/en/players/d0dbca9f/Alex-Ferrari"
2023,"Cremonese","Serie A","Pablo Galdames Millán","CHI","MF","25",1996,8.2,14,10,8,3,3,5,33,15.2,28,13,2,11,10,24,13,0,"https://fbref.com/en/players/dd403465/Pablo-Galdames-Millan"
2023,"Cremonese","Serie A","Paolo Ghiglione","ITA","DF","25",1997,7.9,16,11,10,3,3,10,23,43.5,13,9,4,5,4,20,12,0,"https://fbref.com/en/players/71dc23da/Paolo-Ghiglione"
2023,"Cremonese","Serie A","Jack Hendry","SCO","DF","27",1995,2.4,0,0,0,0,0,0,1,0,1,2,1,1,1,1,7,0,"https://fbref.com/en/players/ffed43e3/Jack-Hendry"
2023,"Cremonese","Serie A","Luka Lochoshvili","GEO","DF","24",1998,20.4,45,19,30,11,4,22,31,71,9,31,10,21,22,67,89,0,"https://fbref.com/en/players/c8ad0857/Luka-Lochoshvili"
2023,"Cremonese","Serie A","Soualiho Meïté","FRA","MF","28",1994,26.3,47,31,25,15,7,22,46,47.8,24,27,6,21,27,74,36,0,"https://fbref.com/en/players/5cec2c74/Soualiho-Meite"
2023,"Cremonese","Serie A","Tommaso Milanese","ITA","MF","20",2002,0.3,0,0,0,0,0,0,0,NA,0,1,1,0,0,0,0,0,"https://fbref.com/en/players/b2561711/Tommaso-Milanese"
2023,"Cremonese","Serie A","David Okereke","NGA","FW,MF","24",1997,25.2,12,8,4,5,3,3,16,18.8,13,23,3,20,10,22,12,0,"https://fbref.com/en/players/d125f22f/David-Okereke"
2023,"Cremonese","Serie A","Charles Pickel","SUI","MF","25",1997,27.6,55,23,25,26,4,32,57,56.1,25,37,5,32,24,79,36,1,"https://fbref.com/en/players/f71ad8cb/Charles-Pickel"
2023,"Cremonese","Serie A","Giacomo Quagliata","ITA","DF","22",2000,7.8,10,8,7,1,2,5,11,45.5,6,7,2,5,11,21,8,0,"https://fbref.com/en/players/1b9c7401/Giacomo-Quagliata"
2023,"Cremonese","Serie A","Ionuț Radu","ROU","GK","25",1997,9,0,0,0,0,0,0,0,NA,0,0,0,0,0,0,1,3,"https://fbref.com/en/players/67f649be/Ionut-Radu"
2023,"Cremonese","Serie A","Mouhamadou Sarr","SEN","GK","25",1997,2,0,0,0,0,0,0,0,NA,0,0,0,0,0,0,2,0,"https://fbref.com/en/players/b959a0d1/Mouhamadou-Sarr"
2023,"Cremonese","Serie A","Leonardo Sernicola","ITA","DF","25",1997,25.7,45,33,25,13,7,29,43,67.4,14,23,6,17,38,83,55,0,"https://fbref.com/en/players/dd7febd8/Leonardo-Sernicola"
2023,"Cremonese","Serie A","Frank Tsadjout","ITA","FW","23",1999,11.7,10,8,3,6,1,3,9,33.3,6,7,1,6,8,18,9,0,"https://fbref.com/en/players/0588a092/Frank-Tsadjout"
2023,"Cremonese","Serie A","Emanuele Valeri","ITA","DF","23",1998,30.9,54,27,29,21,4,29,69,42,40,17,3,14,22,76,44,1,"https://fbref.com/en/players/ec52b661/Emanuele-Valeri"
2023,"Cremonese","Serie A","Johan Vásquez","MEX","DF","23",1998,20.1,41,26,34,7,0,18,39,46.2,21,27,20,7,45,86,93,1,"https://fbref.com/en/players/5eaed77a/Johan-Vasquez"
2023,"Cremonese","Serie A","Luca Zanimacchia","ITA","MF,FW","24",1998,8.3,21,13,11,6,4,8,21,38.1,13,9,0,9,9,30,5,0,"https://fbref.com/en/players/5e834dce/Luca-Zanimacchia"
2023,"Crystal Palace","Premier League","Naouirou Ahamada","FRA","MF,FW","20",2002,1,3,2,3,0,0,1,3,33.3,2,2,0,2,0,3,0,0,"https://fbref.com/en/players/a6c58494/Naouirou-Ahamada"
2023,"Crystal Palace","Premier League","Joachim Andersen","DEN","DF","26",1996,30.9,42,22,30,12,0,16,32,50,16,28,13,15,24,66,188,0,"https://fbref.com/en/players/e34fc66d/Joachim-Andersen"
2023,"Crystal Palace","Premier League","Jordan Ayew","GHA","FW,MF","30",1991,30.2,66,41,23,20,23,21,53,39.6,32,35,4,31,15,81,31,0,"https://fbref.com/en/players/da052c14/Jordan-Ayew"
2023,"Crystal Palace","Premier League","Nathaniel Clyne","ENG","DF","31",1991,18.2,27,16,13,9,5,14,23,60.9,9,22,4,18,19,46,34,0,"https://fbref.com/en/players/0442183b/Nathaniel-Clyne"
2023,"Crystal Palace","Premier League","Cheick Doucouré","MLI","MF","22",2000,30.8,77,46,40,33,4,29,52,55.8,23,47,13,34,56,133,48,0,"https://fbref.com/en/players/ce4f40c7/Cheick-Doucoure"
2023,"Crystal Palace","Premier League","Malcolm Ebiowei","ENG","MF,FW","18",2003,0.4,1,1,1,0,0,0,1,0,1,2,0,2,0,1,0,0,"https://fbref.com/en/players/fa9fa773/Malcolm-Ebiowei"
2023,"Crystal Palace","Premier League","Odsonne Édouard","FRA","FW","24",1998,20,25,13,7,12,6,7,13,53.8,6,17,5,12,3,28,22,0,"https://fbref.com/en/players/0562b7f1/Odsonne-Edouard"
2023,"Crystal Palace","Premier League","Eberechi Eze","ENG","MF,FW","24",1998,29.3,42,24,17,18,7,18,38,47.4,20,22,0,22,13,55,10,0,"https://fbref.com/en/players/ae4fc6a4/Eberechi-Eze"
2023,"Crystal Palace","Premier League","Vicente Guaita","ESP","GK","35",1987,27,0,0,0,0,0,0,0,NA,0,0,0,0,0,0,9,1,"https://fbref.com/en/players/ab13a5aa/Vicente-Guaita"
2023,"Crystal Palace","Premier League","Marc Guéhi","ENG","DF","22",2000,37,52,27,39,11,2,26,42,61.9,16,45,24,21,45,97,134,3,"https://fbref.com/en/players/d0706b27/Marc-Guehi"
2023,"Crystal Palace","Premier League","Will Hughes","ENG","MF","27",1995,9.4,29,16,11,16,2,11,20,55,9,16,7,9,16,45,9,0,"https://fbref.com/en/players/a0666d3e/Will-Hughes"
2023,"Crystal Palace","Premier League","Sam Johnstone","ENG","GK","29",1993,9,0,0,0,0,0,0,0,NA,0,0,0,0,0,0,5,0,"https://fbref.com/en/players/9e5708be/Sam-Johnstone"
2023,"Crystal Palace","Premier League","Jean-Philippe Mateta","FRA","FW","25",1997,8.6,7,1,2,4,1,1,3,33.3,2,3,1,2,3,10,18,0,"https://fbref.com/en/players/50e6dc35/Jean-Philippe-Mateta"
2023,"Crystal Palace","Premier League","James McArthur","SCO","MF","34",1987,0.6,1,1,1,0,0,1,1,100,0,2,1,1,1,2,2,0,"https://fbref.com/en/players/cee31595/James-McArthur"
2023,"Crystal Palace","Premier League","Luka Milivojević","SRB","MF","31",1991,5.7,13,7,7,4,2,7,10,70,3,13,4,9,12,25,10,0,"https://fbref.com/en/players/2ce2508a/Luka-Milivojevic"
2023,"Crystal Palace","Premier League","Tyrick Mitchell","ENG","DF","22",1999,32.1,71,49,43,23,5,30,53,56.6,23,48,11,37,42,113,78,0,"https://fbref.com/en/players/5cbd1eb0/Tyrick-Mitchell"
2023,"Crystal Palace","Premier League","Michael Olise","FRA","FW,MF","20",2001,30.5,58,34,28,26,4,25,60,41.7,35,46,1,45,26,84,17,0,"https://fbref.com/en/players/c4486bac/Michael-Olise"
2023,"Crystal Palace","Premier League","David Ozoh","","FW","17",2005,0,0,0,0,0,0,0,0,NA,0,0,0,0,0,0,0,0,"https://fbref.com/en/players/d00d45ab/David-Ozoh"
2023,"Crystal Palace","Premier League","Chris Richards","USA","DF","22",2000,5,9,6,8,1,0,5,7,71.4,2,10,1,9,8,17,31,0,"https://fbref.com/en/players/0a3d6d2b/Chris-Richards"
2023,"Crystal Palace","Premier League","Jaïro Riedewald","NED","DF,MF","25",1996,0.7,2,1,2,0,0,0,1,0,1,2,0,2,0,2,4,0,"https://fbref.com/en/players/7a1f2c08/Jairo-Riedewald"
2023,"Crystal Palace","Premier League","Albert Sambi Lokonga","BEL","MF","22",1999,6,13,10,7,4,2,8,12,66.7,4,8,3,5,7,20,10,0,"https://fbref.com/en/players/1b4f1169/Albert-Sambi-Lokonga"
2023,"Crystal Palace","Premier League","Jeffrey Schlupp","GHA","MF,FW","29",1992,28.1,66,46,28,29,9,22,43,51.2,21,39,8,31,23,89,38,0,"https://fbref.com/en/players/3312f911/Jeffrey-Schlupp"
2023,"Crystal Palace","Premier League","James Tomkins","ENG","DF","33",1989,3.8,4,2,2,1,1,1,3,33.3,2,3,2,1,5,9,19,0,"https://fbref.com/en/players/e7ca0439/James-Tomkins"
2023,"Crystal Palace","Premier League","Joel Ward","ENG","DF","32",1989,25.1,50,36,30,11,9,30,41,73.2,11,32,16,16,25,75,80,1,"https://fbref.com/en/players/8a7ff278/Joel-Ward"
2023,"Crystal Palace","Premier League","Joseph Whitworth","ENG","GK","18",2004,2,0,0,0,0,0,0,0,NA,0,0,0,0,0,0,1,0,"https://fbref.com/en/players/3f847d95/Joseph-Whitworth"
2023,"Crystal Palace","Premier League","Wilfried Zaha","CIV","FW,MF","29",1992,25.4,32,20,12,12,8,8,21,38.1,13,21,1,20,16,48,9,0,"https://fbref.com/en/players/b2bc3b1f/Wilfried-Zaha"
2023,"Cádiz","La Liga","Tomás Alarcón","CHI","MF","23",1999,2.5,3,2,0,2,1,1,2,50,1,1,0,1,2,5,2,0,"https://fbref.com/en/players/99ea2ddd/Tomas-Alarcon"
2023,"Cádiz","La Liga","Rubén Alcaraz","ESP","MF","31",1991,22.7,43,31,24,18,1,19,54,35.2,35,23,8,15,19,62,37,0,"https://fbref.com/en/players/036bba5f/Ruben-Alcaraz"
2023,"Cádiz","La Liga","Iván Alejo","ESP","MF,FW","27",1995,14.6,32,21,19,9,4,17,37,45.9,20,18,3,15,5,37,12,1,"https://fbref.com/en/players/3d7e48ce/Ivan-Alejo"
2023,"Cádiz","La Liga","José Antonio","ESP","MF,DF","18",2004,0.5,2,1,0,0,2,0,0,NA,0,0,0,0,0,2,0,0,"https://fbref.com/en/players/62a583ee/Jose-Antonio"
2023,"Cádiz","La Liga","Santiago Arzamendia","PAR","DF,MF","24",1998,5.4,9,8,7,1,1,6,21,28.6,15,11,1,10,2,11,15,1,"https://fbref.com/en/players/759d8dd7/Santiago-Arzamendia"
2023,"Cádiz","La Liga","Blanco","ESP","MF","22",2000,1.8,6,4,5,1,0,4,6,66.7,2,5,0,5,1,7,3,0,"https://fbref.com/en/players/506daeac/Blanco"
2023,"Cádiz","La Liga","Theo Bongonda","COD","MF,FW","26",1995,21.5,28,20,11,14,3,17,40,42.5,23,21,2,19,6,34,14,0,"https://fbref.com/en/players/0da6a13e/Theo-Bongonda"
2023,"Cádiz","La Liga","Cala","ESP","DF","32",1989,1.5,2,1,1,1,0,1,2,50,1,2,1,1,1,3,12,0,"https://fbref.com/en/players/fe05804b/Cala"
2023,"Cádiz","La Liga","Isaac Carcelen","ESP","DF","29",1993,24.4,69,51,41,22,6,41,63,65.1,22,35,11,24,19,88,80,1,"https://fbref.com/en/players/c4b888df/Isaac-Carcelen"
2023,"Cádiz","La Liga","Víctor Chust","ESP","DF","22",2000,10.7,9,6,7,2,0,4,7,57.1,3,8,3,5,10,19,53,0,"https://fbref.com/en/players/ec1a731e/Victor-Chust"
2023,"Cádiz","La Liga","Mamady Diarra","MLI","MF,DF","22",2000,0.7,2,1,2,0,0,1,2,50,1,2,0,2,0,2,0,0,"https://fbref.com/en/players/80211dc5/Mamady-Diarra"
2023,"Cádiz","La Liga","Youba Diarra","MLI","MF","24",1998,1.1,3,0,2,1,0,1,5,20,4,7,1,6,2,5,3,0,"https://fbref.com/en/players/d61759ec/Youba-Diarra"
2023,"Cádiz","La Liga","Gonzalo Escalante","ARG","MF","29",1993,12.5,36,24,15,20,1,15,29,51.7,14,18,4,14,17,53,26,1,"https://fbref.com/en/players/3f79a1c8/Gonzalo-Escalante"
2023,"Cádiz","La Liga","Alfonso Espino","URU","DF","30",1992,34.7,87,56,55,20,12,48,96,50,48,52,11,41,48,135,99,3,"https://fbref.com/en/players/db001fa9/Alfonso-Espino"
2023,"Cádiz","La Liga","Fali","ESP","DF,MF","28",1993,19,27,19,19,8,0,18,29,62.1,11,24,15,9,13,40,70,1,"https://fbref.com/en/players/72a84002/Fali"
2023,"Cádiz","La Liga","Álex Fernández","ESP","MF,FW","29",1992,17.5,13,7,6,4,3,4,14,28.6,10,14,1,13,8,21,19,0,"https://fbref.com/en/players/aa677a35/Alex-Fernandez"
2023,"Cádiz","La Liga","Carlos García","ESP","DF","22",2000,0.3,0,0,0,0,0,0,0,NA,0,0,0,0,0,0,2,0,"https://fbref.com/en/players/661e2822/Carlos-Garcia"
2023,"Cádiz","La Liga","David Gil","ESP","GK","28",1994,4,0,0,0,0,0,0,0,NA,0,0,0,0,0,0,3,0,"https://fbref.com/en/players/fea23125/David-Gil"
2023,"Cádiz","La Liga","Álvaro Giménez","ESP","FW","31",1991,0.2,0,0,0,0,0,0,1,0,1,0,0,0,0,0,0,0,"https://fbref.com/en/players/18017beb/Alvaro-Gimenez"
2023,"Cádiz","La Liga","Sergi Guardiola","ESP","FW","31",1991,12.9,9,7,0,6,3,3,12,25,9,5,0,5,3,12,7,0,"https://fbref.com/en/players/32974271/Sergi-Guardiola"
2023,"Cádiz","La Liga","Luis Hernández","ESP","DF","33",1989,35,33,21,25,7,1,22,36,61.1,14,31,24,7,31,64,145,0,"https://fbref.com/en/players/02d2c436/Luis-Hernandez"
2023,"Cádiz","La Liga","Jeremías Ledesma","ARG","GK","29",1993,34,3,2,3,0,0,3,7,42.9,4,1,0,1,2,5,23,3,"https://fbref.com/en/players/6c4776b1/Jeremias-Ledesma"
2023,"Cádiz","La Liga","Anthony Lozano","HON","FW","29",1993,16,6,4,1,4,1,1,7,14.3,6,12,1,11,3,9,17,0,"https://fbref.com/en/players/38699c72/Anthony-Lozano"
2023,"Cádiz","La Liga","Awer Mabil","AUS","MF,FW","26",1995,1.8,2,0,0,1,1,1,3,33.3,2,1,1,0,0,2,1,0,"https://fbref.com/en/players/922da988/Awer-Mabil"
2023,"Cádiz","La Liga","José Mari","ESP","MF","34",1987,4.4,16,7,12,3,1,10,16,62.5,6,3,1,2,5,21,9,0,"https://fbref.com/en/players/6f4c734d/Jose-Mari"
2023,"Cádiz","La Liga","Roger Martí","ESP","FW","31",1991,7.1,6,4,2,3,1,1,8,12.5,7,7,0,7,2,8,7,0,"https://fbref.com/en/players/0ae4e09a/Roger-Marti"
2023,"Cádiz","La Liga","Mamadou Mbaye","SEN","DF","24",1998,8.4,10,7,7,3,0,6,8,75,2,10,8,2,7,17,50,1,"https://fbref.com/en/players/8aae94b9/Mamadou-Mbaye"
2023,"Cádiz","La Liga","Jorge Meré","ESP","DF","25",1997,6.7,11,7,9,2,0,5,8,62.5,3,9,6,3,6,17,32,0,"https://fbref.com/en/players/9f979eb2/Jorge-Mere"
2023,"Cádiz","La Liga","Francisco Mwepu","ZAM","FW","22",2000,0.2,1,0,0,1,0,0,0,NA,0,0,0,0,0,1,0,0,"https://fbref.com/en/players/dfe5caa2/Francisco-Mwepu"
2023,"Cádiz","La Liga","Álvaro Negredo","ESP","FW","36",1985,8.4,5,4,1,2,2,2,2,100,0,4,1,3,0,5,8,0,"https://fbref.com/en/players/63b0ca6b/Alvaro-Negredo"
2023,"Cádiz","La Liga","Brian Ocampo","URU","MF,FW","23",1999,12.4,18,15,12,5,1,8,21,38.1,13,13,0,13,3,21,3,0,"https://fbref.com/en/players/2e3995cd/Brian-Ocampo"
2023,"Cádiz","La Liga","Raúl Parra","ESP","DF","22",1999,3.4,4,2,4,0,0,4,9,44.4,5,5,3,2,1,5,9,0,"https://fbref.com/en/players/647d39d2/Raul-Parra"
2023,"Cádiz","La Liga","Alberto Perea","ESP","MF","31",1990,0.5,2,0,2,0,0,0,0,NA,0,2,0,2,0,2,0,0,"https://fbref.com/en/players/5496cc91/Alberto-Perea"
2023,"Cádiz","La Liga","Lucas Pérez","ESP","FW","33",1988,7,3,2,2,1,0,1,3,33.3,2,2,0,2,1,4,3,0,"https://fbref.com/en/players/a300ac7e/Lucas-Perez"
2023,"Cádiz","La Liga","Chris Ramos","ESP","FW","25",1997,7.9,12,9,2,7,3,4,11,36.4,7,8,3,5,1,13,19,0,"https://fbref.com/en/players/44e07fac/Chris-Ramos"
2023,"Cádiz","La Liga","Fede San Emeterio","ESP","MF","25",1997,20.5,41,22,23,16,2,22,46,47.8,24,34,14,20,17,58,28,0,"https://fbref.com/en/players/efecd633/Fede-San-Emeterio"
2023,"Cádiz","La Liga","Rubén Sobrino","ESP","MF,FW","30",1992,27.4,55,37,29,17,9,23,56,41.1,33,33,3,30,24,79,20,1,"https://fbref.com/en/players/19b776e9/Ruben-Sobrino"
2023,"Cádiz","La Liga","Joseba Zaldúa","ESP","DF","30",1992,7.1,15,8,10,4,1,7,10,70,3,4,2,2,11,26,22,0,"https://fbref.com/en/players/5ca20b7a/Joseba-Zaldua"
2023,"Dortmund","Bundesliga","Karim Adeyemi","GER","FW,MF","20",2002,15.4,16,11,6,6,4,8,30,26.7,22,18,1,17,7,23,3,0,"https://fbref.com/en/players/501055d8/Karim-Adeyemi"
2023,"Dortmund","Bundesliga","Jude Bellingham","ENG","MF","19",2003,29.9,76,42,28,34,14,34,51,66.7,17,51,4,47,35,111,30,0,"https://fbref.com/en/players/57d88cf9/Jude-Bellingham"
2023,"Dortmund","Bundesliga","Julian Brandt","GER","MF,FW","26",1996,26.6,29,20,6,14,9,12,43,27.9,31,23,0,23,15,44,9,1,"https://fbref.com/en/players/a167537f/Julian-Brandt"
2023,"Dortmund","Bundesliga","Jamie Bynoe-Gittens","ENG","FW,MF","17",2004,5.9,8,4,2,5,1,2,7,28.6,5,1,0,1,1,9,2,0,"https://fbref.com/en/players/10745192/Jamie-Bynoe-Gittens"
2023,"Dortmund","Bundesliga","Emre Can","GER","MF","28",1994,21.1,57,28,25,27,5,22,43,51.2,21,16,6,10,25,82,39,1,"https://fbref.com/en/players/a65ce836/Emre-Can"
2023,"Dortmund","Bundesliga","Soumaïla Coulibaly","FRA","DF","18",2003,0.5,0,0,0,0,0,0,0,NA,0,0,0,0,0,0,0,1,"https://fbref.com/en/players/9dff291c/Soumaila-Coulibaly"
2023,"Dortmund","Bundesliga","Mahmoud Dahoud","GER","MF","26",1996,3.7,11,9,3,4,4,7,7,100,0,6,2,4,7,18,3,0,"https://fbref.com/en/players/db4ed67b/Mahmoud-Dahoud"
2023,"Dortmund","Bundesliga","Julien Duranville","BEL","MF","16",2006,0.3,1,1,0,1,0,1,1,100,0,0,0,0,0,1,0,0,"https://fbref.com/en/players/b06a7ae9/Julien-Duranville"
2023,"Dortmund","Bundesliga","Raphaël Guerreiro","POR","DF,MF","28",1993,25.4,36,20,13,15,8,21,34,61.8,13,21,2,19,36,72,23,0,"https://fbref.com/en/players/048a1cbc/Raphael-Guerreiro"
2023,"Dortmund","Bundesliga","Sébastien Haller","CIV","FW","28",1994,13.6,5,4,2,1,2,0,4,0,4,8,0,8,1,6,10,0,"https://fbref.com/en/players/ba115a40/Sebastien-Haller"
2023,"Dortmund","Bundesliga","Thorgan Hazard","BEL","FW,DF","29",1993,5.2,17,6,5,11,1,12,17,70.6,5,6,0,6,5,22,5,0,"https://fbref.com/en/players/50871bcc/Thorgan-Hazard"
2023,"Dortmund","Bundesliga","Mats Hummels","GER","DF","33",1988,22.4,62,34,38,22,2,32,55,58.2,23,30,16,14,33,95,100,1,"https://fbref.com/en/players/05d548d8/Mats-Hummels"
2023,"Dortmund","Bundesliga","Gregor Kobel","SUI","GK","24",1997,27,0,0,0,0,0,0,1,0,1,1,0,1,0,0,7,2,"https://fbref.com/en/players/cd59b9df/Gregor-Kobel"
2023,"Dortmund","Bundesliga","Donyell Malen","NED","FW","23",1999,19,13,5,3,4,6,5,12,41.7,7,14,1,13,4,17,11,0,"https://fbref.com/en/players/864163f3/Donyell-Malen"
2023,"Dortmund","Bundesliga","Thomas Meunier","BEL","DF","30",1991,6.5,16,7,8,5,3,10,17,58.8,7,7,2,5,9,25,16,0,"https://fbref.com/en/players/e162b013/Thomas-Meunier"
2023,"Dortmund","Bundesliga","Alexander Meyer","GER","GK","31",1991,7,0,0,0,0,0,0,1,0,1,0,0,0,0,0,1,0,"https://fbref.com/en/players/b56dd813/Alexander-Meyer"
2023,"Dortmund","Bundesliga","Anthony Modeste","FRA","FW","34",1988,9,4,4,2,0,2,2,5,40,3,7,0,7,2,6,22,0,"https://fbref.com/en/players/34e4343c/Anthony-Modeste"
2023,"Dortmund","Bundesliga","Youssoufa Moukoko","GER","FW","17",2004,12.7,13,7,3,6,4,3,6,50,3,9,0,9,2,15,1,0,"https://fbref.com/en/players/6ce43701/Youssoufa-Moukoko"
2023,"Dortmund","Bundesliga","Justin Njinmah","GER","FW","21",2000,0.2,0,0,0,0,0,0,0,NA,0,0,0,0,0,0,0,0,"https://fbref.com/en/players/a45241d5/Justin-Njinmah"
2023,"Dortmund","Bundesliga","Salih Özcan","TUR","MF","24",1998,17.5,31,18,10,16,5,16,39,41,23,24,2,22,28,59,19,1,"https://fbref.com/en/players/15413fa5/Salih-Ozcan"
2023,"Dortmund","Bundesliga","Antonios Papadopoulos","GER","DF","22",1999,0.1,0,0,0,0,0,0,0,NA,0,0,0,0,1,1,0,0,"https://fbref.com/en/players/13d23b29/Antonios-Papadopoulos"
2023,"Dortmund","Bundesliga","Marco Pašalić","CRO","MF","21",2000,0.1,0,0,0,0,0,0,0,NA,0,0,0,0,0,0,0,0,"https://fbref.com/en/players/1866b0f1/Marco-Pasalic"
2023,"Dortmund","Bundesliga","Felix Passlack","GER","DF","24",1998,0.7,4,3,0,4,0,1,1,100,0,1,1,0,0,4,1,0,"https://fbref.com/en/players/5c899683/Felix-Passlack"
2023,"Dortmund","Bundesliga","Marco Reus","GER","MF,FW","33",1989,15,30,17,12,14,4,7,24,29.2,17,12,4,8,8,38,8,0,"https://fbref.com/en/players/36a3ff67/Marco-Reus"
2023,"Dortmund","Bundesliga","Gio Reyna","USA","FW,MF","19",2002,6.9,14,7,2,5,7,5,10,50,5,8,2,6,3,17,5,0,"https://fbref.com/en/players/7fa4e703/Gio-Reyna"
2023,"Dortmund","Bundesliga","Tom Rothe","GER","DF","17",2004,0.3,1,1,0,1,0,1,1,100,0,0,0,0,1,2,2,0,"https://fbref.com/en/players/90c1f9a4/Tom-Rothe"
2023,"Dortmund","Bundesliga","Julian Ryerson","NOR","DF","24",1997,15.7,27,15,17,7,3,19,37,51.4,18,13,2,11,8,35,28,0,"https://fbref.com/en/players/009a4f60/Julian-Ryerson"
2023,"Dortmund","Bundesliga","Nico Schlotterbeck","GER","DF","22",1999,25,59,34,34,24,1,37,53,69.8,16,38,21,17,32,91,71,1,"https://fbref.com/en/players/34e12499/Nico-Schlotterbeck"
2023,"Dortmund","Bundesliga","Niklas Süle","GER","DF","26",1995,23.5,25,19,18,3,4,14,23,60.9,9,28,19,9,17,42,53,0,"https://fbref.com/en/players/e33c06cf/Niklas-Sule"
2023,"Dortmund","Bundesliga","Marius Wolf","GER","DF","27",1995,17.4,25,18,9,12,4,16,29,55.2,13,40,10,30,18,43,22,1,"https://fbref.com/en/players/fa661778/Marius-Wolf"
2023,"Eint Frankfurt","Bundesliga","Paxten Aaronson","USA","MF,DF","18",2003,1.9,6,5,2,2,2,2,3,66.7,1,2,1,1,0,6,2,0,"https://fbref.com/en/players/4cd41883/Paxten-Aaronson"
2023,"Eint Frankfurt","Bundesliga","Lucas Alario","ARG","FW,MF","29",1992,3.7,3,2,1,0,2,0,1,0,1,0,0,0,2,5,13,0,"https://fbref.com/en/players/834d0be5/Lucas-Alario"
2023,"Eint Frankfurt","Bundesliga","Faride Alidou","GER","DF,MF","21",2001,2,8,5,3,4,1,3,9,33.3,6,3,0,3,1,9,3,0,"https://fbref.com/en/players/00f518d8/Faride-Alidou"
2023,"Eint Frankfurt","Bundesliga","Rafael Borré","COL","MF,FW","26",1995,12,25,15,4,13,8,4,17,23.5,13,10,2,8,2,27,9,0,"https://fbref.com/en/players/c68da769/Rafael-Borre"
2023,"Eint Frankfurt","Bundesliga","Aurélio Buta","POR","DF","25",1997,14.6,33,19,15,13,5,15,27,55.6,12,18,1,17,9,42,34,0,"https://fbref.com/en/players/b4705807/Aurelio-Buta"
2023,"Eint Frankfurt","Bundesliga","Timothy Chandler","USA","DF","32",1990,1,2,2,2,0,0,2,2,100,0,1,0,1,0,2,3,0,"https://fbref.com/en/players/b3b7f5a6/Timothy-Chandler"
2023,"Eint Frankfurt","Bundesliga","Junior Dina Ebimbe","FRA","DF,MF","21",2000,11.8,30,19,16,14,0,16,33,48.5,17,18,5,13,11,41,20,0,"https://fbref.com/en/players/95bb6ddc/Junior-Dina-Ebimbe"
2023,"Eint Frankfurt","Bundesliga","Dario Gebuhr","GER","DF","19",2003,0.2,0,0,0,0,0,0,1,0,1,0,0,0,0,0,0,0,"https://fbref.com/en/players/277be51d/Dario-Gebuhr"
2023,"Eint Frankfurt","Bundesliga","Mario Götze","GER","MF","30",1992,30.4,42,25,13,22,7,14,47,29.8,33,25,0,25,13,55,12,0,"https://fbref.com/en/players/9efa1d25/Mario-Gotze"
2023,"Eint Frankfurt","Bundesliga","Makoto Hasebe","JPN","DF","38",1984,14.5,18,12,16,2,0,7,22,31.8,15,22,9,13,17,35,45,0,"https://fbref.com/en/players/9ab16552/Makoto-Hasebe"
2023,"Eint Frankfurt","Bundesliga","Kristijan Jakić","CRO","DF,MF","25",1997,16.2,33,21,19,12,2,22,41,53.7,19,32,10,22,14,47,49,1,"https://fbref.com/en/players/a8ee54ad/Kristijan-Jakic"
2023,"Eint Frankfurt","Bundesliga","Daichi Kamada","JPN","MF","25",1996,25.2,51,31,10,37,4,31,57,54.4,26,31,2,29,16,67,17,1,"https://fbref.com/en/players/15b287da/Daichi-Kamada"
2023,"Eint Frankfurt","Bundesliga","Ansgar Knauff","GER","DF","20",2002,14.3,36,25,22,11,3,15,34,44.1,19,19,1,18,15,51,26,0,"https://fbref.com/en/players/19a967ab/Ansgar-Knauff"
2023,"Eint Frankfurt","Bundesliga","Randal Kolo Muani","FRA","FW","23",1998,29.2,14,10,3,3,8,1,9,11.1,8,19,2,17,3,17,13,0,"https://fbref.com/en/players/c0b3669f/Randal-Kolo-Muani"
2023,"Eint Frankfurt","Bundesliga","Filip Kostić","SRB","DF,MF","29",1992,0.8,2,0,1,1,0,0,0,NA,0,0,0,0,1,3,0,0,"https://fbref.com/en/players/b1cd37e6/Filip-Kostic"
2023,"Eint Frankfurt","Bundesliga","Christopher Lenz","GER","DF","27",1994,14.3,29,21,17,7,5,16,37,43.2,21,16,3,13,21,50,34,0,"https://fbref.com/en/players/bbd86530/Christopher-Lenz"
2023,"Eint Frankfurt","Bundesliga","Jesper Lindstrøm","DEN","MF,FW","22",2000,18.7,26,11,15,7,4,7,22,31.8,15,25,3,22,9,35,9,0,"https://fbref.com/en/players/37dc1a48/Jesper-Lindstrom"
2023,"Eint Frankfurt","Bundesliga","Philipp Max","GER","DF","28",1993,7.7,12,9,4,7,1,5,16,31.3,11,10,2,8,3,15,11,0,"https://fbref.com/en/players/826e8b63/Philipp-Max"
2023,"Eint Frankfurt","Bundesliga","Obite N'Dicka","FRA","DF","22",1999,29.9,25,18,10,11,4,18,32,56.3,14,47,19,28,31,56,150,0,"https://fbref.com/en/players/441197b8/Obite-NDicka"
2023,"Eint Frankfurt","Bundesliga","Luca Pellegrini","ITA","DF","23",1999,6.2,13,8,10,3,0,8,8,100,0,8,2,6,7,20,11,1,"https://fbref.com/en/players/3b61c9ec/Luca-Pellegrini"
2023,"Eint Frankfurt","Bundesliga","Diant Ramaj","GER","GK","20",2001,1,0,0,0,0,0,0,0,NA,0,0,0,0,0,0,1,0,"https://fbref.com/en/players/b90c4a43/Diant-Ramaj"
2023,"Eint Frankfurt","Bundesliga","Sebastian Rode","GER","MF","31",1990,15.7,38,24,7,28,3,14,45,31.1,31,18,2,16,16,54,12,0,"https://fbref.com/en/players/e12b0b5b/Sebastian-Rode"
2023,"Eint Frankfurt","Bundesliga","Hrvoje Smolčić","CRO","DF","21",2000,5.2,8,7,6,2,0,5,10,50,5,11,4,7,6,14,38,0,"https://fbref.com/en/players/c967f6b8/Hrvoje-Smolcic"
2023,"Eint Frankfurt","Bundesliga","Djibril Sow","SUI","MF","25",1997,29.4,41,25,13,25,3,22,44,50,22,22,4,18,28,69,23,0,"https://fbref.com/en/players/4c6facae/Djibril-Sow"
2023,"Eint Frankfurt","Bundesliga","Almamy Touré","MLI","DF","26",1996,4.4,13,7,7,5,1,5,9,55.6,4,9,2,7,10,23,8,0,"https://fbref.com/en/players/c8c60119/Almamy-Toure"
2023,"Eint Frankfurt","Bundesliga","Kevin Trapp","GER","GK","32",1990,33,1,1,1,0,0,0,2,0,2,2,0,2,0,1,10,0,"https://fbref.com/en/players/ce17b5eb/Kevin-Trapp"
2023,"Eint Frankfurt","Bundesliga","Tuta","BRA","DF","23",1999,30.2,53,35,27,19,7,33,57,57.9,24,47,14,33,49,102,134,2,"https://fbref.com/en/players/35d64857/Tuta"
2023,"Eint Frankfurt","Bundesliga","Marcel Wenig","GER","MF","18",2004,0,0,0,0,0,0,0,0,NA,0,0,0,0,0,0,0,0,"https://fbref.com/en/players/1c86aa16/Marcel-Wenig"
2023,"Elche","La Liga","Alejandro Alfaro","ESP","MF","20",2002,0.2,0,0,0,0,0,0,0,NA,0,0,0,0,0,0,0,0,"https://fbref.com/en/players/b907d169/Alejandro-Alfaro"
2023,"Elche","La Liga","Édgar Badía","ESP","GK","30",1992,36,1,0,1,0,0,1,2,50,1,0,0,0,0,1,19,3,"https://fbref.com/en/players/e4346678/Edgar-Badia"
2023,"Elche","La Liga","Pedro Bigas","ESP","DF","31",1990,22.4,37,20,30,7,0,18,29,62.1,11,25,14,11,33,70,95,0,"https://fbref.com/en/players/697295b1/Pedro-Bigas"
2023,"Elche","La Liga","Lautaro Blanco","ARG","DF,MF","23",1999,9.7,16,9,10,4,2,9,26,34.6,17,8,1,7,2,18,10,1,"https://fbref.com/en/players/1657f448/Lautaro-Blanco"
2023,"Elche","La Liga","Lucas Boyé","ARG","FW","26",1996,27.4,36,16,12,16,8,17,35,48.6,18,33,5,28,15,51,46,0,"https://fbref.com/en/players/d49f3e6b/Lucas-Boye"
2023,"Elche","La Liga","Carmona","ESP","MF,DF","20",2002,6.5,16,9,7,6,3,6,16,37.5,10,14,2,12,8,24,9,0,"https://fbref.com/en/players/2dce876a/Carmona"
2023,"Elche","La Liga","Pape Cheikh Diop","SEN","MF","24",1997,0.4,0,0,0,0,0,0,1,0,1,0,0,0,0,0,0,0,"https://fbref.com/en/players/873ce3a2/Pape-Cheikh-Diop"
2023,"Elche","La Liga","Carlos Clerc","ESP","DF,MF","30",1992,29.3,75,51,55,16,4,31,50,62,19,29,7,22,28,103,94,1,"https://fbref.com/en/players/33a61a52/Carlos-Clerc"
2023,"Elche","La Liga","Álex Collado","ESP","MF","23",1999,8.1,26,14,13,11,2,8,13,61.5,5,12,1,11,2,28,4,0,"https://fbref.com/en/players/85dace26/Alex-Collado"
2023,"Elche","La Liga","John Donald","ESP","MF,DF","21",2000,12.1,20,11,9,9,2,7,14,50,7,14,7,7,14,34,23,1,"https://fbref.com/en/players/5e95c000/John-Donald"
2023,"Elche","La Liga","Nicolás Ezequiel Fernández","ARG","MF,DF","22",2000,5.7,23,12,10,7,6,9,17,52.9,8,7,0,7,5,28,2,1,"https://fbref.com/en/players/3409de86/Nicolas-Ezequiel-Fernandez"
2023,"Elche","La Liga","Federico Fernández","ARG","DF","33",1989,1,1,1,1,0,0,1,1,100,0,0,0,0,2,3,12,0,"https://fbref.com/en/players/f25b010f/Federico-Fernandez"
2023,"Elche","La Liga","Fidel","ESP","MF,FW","32",1989,19,15,10,8,5,2,4,38,10.5,34,9,0,9,5,20,8,0,"https://fbref.com/en/players/eb82b6f1/Fidel"
2023,"Elche","La Liga","Diego González","ESP","DF","27",1995,10.6,12,7,9,3,0,7,11,63.6,4,14,12,2,7,19,50,1,"https://fbref.com/en/players/4ac7608e/Diego-Gonzalez"
2023,"Elche","La Liga","Gerard Gumbau","ESP","MF","27",1994,30.4,44,25,17,23,4,18,51,35.3,33,32,8,24,28,72,40,0,"https://fbref.com/en/players/ac454a4f/Gerard-Gumbau"
2023,"Elche","La Liga","Raúl Guti","ESP","MF","25",1996,12.4,18,12,8,9,1,8,18,44.4,10,10,3,7,8,26,6,0,"https://fbref.com/en/players/0b2c8585/Raul-Guti"
2023,"Elche","La Liga","Josan","ESP","DF,MF","32",1989,12,25,20,20,5,0,14,27,51.9,13,8,0,8,7,32,15,1,"https://fbref.com/en/players/5b28b2f6/Josan"
2023,"Elche","La Liga","Pol Lirola","ESP","DF","24",1997,7,13,6,9,3,1,8,13,61.5,5,3,2,1,7,20,16,0,"https://fbref.com/en/players/ff800ed8/Pol-Lirola"
2023,"Elche","La Liga","Lisandro Magallán","ARG","DF","28",1993,10,19,11,11,5,3,10,12,83.3,2,14,5,9,13,32,30,1,"https://fbref.com/en/players/01a49bd2/Lisandro-Magallan"
2023,"Elche","La Liga","Roger Martí","ESP","FW","31",1991,7.3,5,2,3,2,0,1,5,20,4,4,0,4,1,6,7,0,"https://fbref.com/en/players/0ae4e09a/Roger-Marti"
2023,"Elche","La Liga","Omar Mascarell","ESP","MF,DF","29",1993,27.2,53,26,32,19,2,31,64,48.4,33,51,19,32,45,98,54,1,"https://fbref.com/en/players/11fd2b75/Omar-Mascarell"
2023,"Elche","La Liga","Pere Milla","ESP","FW,MF","29",1992,20.5,31,20,18,8,5,14,41,34.1,27,18,3,15,9,40,19,1,"https://fbref.com/en/players/335039a2/Pere-Milla"
2023,"Elche","La Liga","Johan Mojica","COL","DF,MF","29",1992,3,6,3,5,1,0,2,3,66.7,1,3,2,1,4,10,5,0,"https://fbref.com/en/players/608f2092/Johan-Mojica"
2023,"Elche","La Liga","Tete Morente","ESP","MF,DF","25",1996,23,33,21,18,13,2,15,36,41.7,21,23,3,20,25,58,28,0,"https://fbref.com/en/players/004d185e/Tete-Morente"
2023,"Elche","La Liga","Randy Ntekja","FRA","FW,MF","24",1997,8.1,15,10,7,6,2,2,11,18.2,9,15,3,12,4,19,9,0,"https://fbref.com/en/players/a6103274/Randy-Ntekja"
2023,"Elche","La Liga","Helibelton Palacios","COL","DF","29",1993,21.3,38,20,21,15,2,19,26,73.1,7,26,12,14,20,58,55,0,"https://fbref.com/en/players/ac8b2421/Helibelton-Palacios"
2023,"Elche","La Liga","Javier Pastore","ARG","MF","33",1989,0.1,0,0,0,0,0,0,0,NA,0,0,0,0,0,0,0,0,"https://fbref.com/en/players/881ef58c/Javier-Pastore"
2023,"Elche","La Liga","Ezequiel Ponce","ARG","FW,MF","25",1997,12.5,9,7,0,6,3,0,7,0,7,6,1,5,1,10,13,0,"https://fbref.com/en/players/ccbbe661/Ezequiel-Ponce"
2023,"Elche","La Liga","Domingos Quina","POR","MF","22",1999,3.1,3,2,2,1,0,1,3,33.3,2,5,0,5,3,6,1,0,"https://fbref.com/en/players/41fb0f4e/Domingos-Quina"
2023,"Elche","La Liga","Enzo Roco","CHI","DF","29",1992,18.4,33,13,23,10,0,15,24,62.5,9,22,15,7,17,50,63,1,"https://fbref.com/en/players/37f827ec/Enzo-Roco"
2023,"Elche","La Liga","Gonzalo Verdú","ESP","DF","33",1988,7.8,10,5,8,2,0,4,8,50,4,8,6,2,10,20,33,0,"https://fbref.com/en/players/1c2c55fc/Gonzalo-Verdu"
2023,"Elche","La Liga","Axel Werner","ARG","GK","26",1996,2,0,0,0,0,0,0,1,0,1,0,0,0,0,0,0,0,"https://fbref.com/en/players/c0b1a6da/Axel-Werner"
2023,"Empoli","Serie A","Jean-Daniel Akpa-Akpro","CIV","MF,FW","29",1992,15.1,53,37,25,19,9,23,42,54.8,19,35,4,31,13,66,27,0,"https://fbref.com/en/players/fdf4b948/Jean-Daniel-Akpa-Akpro"
2023,"Empoli","Serie A","Nedim Bajrami","ALB","MF,FW","23",1999,10.4,8,4,3,3,2,4,6,66.7,2,5,0,5,7,15,4,0,"https://fbref.com/en/players/f42d6c13/Nedim-Bajrami"
2023,"Empoli","Serie A","Tommaso Baldanzi","ITA","MF","19",2003,19.7,25,12,9,13,3,7,32,21.9,25,21,1,20,2,27,5,0,"https://fbref.com/en/players/102e2599/Tommaso-Baldanzi"
2023,"Empoli","Serie A","Filippo Bandinelli","ITA","MF","27",1995,25.1,55,34,19,26,10,17,45,37.8,28,20,7,13,18,73,40,0,"https://fbref.com/en/players/d44360be/Filippo-Bandinelli"
2023,"Empoli","Serie A","Liberato Cacace","NZL","DF","21",2000,6.5,25,10,12,8,5,9,15,60,6,15,7,8,4,29,16,0,"https://fbref.com/en/players/dd86e8e4/Liberato-Cacace"
2023,"Empoli","Serie A","Nicolò Cambiaghi","ITA","FW,MF","21",2000,14.3,30,22,11,12,7,8,27,29.6,19,19,1,18,9,39,8,0,"https://fbref.com/en/players/91ff775f/Nicolo-Cambiaghi"
2023,"Empoli","Serie A","Francesco Caputo","ITA","FW","34",1987,19,2,2,0,1,1,0,1,0,1,7,2,5,2,4,8,0,"https://fbref.com/en/players/5bd72174/Francesco-Caputo"
2023,"Empoli","Serie A","Koni De Winter","BEL","DF","20",2002,11.4,14,9,11,3,0,5,13,38.5,8,14,12,2,6,20,65,0,"https://fbref.com/en/players/f4797849/Koni-De-Winter"
2023,"Empoli","Serie A","Duccio Degl'Innocenti","ITA","MF","19",2003,0,0,0,0,0,0,0,0,NA,0,0,0,0,1,1,0,0,"https://fbref.com/en/players/0e0d6c53/Duccio-DeglInnocenti"
2023,"Empoli","Serie A","Mattia Destro","ITA","FW,MF","31",1991,6.4,1,1,0,1,0,0,0,NA,0,2,0,2,1,2,5,0,"https://fbref.com/en/players/d7d32194/Mattia-Destro"
2023,"Empoli","Serie A","Tyronne Ebuehi","NGA","DF","26",1995,21.4,22,14,11,7,4,9,13,69.2,4,23,12,11,12,34,79,1,"https://fbref.com/en/players/6af30900/Tyronne-Ebuehi"
2023,"Empoli","Serie A","Emmanuel Ekong","SWE","FW,MF","20",2002,0.2,0,0,0,0,0,0,0,NA,0,0,0,0,0,0,0,0,"https://fbref.com/en/players/c20892ee/Emmanuel-Ekong"
2023,"Empoli","Serie A","Jacopo Fazzini","ITA","MF","19",2003,9.2,31,17,20,8,3,18,34,52.9,16,15,3,12,7,38,19,0,"https://fbref.com/en/players/06b08c45/Jacopo-Fazzini"
2023,"Empoli","Serie A","Alberto Grassi","ITA","MF","27",1995,13.3,26,21,13,13,0,15,24,62.5,9,23,12,11,27,53,45,0,"https://fbref.com/en/players/6cc97b6a/Alberto-Grassi"
2023,"Empoli","Serie A","Nicolas Haas","SUI","MF","26",1996,12.8,27,13,16,6,5,12,24,50,12,16,4,12,8,35,27,0,"https://fbref.com/en/players/fa449bba/Nicolas-Haas"
2023,"Empoli","Serie A","Liam Henderson","SCO","MF","26",1996,11.2,13,10,6,5,2,4,21,19,17,10,2,8,10,23,10,0,"https://fbref.com/en/players/d7918b13/Liam-Henderson"
2023,"Empoli","Serie A","Ardian Ismajli","ALB","DF","25",1996,23.3,40,32,25,15,0,18,24,75,6,47,31,16,27,67,120,0,"https://fbref.com/en/players/6b635f5c/Ardian-Ismajli"
2023,"Empoli","Serie A","Sam Lammers","NED","FW","25",1997,9.8,20,10,5,9,6,7,11,63.6,4,4,1,3,3,23,8,0,"https://fbref.com/en/players/c283ddef/Sam-Lammers"
2023,"Empoli","Serie A","Sebastiano Luperto","ITA","DF","25",1996,34.8,33,18,24,8,1,9,20,45,11,54,42,12,43,76,163,1,"https://fbref.com/en/players/997fff07/Sebastiano-Luperto"
2023,"Empoli","Serie A","Răzvan Marin","ROU","MF","26",1996,28.2,44,22,22,21,1,19,40,47.5,21,29,11,18,14,58,33,0,"https://fbref.com/en/players/7fac99d4/Razvan-Marin"
2023,"Empoli","Serie A","Herculano Nabian","POR","MF","18",2004,0,0,0,0,0,0,0,0,NA,0,0,0,0,0,0,0,0,"https://fbref.com/en/players/c39babc1/Herculano-Nabian"
2023,"Empoli","Serie A","Fabiano Parisi","ITA","DF","21",2000,31.4,65,35,37,21,7,30,72,41.7,42,51,16,35,41,106,91,0,"https://fbref.com/en/players/0967845b/Fabiano-Parisi"
2023,"Empoli","Serie A","Samuele Perisan","ITA","GK","24",1997,7,0,0,0,0,0,0,0,NA,0,0,0,0,0,0,2,0,"https://fbref.com/en/players/00a17eba/Samuele-Perisan"
2023,"Empoli","Serie A","Roberto Piccoli","ITA","FW","21",2001,5.7,1,1,1,0,0,0,3,0,3,4,1,3,1,2,9,0,"https://fbref.com/en/players/1cadaf34/Roberto-Piccoli"
2023,"Empoli","Serie A","Marko Pjaca","CRO","MF,FW","27",1995,5.8,4,3,3,1,0,3,5,60,2,3,0,3,3,7,3,0,"https://fbref.com/en/players/2c38b327/Marko-Pjaca"
2023,"Empoli","Serie A","Martin Satriano","URU","FW","21",2001,18.9,13,8,5,6,2,6,14,42.9,8,5,0,5,3,16,22,0,"https://fbref.com/en/players/86383d0e/Martin-Satriano"
2023,"Empoli","Serie A","Petar Stojanović","SVN","DF","26",1995,17,42,22,28,10,4,26,43,60.5,17,17,5,12,11,53,55,0,"https://fbref.com/en/players/13b44b02/Petar-Stojanovic"
2023,"Empoli","Serie A","Lorenzo Tonelli","ITA","DF","32",1990,0.2,0,0,0,0,0,0,1,0,1,0,0,0,0,0,0,0,"https://fbref.com/en/players/8cc29864/Lorenzo-Tonelli"
2023,"Empoli","Serie A","Samir Ujkani","KVX","GK","34",1988,0.1,0,0,0,0,0,0,0,NA,0,0,0,0,0,0,0,0,"https://fbref.com/en/players/96640846/Samir-Ujkani"
2023,"Empoli","Serie A","Guglielmo Vicario","ITA","GK","25",1996,30.9,1,1,1,0,0,1,2,50,1,0,0,0,0,1,15,2,"https://fbref.com/en/players/77d6fd4d/Guglielmo-Vicario"
2023,"Empoli","Serie A","Emanuel Vignato","ITA","MF,FW","21",2000,0.6,2,0,2,0,0,0,0,NA,0,0,0,0,0,2,1,0,"https://fbref.com/en/players/ec5dae45/Emanuel-Vignato"
2023,"Empoli","Serie A","Sebastian Walukiewicz","POL","DF","22",2000,6.7,9,6,7,2,0,4,6,66.7,2,10,9,1,7,16,30,0,"https://fbref.com/en/players/217875a4/Sebastian-Walukiewicz"
2023,"Espanyol","La Liga","Keidi Bare","ALB","MF","24",1997,5.6,15,8,7,5,3,7,13,53.8,6,8,2,6,11,26,8,0,"https://fbref.com/en/players/03049c8c/Keidi-Bare"
2023,"Espanyol","La Liga","Wassim Boullif","ESP","DF","17",2005,1.6,3,1,3,0,0,2,3,66.7,1,5,4,1,0,3,3,0,"https://fbref.com/en/players/7f271d74/Wassim-Boullif"
2023,"Espanyol","La Liga","Martin Braithwaite","DEN","FW,MF","31",1991,27.3,12,2,2,4,6,5,14,35.7,9,10,0,10,5,17,11,0,"https://fbref.com/en/players/fd771f95/Martin-Braithwaite"
2023,"Espanyol","La Liga","Leandro Cabrera","URU","DF","31",1991,29.7,46,24,34,12,0,28,43,65.1,15,37,23,14,43,89,114,2,"https://fbref.com/en/players/69cbc8b6/Leandro-Cabrera"
2023,"Espanyol","La Liga","Fernando Calero","ESP","DF,MF","26",1995,17.9,46,29,27,15,4,21,34,61.8,13,31,13,18,13,59,52,0,"https://fbref.com/en/players/41b3069f/Fernando-Calero"
2023,"Espanyol","La Liga","José Carlos Lazo","ESP","MF,FW","26",1996,1.8,5,3,2,2,1,3,3,100,0,2,0,2,3,8,5,0,"https://fbref.com/en/players/5b93209a/Jose-Carlos-Lazo"
2023,"Espanyol","La Liga","Sergi Darder","ESP","MF","28",1993,36.9,69,38,12,43,14,29,73,39.7,44,34,2,32,24,93,23,0,"https://fbref.com/en/players/070a3904/Sergi-Darder"
2023,"Espanyol","La Liga","Adri Embarba","ESP","FW","30",1992,0.4,1,0,0,1,0,1,1,100,0,1,0,1,0,1,0,0,"https://fbref.com/en/players/db8f0eba/Adri-Embarba"
2023,"Espanyol","La Liga","Edu Expósito","ESP","MF","25",1996,12.9,34,20,16,15,3,13,23,56.5,10,7,0,7,12,46,20,0,"https://fbref.com/en/players/283c7121/Edu-Exposito"
2023,"Espanyol","La Liga","Álvaro Fernández","ESP","GK","24",1998,11,0,0,0,0,0,0,0,NA,0,0,0,0,0,0,7,2,"https://fbref.com/en/players/f127d782/Alvaro-Fernandez"
2023,"Espanyol","La Liga","Joan García","ESP","GK","21",2001,1,0,0,0,0,0,0,0,NA,0,0,0,0,0,0,0,0,"https://fbref.com/en/players/87b498b0/Joan-Garcia"
2023,"Espanyol","La Liga","Óscar Gil","ESP","DF","25",1997,28.4,63,37,38,16,9,32,61,52.5,29,51,18,33,31,94,55,1,"https://fbref.com/en/players/6652cf96/Oscar-Gil"
2023,"Espanyol","La Liga","Dani Gómez","ESP","MF,FW","24",1998,1,2,1,1,1,0,1,2,50,1,0,0,0,1,3,0,0,"https://fbref.com/en/players/0e5ddc7c/Dani-Gomez"
2023,"Espanyol","La Liga","Sergi Gómez","ESP","DF","30",1992,26,29,16,20,9,0,18,22,81.8,4,33,19,14,27,56,125,1,"https://fbref.com/en/players/bc6f5f06/Sergi-Gomez"
2023,"Espanyol","La Liga","José Gragera","ESP","MF,DF","21",2000,5.1,19,9,11,6,2,6,11,54.5,5,10,4,6,7,26,18,0,"https://fbref.com/en/players/ee45d138/Jose-Gragera"
2023,"Espanyol","La Liga","Omar El Hilali","MAR","DF,MF","18",2003,1,3,2,3,0,0,1,2,50,1,1,0,1,1,4,6,0,"https://fbref.com/en/players/139560df/Omar-El-Hilali"
2023,"Espanyol","La Liga","Joselu","ESP","FW","32",1990,33.2,13,11,3,4,6,4,17,23.5,13,25,4,21,8,21,43,0,"https://fbref.com/en/players/6265208f/Joselu"
2023,"Espanyol","La Liga","Luca Koleosho","ITA","FW,DF","17",2004,0.7,2,2,0,0,2,1,2,50,1,1,0,1,0,2,0,0,"https://fbref.com/en/players/fc076f78/Luca-Koleosho"
2023,"Espanyol","La Liga","Benjamin Lecomte","FRA","GK","31",1991,10,0,0,0,0,0,0,0,NA,0,0,0,0,0,0,3,2,"https://fbref.com/en/players/2fa2a875/Benjamin-Lecomte"
2023,"Espanyol","La Liga","Pol Lozano","ESP","MF","22",1999,0.2,0,0,0,0,0,0,0,NA,0,1,0,1,0,0,1,0,"https://fbref.com/en/players/ea610f00/Pol-Lozano"
2023,"Espanyol","La Liga","Roger Martínez","ESP","DF","18",2004,0.1,0,0,0,0,0,0,0,NA,0,0,0,0,0,0,0,0,"https://fbref.com/en/players/937c6ae6/Roger-Martinez"
2023,"Espanyol","La Liga","César Montes","MEX","DF","25",1997,17.7,17,9,10,7,0,10,18,55.6,8,19,12,7,14,31,101,0,"https://fbref.com/en/players/28e957d7/Cesar-Montes"
2023,"Espanyol","La Liga","Brian Oliván","ESP","DF","28",1994,26.7,47,27,30,12,5,17,26,65.4,9,26,6,20,22,69,67,0,"https://fbref.com/en/players/a3e4bf46/Brian-Olivan"
2023,"Espanyol","La Liga","Fernando Pacheco","ESP","GK","30",1992,16,0,0,0,0,0,0,1,0,1,0,0,0,1,1,11,0,"https://fbref.com/en/players/97852360/Fernando-Pacheco"
2023,"Espanyol","La Liga","Pedrosa","ESP","DF,MF","24",1998,2.5,5,1,5,0,0,4,7,57.1,3,1,1,0,5,10,3,0,"https://fbref.com/en/players/112521d1/Pedrosa"
2023,"Espanyol","La Liga","Ronaël Pierre-Gabriel","FRA","DF","24",1998,2.6,17,9,12,4,1,5,11,45.5,6,5,2,3,9,26,11,0,"https://fbref.com/en/players/64ba07c0/Ronael-Pierre-Gabriel"
2023,"Espanyol","La Liga","Javi Puado","ESP","FW,MF","24",1998,26,20,11,12,5,3,12,28,42.9,16,12,2,10,10,30,14,0,"https://fbref.com/en/players/2683eda7/Javi-Puado"
2023,"Espanyol","La Liga","Nico Ribaudo","ESP","MF,FW","21",2001,13.9,18,13,5,9,4,11,30,36.7,19,19,1,18,5,23,1,0,"https://fbref.com/en/players/ce8039aa/Nico-Ribaudo"
2023,"Espanyol","La Liga","Rubén","ESP","DF,MF","21",2001,9.9,30,15,18,9,3,20,29,69,9,14,4,10,18,48,18,0,"https://fbref.com/en/players/35d4f151/Ruben"
2023,"Espanyol","La Liga","Vinicius Souza","BRA","MF","23",1999,27,99,66,41,45,13,33,59,55.9,26,31,14,17,48,147,50,1,"https://fbref.com/en/players/6a8a7af8/Vinicius-Souza"
2023,"Espanyol","La Liga","Denis Suárez","ESP","MF,FW","28",1994,10.5,26,20,12,12,2,13,45,28.9,32,11,1,10,5,31,4,0,"https://fbref.com/en/players/12c50af5/Denis-Suarez"
2023,"Espanyol","La Liga","Nabil Touaizi","MAR","MF","21",2001,0,0,0,0,0,0,0,0,NA,0,0,0,0,0,0,0,0,"https://fbref.com/en/players/e96b2583/Nabil-Touaizi"
2023,"Espanyol","La Liga","Aleix Vidal","ESP","MF,FW","32",1989,11.4,11,5,6,3,2,4,22,18.2,18,21,2,19,15,26,14,0,"https://fbref.com/en/players/04965583/Aleix-Vidal"
2023,"Everton","Premier League","Dele Alli","ENG","MF","26",1996,0.4,0,0,0,0,0,0,0,NA,0,0,0,0,0,0,0,0,"https://fbref.com/en/players/cea4ee8f/Dele-Alli"
2023,"Everton","Premier League","Asmir Begović","BIH","GK","35",1987,1,0,0,0,0,0,0,0,NA,0,0,0,0,0,0,1,0,"https://fbref.com/en/players/7b4de647/Asmir-Begovic"
2023,"Everton","Premier League","Dominic Calvert-Lewin","ENG","FW","25",1997,12.9,4,2,1,0,3,1,5,20,4,5,1,4,3,7,18,0,"https://fbref.com/en/players/59e6e5bf/Dominic-Calvert-Lewin"
2023,"Everton","Premier League","Thomas Cannon","IRL","FW","19",2002,0.3,0,0,0,0,0,0,0,NA,0,0,0,0,0,0,0,0,"https://fbref.com/en/players/4506aec5/Thomas-Cannon"
2023,"Everton","Premier League","Conor Coady","ENG","DF","29",1993,23.3,14,9,8,6,0,7,15,46.7,8,21,17,4,14,28,88,3,"https://fbref.com/en/players/2928dca2/Conor-Coady"
2023,"Everton","Premier League","Séamus Coleman","IRL","DF","33",1988,18.4,35,26,21,10,4,19,29,65.5,10,14,7,7,22,57,58,2,"https://fbref.com/en/players/0420d84f/Seamus-Coleman"
2023,"Everton","Premier League","Tom Davies","ENG","MF","24",1998,6,15,9,5,9,1,7,14,50,7,10,1,9,4,19,7,1,"https://fbref.com/en/players/9228b07c/Tom-Davies"
2023,"Everton","Premier League","Abdoulaye Doucouré","MLI","MF","29",1993,17,31,20,9,15,7,12,37,32.4,25,26,3,23,13,44,11,0,"https://fbref.com/en/players/02b29014/Abdoulaye-Doucoure"
2023,"Everton","Premier League","Idrissa Gana Gueye","SEN","MF","32",1989,28.6,97,57,49,35,13,31,60,51.7,29,50,12,38,56,153,34,3,"https://fbref.com/en/players/72c812f3/Idrissa-Gana-Gueye"
2023,"Everton","Premier League","James Garner","ENG","MF,DF","21",2001,8.9,16,13,4,8,4,9,19,47.4,10,9,1,8,12,28,13,0,"https://fbref.com/en/players/4e015693/James-Garner"
2023,"Everton","Premier League","Ben Godfrey","ENG","DF","24",1998,8.9,20,11,13,5,2,11,29,37.9,18,12,6,6,8,28,33,1,"https://fbref.com/en/players/9f7c837d/Ben-Godfrey"
2023,"Everton","Premier League","Anthony Gordon","ENG","FW","21",2001,12.2,34,22,17,10,7,8,23,34.8,15,19,0,19,4,38,11,0,"https://fbref.com/en/players/2bd83368/Anthony-Gordon"
2023,"Everton","Premier League","Demarai Gray","JAM","FW,MF","26",1996,27.9,33,24,9,14,10,17,31,54.8,14,23,3,20,13,46,18,0,"https://fbref.com/en/players/4468ec10/Demarai-Gray"
2023,"Everton","Premier League","Mason Holgate","ENG","DF","25",1996,5.6,11,7,8,3,0,3,11,27.3,8,7,3,4,7,18,28,0,"https://fbref.com/en/players/d0042ab9/Mason-Holgate"
2023,"Everton","Premier League","Alex Iwobi","NGA","MF,FW","26",1996,37.5,69,37,37,28,4,33,65,50.8,32,41,2,39,25,94,29,0,"https://fbref.com/en/players/6ca5ec4b/Alex-Iwobi"
2023,"Everton","Premier League","Michael Keane","ENG","DF","29",1993,10.9,7,4,5,2,0,5,8,62.5,3,12,7,5,14,21,55,1,"https://fbref.com/en/players/c5b7c315/Michael-Keane"
2023,"Everton","Premier League","Neal Maupay","FRA","FW","25",1996,12.4,11,5,3,4,4,2,4,50,2,8,0,8,5,16,0,0,"https://fbref.com/en/players/4bcf39f6/Neal-Maupay"
2023,"Everton","Premier League","Dwight McNeil","ENG","FW,MF","22",1999,27.8,64,41,35,14,15,27,62,43.5,35,46,7,39,31,95,41,0,"https://fbref.com/en/players/fc15fb84/Dwight-McNeil"
2023,"Everton","Premier League","Yerry Mina","COL","DF","27",1994,6.6,15,8,9,6,0,9,11,81.8,2,7,4,3,6,21,28,0,"https://fbref.com/en/players/6d5701f2/Yerry-Mina"
2023,"Everton","Premier League","Vitaliy Mykolenko","UKR","DF","23",1999,29.5,58,34,36,19,3,28,51,54.9,23,50,16,34,46,104,99,0,"https://fbref.com/en/players/30d4a2e5/Vitaliy-Mykolenko"
2023,"Everton","Premier League","Amadou Onana","BEL","MF","20",2001,27.6,72,43,24,42,6,30,42,71.4,12,25,6,19,37,109,39,0,"https://fbref.com/en/players/828657ff/Amadou-Onana"
2023,"Everton","Premier League","Nathan Patterson","SCO","DF,MF","20",2001,14.2,49,24,32,13,4,29,53,54.7,24,24,4,20,15,64,45,0,"https://fbref.com/en/players/230f0471/Nathan-Patterson"
2023,"Everton","Premier League","Jordan Pickford","ENG","GK","28",1994,37,0,0,0,0,0,0,1,0,1,0,0,0,4,4,15,3,"https://fbref.com/en/players/4806ec67/Jordan-Pickford"
2023,"Everton","Premier League","Isaac Price","NIR","MF","18",2003,0.4,0,0,0,0,0,0,1,0,1,1,1,0,0,0,0,0,"https://fbref.com/en/players/b9403c99/Isaac-Price"
2023,"Everton","Premier League","Salomón Rondón","VEN","FW","32",1989,1.2,0,0,0,0,0,0,0,NA,0,1,1,0,0,0,0,0,"https://fbref.com/en/players/b318a643/Salomon-Rondon"
2023,"Everton","Premier League","Ellis Simms","ENG","FW","21",2001,2.5,0,0,0,0,0,0,0,NA,0,0,0,0,0,0,1,0,"https://fbref.com/en/players/26d3b5be/Ellis-Simms"
2023,"Everton","Premier League","James Tarkowski","ENG","DF","29",1992,38,51,26,36,13,2,20,38,52.6,18,99,78,21,51,102,201,3,"https://fbref.com/en/players/15ea812b/James-Tarkowski"
2023,"Everton","Premier League","Rúben Vinagre","POR","DF,MF","23",1999,0.3,2,2,1,1,0,1,2,50,1,0,0,0,0,2,1,0,"https://fbref.com/en/players/b937e490/Ruben-Vinagre"
2023,"Fiorentina","Serie A","Sofyan Amrabat","MAR","MF","25",1996,22.2,39,24,15,17,7,16,29,55.2,13,23,5,18,21,60,18,2,"https://fbref.com/en/players/5a2cb25d/Sofyan-Amrabat"
2023,"Fiorentina","Serie A","Arthur","BRA","FW","24",1998,15.9,9,2,1,4,4,4,8,50,4,10,1,9,1,10,12,0,"https://fbref.com/en/players/a820e429/Arthur"
2023,"Fiorentina","Serie A","Antonín Barák","CZE","MF","27",1994,20,21,9,5,7,9,6,16,37.5,10,16,2,14,3,24,13,0,"https://fbref.com/en/players/01efac19/Antonin-Barak"
2023,"Fiorentina","Serie A","Marco Benassi","ITA","DF","27",1994,1,3,3,2,0,1,3,4,75,1,0,0,0,1,4,1,0,"https://fbref.com/en/players/0000acda/Marco-Benassi"
2023,"Fiorentina","Serie A","Alessandro Bianco","ITA","MF","19",2002,1.7,5,2,2,3,0,2,3,66.7,1,1,0,1,0,5,0,0,"https://fbref.com/en/players/d65cf468/Alessandro-Bianco"
2023,"Fiorentina","Serie A","Cristiano Biraghi","ITA","DF","29",1992,28.3,65,38,29,29,7,32,65,49.2,33,32,7,25,14,79,42,1,"https://fbref.com/en/players/9e1577aa/Cristiano-Biraghi"
2023,"Fiorentina","Serie A","Giacomo Bonaventura","ITA","MF","32",1989,21.2,35,23,14,15,6,24,37,64.9,13,14,0,14,16,51,5,1,"https://fbref.com/en/players/d995ed27/Giacomo-Bonaventura"
2023,"Fiorentina","Serie A","Josip Brekalo","CRO","FW,MF","24",1998,2.5,2,1,0,1,1,1,4,25,3,1,0,1,1,3,1,0,"https://fbref.com/en/players/d4a2533d/Josip-Brekalo"
2023,"Fiorentina","Serie A","Gaetano Castrovilli","ITA","MF","25",1997,8,10,8,1,7,2,2,9,22.2,7,5,1,4,8,18,5,0,"https://fbref.com/en/players/0728bebe/Gaetano-Castrovilli"
2023,"Fiorentina","Serie A","Michele Cerofolini","ITA","GK","23",1999,5,0,0,0,0,0,0,0,NA,0,0,0,0,1,1,2,0,"https://fbref.com/en/players/efdeaff3/Michele-Cerofolini"
2023,"Fiorentina","Serie A","Dodô","BRA","DF","23",1998,25.9,40,22,20,14,6,22,46,47.8,24,26,2,24,25,65,37,0,"https://fbref.com/en/players/b5f7d10b/Dodo"
2023,"Fiorentina","Serie A","Alfred Duncan","GHA","MF","29",1993,12.3,18,10,0,17,1,10,21,47.6,11,9,0,9,8,26,6,0,"https://fbref.com/en/players/528492ea/Alfred-Duncan"
2023,"Fiorentina","Serie A","Pierluigi Gollini","ITA","GK","27",1995,3,1,0,1,0,0,1,1,100,0,0,0,0,0,1,2,0,"https://fbref.com/en/players/f0f7f62f/Pierluigi-Gollini"
2023,"Fiorentina","Serie A","Nicolás González","ARG","FW,MF","24",1998,15,17,10,3,10,4,5,16,31.3,11,14,0,14,4,21,6,0,"https://fbref.com/en/players/2374aaca/Nicolas-Gonzalez"
2023,"Fiorentina","Serie A","Igor","BRA","DF","24",1998,22.9,43,29,21,18,4,20,27,74.1,7,33,14,19,25,68,56,2,"https://fbref.com/en/players/a4e85758/Igor"
2023,"Fiorentina","Serie A","Jonathan Ikone","FRA","FW","24",1998,22.3,16,8,5,6,5,5,14,35.7,9,18,1,17,4,20,3,0,"https://fbref.com/en/players/42eaa028/Jonathan-Ikone"
2023,"Fiorentina","Serie A","Luka Jović","SRB","FW,MF","24",1997,17,6,3,1,4,1,2,8,25,6,7,2,5,2,8,10,0,"https://fbref.com/en/players/4d8cd038/Luka-Jovic"
2023,"Fiorentina","Serie A","Christian Kouamé","CIV","FW","24",1997,20.7,27,18,8,10,9,7,14,50,7,15,3,12,12,39,8,0,"https://fbref.com/en/players/58e933d2/Christian-Kouame"
2023,"Fiorentina","Serie A","Youssef Maleh","MAR","MF","23",1998,3.3,3,1,0,3,0,0,4,0,4,5,0,5,1,4,3,0,"https://fbref.com/en/players/4c8845f7/Youssef-Maleh"
2023,"Fiorentina","Serie A","Rolando Mandragora","ITA","MF","25",1997,21.7,42,24,12,22,8,23,52,44.2,29,25,3,22,16,58,21,0,"https://fbref.com/en/players/c7259b83/Rolando-Mandragora"
2023,"Fiorentina","Serie A","Lucas Martínez Quarta","ARG","DF","26",1996,24.1,80,48,44,32,4,42,61,68.9,19,41,19,22,48,128,78,1,"https://fbref.com/en/players/3ec3c1c9/Lucas-Martinez-Quarta"
2023,"Fiorentina","Serie A","Nikola Milenković","SRB","DF","24",1997,23.7,40,25,20,17,3,18,27,66.7,9,27,14,13,22,62,72,0,"https://fbref.com/en/players/bee704fc/Nikola-Milenkovic"
2023,"Fiorentina","Serie A","Luca Ranieri","ITA","DF","23",1999,5.6,9,4,6,3,0,6,9,66.7,3,5,3,2,11,20,15,1,"https://fbref.com/en/players/8c63fae5/Luca-Ranieri"
2023,"Fiorentina","Serie A","Riccardo Saponara","ITA","FW","30",1991,13.4,10,5,3,6,1,5,9,55.6,4,7,1,6,5,15,9,1,"https://fbref.com/en/players/3bb7af3b/Riccardo-Saponara"
2023,"Fiorentina","Serie A","Salvatore Sirigu","ITA","GK","35",1987,1,0,0,0,0,0,0,0,NA,0,0,0,0,0,0,1,0,"https://fbref.com/en/players/10dc46f0/Salvatore-Sirigu"
2023,"Fiorentina","Serie A","Riccardo Sottil","ITA","FW","23",1999,9.3,4,3,2,0,2,2,5,40,3,2,0,2,0,4,0,0,"https://fbref.com/en/players/94816803/Riccardo-Sottil"
2023,"Fiorentina","Serie A","Pietro Terracciano","ITA","GK","32",1990,29,2,1,2,0,0,2,3,66.7,1,0,0,0,1,3,14,0,"https://fbref.com/en/players/e1b0a70d/Pietro-Terracciano"
2023,"Fiorentina","Serie A","Aleksa Terzić","SRB","DF","22",1999,10.4,16,9,9,4,3,11,21,52.4,10,13,4,9,5,21,16,0,"https://fbref.com/en/players/3ef0a2d7/Aleksa-Terzic"
2023,"Fiorentina","Serie A","Lorenzo Venuti","ITA","DF","27",1995,10.3,18,7,6,11,1,11,18,61.1,7,7,2,5,5,23,17,2,"https://fbref.com/en/players/983ff2c7/Lorenzo-Venuti"
2023,"Fiorentina","Serie A","Szymon Żurkowski","POL","MF","24",1997,0.4,0,0,0,0,0,0,0,NA,0,0,0,0,0,0,0,0,"https://fbref.com/en/players/4e1d5e59/Szymon-Zurkowski"
2023,"Freiburg","Bundesliga","Ritsu Doan","JPN","MF,FW","24",1998,26.9,61,29,19,29,13,25,54,46.3,29,40,1,39,14,75,12,0,"https://fbref.com/en/players/d01bbb6f/Ritsu-Doan"
2023,"Freiburg","Bundesliga","Maximilian Eggestein","GER","MF","25",1996,27.2,51,29,21,24,6,17,35,48.6,18,37,8,29,36,87,27,0,"https://fbref.com/en/players/beb882a8/Maximilian-Eggestein"
2023,"Freiburg","Bundesliga","Kimberly Ezekwem","GER","DF","21",2001,0.1,0,0,0,0,0,0,0,NA,0,1,0,1,0,0,0,0,"https://fbref.com/en/players/56e6a1c9/Kimberly-Ezekwem"
2023,"Freiburg","Bundesliga","Mark Flekken","NED","GK","29",1993,34,0,0,0,0,0,0,1,0,1,1,0,1,0,0,9,5,"https://fbref.com/en/players/a92ab7be/Mark-Flekken"
2023,"Freiburg","Bundesliga","Matthias Ginter","GER","DF","28",1994,34,43,20,29,12,2,26,40,65,14,40,24,16,35,78,153,3,"https://fbref.com/en/players/f521b80a/Matthias-Ginter"
2023,"Freiburg","Bundesliga","Michael Gregoritsch","AUT","FW","28",1994,23.9,19,12,6,9,4,3,21,14.3,18,23,4,19,5,24,10,0,"https://fbref.com/en/players/8e235926/Michael-Gregoritsch"
2023,"Freiburg","Bundesliga","Vincenzo Grifo","ITA","MF,FW","29",1993,26.8,29,16,6,15,8,13,31,41.9,18,18,1,17,19,48,19,0,"https://fbref.com/en/players/54e4866f/Vincenzo-Grifo"
2023,"Freiburg","Bundesliga","Manuel Gulde","GER","DF","31",1991,7.1,14,8,10,4,0,2,4,50,2,5,1,4,19,33,25,0,"https://fbref.com/en/players/25ab9c9c/Manuel-Gulde"
2023,"Freiburg","Bundesliga","Christian Günter","GER","DF,MF","29",1993,30.5,29,21,18,9,2,13,43,30.2,30,22,4,18,16,45,41,0,"https://fbref.com/en/players/8593f88c/Christian-Gunter"
2023,"Freiburg","Bundesliga","Nicolas Höfler","GER","MF","32",1990,31.3,66,35,28,35,3,27,61,44.3,34,40,13,27,58,124,49,0,"https://fbref.com/en/players/5d8e331f/Nicolas-Hofler"
2023,"Freiburg","Bundesliga","Lucas Höler","GER","FW,MF","28",1994,16.7,19,14,5,7,7,6,22,27.3,16,22,5,17,10,29,17,0,"https://fbref.com/en/players/ca618d23/Lucas-Holer"
2023,"Freiburg","Bundesliga","Yannik Keitel","GER","MF","22",2000,7.6,11,7,4,6,1,3,5,60,2,6,3,3,13,24,8,0,"https://fbref.com/en/players/d2c580ce/Yannik-Keitel"
2023,"Freiburg","Bundesliga","Lukas Kübler","GER","DF","29",1992,18.2,37,25,24,9,4,18,30,60,12,25,11,14,29,66,50,0,"https://fbref.com/en/players/2a29eb9b/Lukas-Kubler"
2023,"Freiburg","Bundesliga","Daniel Kyereh","GHA","MF,FW","26",1996,6.2,6,4,2,4,0,3,6,50,3,4,0,4,2,8,6,0,"https://fbref.com/en/players/2770726a/Daniel-Kyereh"
2023,"Freiburg","Bundesliga","Philipp Lienhart","AUT","DF","26",1996,27.8,29,18,19,10,0,13,27,48.1,14,29,15,14,35,64,97,0,"https://fbref.com/en/players/302527b2/Philipp-Lienhart"
2023,"Freiburg","Bundesliga","Nils Petersen","GER","FW","33",1988,3.1,6,4,0,3,3,2,5,40,3,11,2,9,1,7,6,0,"https://fbref.com/en/players/f93e6e94/Nils-Petersen"
2023,"Freiburg","Bundesliga","Merlin Röhl","GER","MF,FW","20",2002,0.6,1,0,1,0,0,0,0,NA,0,0,0,0,0,1,1,0,"https://fbref.com/en/players/1f2c7b55/Merlin-Rohl"
2023,"Freiburg","Bundesliga","Roland Sallai","HUN","MF,FW","25",1997,11.1,11,8,4,3,4,4,10,40,6,7,1,6,2,13,11,0,"https://fbref.com/en/players/bf075f6b/Roland-Sallai"
2023,"Freiburg","Bundesliga","Kevin Schade","GER","FW,MF","20",2001,2,6,4,3,2,1,3,5,60,2,0,0,0,0,6,2,0,"https://fbref.com/en/players/52afb588/Kevin-Schade"
2023,"Freiburg","Bundesliga","Keven Schlotterbeck","GER","DF","25",1997,0.2,0,0,0,0,0,0,0,NA,0,1,1,0,2,2,2,0,"https://fbref.com/en/players/f6bdc830/Keven-Schlotterbeck"
2023,"Freiburg","Bundesliga","Jonathan Schmid","FRA","DF","32",1990,0.5,1,1,1,0,0,0,0,NA,0,1,0,1,1,2,1,1,"https://fbref.com/en/players/088ca1bd/Jonathan-Schmid"
2023,"Freiburg","Bundesliga","Kenneth Schmidt","GER","DF","20",2002,2.8,6,3,4,2,0,5,6,83.3,1,4,2,2,0,6,2,0,"https://fbref.com/en/players/7d31f1cb/Kenneth-Schmidt"
2023,"Freiburg","Bundesliga","Kiliann Sildillia","FRA","DF,MF","20",2002,22,33,20,10,19,4,18,30,60,12,24,9,15,21,54,47,1,"https://fbref.com/en/players/313254a3/Kiliann-Sildillia"
2023,"Freiburg","Bundesliga","Hugo Siquet","BEL","DF","20",2002,0.2,2,2,2,0,0,2,2,100,0,1,0,1,0,2,0,0,"https://fbref.com/en/players/c6cf860f/Hugo-Siquet"
2023,"Freiburg","Bundesliga","Robert Wagner","GER","MF","19",2003,0.4,0,0,0,0,0,0,0,NA,0,2,0,2,0,0,2,0,"https://fbref.com/en/players/e3d3fbeb/Robert-Wagner"
2023,"Freiburg","Bundesliga","Noah Weißhaupt","GER","MF,DF","20",2001,4.7,11,6,3,7,1,2,7,28.6,5,4,0,4,6,17,8,0,"https://fbref.com/en/players/dd676a97/Noah-Weisshaupt"
2023,"Freiburg","Bundesliga","Jeong Woo-yeong","KOR","MF,FW","22",1999,7.3,7,3,4,2,1,2,5,40,3,7,1,6,1,8,7,0,"https://fbref.com/en/players/6190474d/Jeong-Woo-yeong"
2023,"Fulham","Premier League","Tosin Adarabioyo","ENG","DF","24",1997,23.2,30,13,22,6,2,16,23,69.6,7,20,15,5,26,56,140,1,"https://fbref.com/en/players/c81d773d/Tosin-Adarabioyo"
2023,"Fulham","Premier League","Tom Cairney","SCO","MF","31",1991,11,17,6,4,8,5,7,10,70,3,18,3,15,5,22,3,0,"https://fbref.com/en/players/a8748947/Tom-Cairney"
2023,"Fulham","Premier League","Nathaniel Chalobah","ENG","MF","27",1994,0.1,1,1,1,0,0,1,1,100,0,0,0,0,0,1,2,0,"https://fbref.com/en/players/422862ea/Nathaniel-Chalobah"
2023,"Fulham","Premier League","Issa Diop","FRA","DF","25",1997,22.4,28,19,18,9,1,17,32,53.1,15,24,17,7,35,63,86,0,"https://fbref.com/en/players/a712ca2b/Issa-Diop"
2023,"Fulham","Premier League","Shane Duffy","IRL","DF,FW","30",1992,0.2,0,0,0,0,0,0,0,NA,0,0,0,0,0,0,0,1,"https://fbref.com/en/players/7314bba4/Shane-Duffy"
2023,"Fulham","Premier League","Tyrese Francois","AUS","FW","22",2000,0,0,0,0,0,0,0,0,NA,0,0,0,0,0,0,1,0,"https://fbref.com/en/players/6722d4f0/Tyrese-Francois"
2023,"Fulham","Premier League","Luke Harris","WAL","MF,FW","17",2005,0.1,0,0,0,0,0,0,0,NA,0,0,0,0,0,0,0,0,"https://fbref.com/en/players/8c3078cd/Luke-Harris"
2023,"Fulham","Premier League","Daniel James","WAL","FW","24",1997,6.9,9,5,4,4,1,4,8,50,4,5,1,4,1,10,5,0,"https://fbref.com/en/players/c931d9f9/Daniel-James"
2023,"Fulham","Premier League","Neeskens Kebano","COD","FW","30",1992,8.5,17,9,8,6,3,9,17,52.9,8,14,0,14,1,18,8,0,"https://fbref.com/en/players/18b999f4/Neeskens-Kebano"
2023,"Fulham","Premier League","Layvin Kurzawa","FRA","DF","29",1992,1.5,3,2,1,1,1,3,3,100,0,1,1,0,2,5,4,0,"https://fbref.com/en/players/41e7ef1c/Layvin-Kurzawa"
2023,"Fulham","Premier League","Bernd Leno","GER","GK","30",1992,36,0,0,0,0,0,0,2,0,2,0,0,0,0,0,18,0,"https://fbref.com/en/players/2628fd2b/Bernd-Leno"
2023,"Fulham","Premier League","Saša Lukić","SRB","MF","25",1996,4.6,8,3,1,4,3,3,7,42.9,4,6,2,4,5,13,3,0,"https://fbref.com/en/players/c6e8cf1f/Sasa-Lukic"
2023,"Fulham","Premier League","Kevin Mbabu","SUI","DF,FW","27",1995,1.6,3,2,2,1,0,1,3,33.3,2,2,0,2,3,6,3,0,"https://fbref.com/en/players/493924a7/Kevin-Mbabu"
2023,"Fulham","Premier League","Aleksandar Mitrović","SRB","FW","27",1994,22.3,14,7,8,4,2,5,12,41.7,7,22,5,17,3,17,20,1,"https://fbref.com/en/players/3925dbd6/Aleksandar-Mitrovic"
2023,"Fulham","Premier League","Josh Onomah","ENG","MF","25",1997,0.2,1,0,1,0,0,0,0,NA,0,1,0,1,0,1,0,0,"https://fbref.com/en/players/6612cd8c/Josh-Onomah"
2023,"Fulham","Premier League","João Palhinha","POR","MF","27",1995,34.5,147,83,58,65,24,71,134,53,63,48,5,43,46,193,61,2,"https://fbref.com/en/players/a78ff07f/Joao-Palhinha"
2023,"Fulham","Premier League","Andreas Pereira","BRA","MF","26",1996,29.9,18,9,3,6,9,8,33,24.2,25,21,3,18,6,24,8,0,"https://fbref.com/en/players/6639e500/Andreas-Pereira"
2023,"Fulham","Premier League","Tim Ream","USA","DF","34",1987,32.2,30,16,15,12,3,13,26,50,13,45,24,21,41,71,116,2,"https://fbref.com/en/players/28b40c9c/Tim-Ream"
2023,"Fulham","Premier League","Harrison Reed","ENG","MF","27",1995,31.8,44,27,17,21,6,16,50,32,34,54,12,42,19,63,36,0,"https://fbref.com/en/players/803ae100/Harrison-Reed"
2023,"Fulham","Premier League","Bobby Reid","JAM","FW,DF","29",1993,27.5,42,24,14,14,14,16,34,47.1,18,25,3,22,20,62,28,1,"https://fbref.com/en/players/0f7533cd/Bobby-Reid"
2023,"Fulham","Premier League","Antonee Robinson","USA","DF","24",1997,34.3,62,38,43,15,4,44,65,67.7,21,49,13,36,53,115,83,3,"https://fbref.com/en/players/289601e6/Antonee-Robinson"
2023,"Fulham","Premier League","Marek Rodák","SVK","GK","25",1996,2,0,0,0,0,0,0,0,NA,0,0,0,0,0,0,1,1,"https://fbref.com/en/players/17acc2ed/Marek-Rodak"
2023,"Fulham","Premier League","Cédric Soares","POR","DF","30",1991,2.2,8,5,4,3,1,3,3,100,0,3,1,2,1,9,5,0,"https://fbref.com/en/players/839c14e1/Cedric-Soares"
2023,"Fulham","Premier League","Manor Solomon","ISR","FW","23",1999,6.4,20,12,12,6,2,9,16,56.3,7,8,0,8,5,25,3,0,"https://fbref.com/en/players/886f9aac/Manor-Solomon"
2023,"Fulham","Premier League","Jay Stansfield","ENG","FW","19",2002,1,0,0,0,0,0,0,2,0,2,4,1,3,1,1,1,0,"https://fbref.com/en/players/b2626673/Jay-Stansfield"
2023,"Fulham","Premier League","Kenny Tete","NED","DF","26",1995,28.5,83,46,41,29,13,38,50,76,12,48,17,31,52,135,81,1,"https://fbref.com/en/players/77d7c96f/Kenny-Tete"
2023,"Fulham","Premier League","Carlos Vinícius","BRA","FW","27",1995,12.3,4,1,0,2,2,0,4,0,4,7,0,7,0,4,10,0,"https://fbref.com/en/players/8b529245/Carlos-Vinicius"
2023,"Fulham","Premier League","Willian","BRA","FW","33",1988,23.6,13,8,8,3,2,7,25,28,18,13,0,13,9,22,9,0,"https://fbref.com/en/players/8b9ebd03/Willian"
2023,"Fulham","Premier League","Harry Wilson","WAL","FW","25",1997,12.2,21,13,9,9,3,8,18,44.4,10,17,2,15,6,27,14,0,"https://fbref.com/en/players/c6dc9ecd/Harry-Wilson"
2023,"Getafe","La Liga","Omar Alderete","PAR","DF","25",1996,22.7,35,20,21,14,0,28,40,70,12,23,16,7,26,61,85,0,"https://fbref.com/en/players/bb08bce9/Omar-Alderete"
2023,"Getafe","La Liga","Carles Aleñá","ESP","MF,FW","24",1998,23.5,18,10,7,5,6,5,34,14.7,29,19,1,18,4,22,18,0,"https://fbref.com/en/players/6c811eb7/Carles-Alena"
2023,"Getafe","La Liga","Ángel Algobia","ESP","MF","23",1999,12.6,27,13,14,13,0,22,48,45.8,26,15,5,10,3,30,11,0,"https://fbref.com/en/players/acc1aefa/Angel-Algobia"
2023,"Getafe","La Liga","Gastón Álvarez","URU","DF","22",2000,16.7,38,30,24,9,5,23,42,54.8,19,15,5,10,15,53,35,0,"https://fbref.com/en/players/852ddfb8/Gaston-Alvarez"
2023,"Getafe","La Liga","Jordan Amavi","FRA","DF","28",1994,2.2,3,2,3,0,0,1,3,33.3,2,3,0,3,4,7,7,0,"https://fbref.com/en/players/22721b88/Jordan-Amavi"
2023,"Getafe","La Liga","Fabrizio Angileri","ARG","DF","28",1994,6.5,12,9,8,3,1,10,17,58.8,7,8,3,5,7,19,10,0,"https://fbref.com/en/players/fdd26d71/Fabrizio-Angileri"
2023,"Getafe","La Liga","Mauro Arambarri","URU","MF","26",1995,11,14,6,9,4,1,3,17,17.6,14,17,5,12,14,28,19,0,"https://fbref.com/en/players/58afe001/Mauro-Arambarri"
2023,"Getafe","La Liga","Djené","TOG","DF","30",1991,31.6,41,28,23,17,1,22,38,57.9,16,25,10,15,42,83,81,1,"https://fbref.com/en/players/a4971d84/Djene"
2023,"Getafe","La Liga","Domingos Duarte","POR","DF","27",1995,29.5,26,18,21,5,0,19,26,73.1,7,29,23,6,39,65,145,0,"https://fbref.com/en/players/93090f69/Domingos-Duarte"
2023,"Getafe","La Liga","Munir El Haddadi","MAR","MF,FW","26",1995,12.8,12,7,3,7,2,2,10,20,8,23,2,21,9,21,7,0,"https://fbref.com/en/players/8696bc90/Munir-El-Haddadi"
2023,"Getafe","La Liga","Iglesias","ESP","DF,MF","24",1998,23.8,61,35,40,18,3,33,65,50.8,32,40,5,35,21,82,91,1,"https://fbref.com/en/players/974322dc/Iglesias"
2023,"Getafe","La Liga","Latasa","ESP","FW","21",2001,5,5,4,2,0,3,1,1,100,0,3,1,2,1,6,8,0,"https://fbref.com/en/players/2bea832e/Latasa"
2023,"Getafe","La Liga","Nemanja Maksimović","SRB","MF","27",1995,22.8,41,30,17,18,6,19,32,59.4,13,36,14,22,34,75,27,0,"https://fbref.com/en/players/00b28772/Nemanja-Maksimovic"
2023,"Getafe","La Liga","Jaime Mata","ESP","FW,MF","33",1988,4.9,13,10,4,5,4,7,22,31.8,15,7,2,5,3,16,6,0,"https://fbref.com/en/players/02319ad7/Jaime-Mata"
2023,"Getafe","La Liga","Borja Mayoral","ESP","FW","25",1997,30.7,9,4,7,2,0,5,31,16.1,26,18,0,18,3,12,10,0,"https://fbref.com/en/players/64e8ed6d/Borja-Mayoral"
2023,"Getafe","La Liga","Luis Milla","ESP","MF","27",1994,20.6,48,30,21,18,9,19,44,43.2,25,13,1,12,32,80,25,1,"https://fbref.com/en/players/19c36442/Luis-Milla"
2023,"Getafe","La Liga","Stefan Mitrović","SRB","DF","32",1990,18.7,14,6,12,2,0,7,11,63.6,4,12,10,2,17,31,90,2,"https://fbref.com/en/players/e6777e6b/Stefan-Mitrovic"
2023,"Getafe","La Liga","Moises Parra Gutierrez","ESP","FW","20",2002,0.1,1,0,0,1,0,0,0,NA,0,0,0,0,0,1,0,0,"https://fbref.com/en/players/e2dcc60e/Moises-Parra-Gutierrez"
2023,"Getafe","La Liga","Portu","ESP","MF,DF","30",1992,19.7,28,21,14,10,4,18,42,42.9,24,23,3,20,17,45,20,1,"https://fbref.com/en/players/1bda5842/Portu"
2023,"Getafe","La Liga","Alejandro Revuelta Montero","ESP","DF","22",2000,0,0,0,0,0,0,0,0,NA,0,0,0,0,0,0,1,0,"https://fbref.com/en/players/14d5b7ac/Alejandro-Revuelta-Montero"
2023,"Getafe","La Liga","Jaime Seoane","ESP","MF,FW","25",1997,3.6,10,4,3,4,3,2,8,25,6,7,3,4,1,11,2,0,"https://fbref.com/en/players/a62b4888/Jaime-Seoane"
2023,"Getafe","La Liga","David Soria","ESP","GK","29",1993,38,0,0,0,0,0,0,1,0,1,0,0,0,1,1,20,4,"https://fbref.com/en/players/8f8c6934/David-Soria"
2023,"Getafe","La Liga","Damián Suárez","URU","DF,MF","34",1988,21.6,49,33,23,19,7,26,48,54.2,22,40,0,40,15,64,36,0,"https://fbref.com/en/players/ba5004e1/Damian-Suarez"
2023,"Getafe","La Liga","Enes Ünal","TUR","FW","25",1997,33,26,14,5,19,2,7,25,28,18,19,2,17,6,32,35,0,"https://fbref.com/en/players/f8eca1b6/Enes-Unal"
2023,"Getafe","La Liga","Gonzalo Villar","ESP","MF","24",1998,5.1,10,5,1,6,3,6,14,42.9,8,9,2,7,6,16,5,0,"https://fbref.com/en/players/bdc74a8f/Gonzalo-Villar"
2023,"Girona","La Liga","Ricard Artero","ESP","MF,FW","19",2003,1.5,3,3,2,1,0,1,1,100,0,2,0,2,1,4,3,0,"https://fbref.com/en/players/5d133e96/Ricard-Artero"
2023,"Girona","La Liga","Santiago Bueno","URU","DF","23",1998,33.4,63,38,43,19,1,24,36,66.7,12,34,22,12,31,94,105,2,"https://fbref.com/en/players/edc98fac/Santiago-Bueno"
2023,"Girona","La Liga","Alexander Callens","PER","DF","30",1992,1.3,3,3,2,1,0,3,4,75,1,3,1,2,1,4,9,0,"https://fbref.com/en/players/af34f10d/Alexander-Callens"
2023,"Girona","La Liga","Juan Carlos","ESP","GK","34",1988,10,0,0,0,0,0,0,0,NA,0,0,0,0,1,1,7,1,"https://fbref.com/en/players/688b96e3/Juan-Carlos"
2023,"Girona","La Liga","Valentín Castellanos","ARG","FW","23",1998,28.9,12,5,2,7,3,0,18,0,18,22,2,20,6,18,26,0,"https://fbref.com/en/players/da76bab4/Valentin-Castellanos"
2023,"Girona","La Liga","Yan Couto","BRA","DF,MF","20",2002,12.9,25,18,11,11,3,12,20,60,8,7,2,5,5,30,10,0,"https://fbref.com/en/players/1944818c/Yan-Couto"
2023,"Girona","La Liga","Bernardo Espinosa","COL","DF","33",1989,13.6,6,2,2,4,0,3,9,33.3,6,17,10,7,12,18,70,2,"https://fbref.com/en/players/4242011c/Bernardo-Espinosa"
2023,"Girona","La Liga","Aleix García","ESP","MF","25",1997,26,37,20,9,18,10,15,33,45.5,18,24,8,16,31,68,35,1,"https://fbref.com/en/players/a10361d2/Aleix-Garcia"
2023,"Girona","La Liga","Borja García","ESP","MF,FW","31",1990,7.5,10,4,7,2,1,2,9,22.2,7,3,1,2,5,15,6,1,"https://fbref.com/en/players/e7f4603c/Borja-Garcia"
2023,"Girona","La Liga","Paulo Gazzaniga","ARG","GK","30",1992,28,0,0,0,0,0,0,1,0,1,0,0,0,1,1,9,5,"https://fbref.com/en/players/63d17038/Paulo-Gazzaniga"
2023,"Girona","La Liga","Miguel Gutiérrez","ESP","DF","21",2001,26.6,41,23,23,13,5,23,37,62.2,14,23,5,18,18,59,42,1,"https://fbref.com/en/players/7e98cff1/Miguel-Gutierrez"
2023,"Girona","La Liga","Javi Hernández","ESP","DF","24",1998,12.4,21,12,12,7,2,13,21,61.9,8,10,5,5,7,28,38,0,"https://fbref.com/en/players/9a76c2e9/Javi-Hernandez"
2023,"Girona","La Liga","Yangel Herrera","VEN","MF,FW","24",1998,10.7,26,9,9,14,3,6,15,40,9,14,1,13,4,30,12,0,"https://fbref.com/en/players/e778654a/Yangel-Herrera"
2023,"Girona","La Liga","Juanpe","ESP","DF","31",1991,15.8,19,11,10,9,0,11,17,64.7,6,12,9,3,10,29,60,1,"https://fbref.com/en/players/1633fc8a/Juanpe"
2023,"Girona","La Liga","David López","ESP","DF","32",1989,18.4,31,18,17,13,1,19,27,70.4,8,29,19,10,14,45,64,1,"https://fbref.com/en/players/f03f284b/David-Lopez"
2023,"Girona","La Liga","Iván Martín","ESP","MF","23",1999,17.6,9,7,4,4,1,8,23,34.8,15,12,0,12,9,18,12,0,"https://fbref.com/en/players/ae48c5cb/Ivan-Martin"
2023,"Girona","La Liga","Arnau Martinez","ESP","DF","19",2003,30.4,69,45,41,19,9,38,85,44.7,47,44,10,34,25,94,54,2,"https://fbref.com/en/players/c3e66ffe/Arnau-Martinez"
2023,"Girona","La Liga","Reinier","BRA","MF,FW","20",2002,7.2,12,10,7,3,2,2,8,25,6,6,0,6,5,17,4,0,"https://fbref.com/en/players/6b21b7b5/Reinier"
2023,"Girona","La Liga","Rodrigo Riquelme","ESP","MF,FW","22",2000,24.2,20,8,8,8,4,9,35,25.7,26,16,0,16,11,31,5,0,"https://fbref.com/en/players/65154df0/Rodrigo-Riquelme"
2023,"Girona","La Liga","Joel Roca","ESP","MF,FW","17",2005,0.9,2,2,2,0,0,2,5,40,3,1,1,0,0,2,1,0,"https://fbref.com/en/players/5f21b94c/Joel-Roca"
2023,"Girona","La Liga","Oriol Romeu","ESP","MF","30",1991,32.8,70,38,36,26,8,26,51,51,25,48,10,38,37,107,54,0,"https://fbref.com/en/players/4b511457/Oriol-Romeu"
2023,"Girona","La Liga","Samuel Sáiz","ESP","MF","31",1991,2.7,2,2,0,2,0,1,2,50,1,3,0,3,0,2,1,1,"https://fbref.com/en/players/13e0eb29/Samuel-Saiz"
2023,"Girona","La Liga","Cristhian Stuani","URU","FW","35",1986,12.1,13,6,2,7,4,5,14,35.7,9,10,0,10,2,15,5,0,"https://fbref.com/en/players/220c11f1/Cristhian-Stuani"
2023,"Girona","La Liga","Ramón Terrats","ESP","MF","21",2000,2.4,4,2,1,3,0,2,6,33.3,4,6,2,4,3,7,3,1,"https://fbref.com/en/players/f36016a5/Ramon-Terrats"
2023,"Girona","La Liga","Viktor Tsyhankov","UKR","MF","24",1997,16.5,8,8,5,1,2,1,14,7.1,13,13,2,11,7,15,12,0,"https://fbref.com/en/players/f7e87032/Viktor-Tsyhankov"
2023,"Girona","La Liga","Oscar Ureña","ESP","MF","19",2003,1.1,4,2,2,2,0,2,3,66.7,1,2,0,2,1,5,0,0,"https://fbref.com/en/players/2dd7e29d/Oscar-Urena"
2023,"Girona","La Liga","Valery","ESP","MF,DF","22",1999,10.7,12,6,4,6,2,5,9,55.6,4,8,1,7,10,22,9,1,"https://fbref.com/en/players/4acd733a/Valery"
2023,"Girona","La Liga","Manu Vallejo","ESP","FW,MF","25",1997,2.3,4,1,1,2,1,1,6,16.7,5,2,0,2,1,5,3,0,"https://fbref.com/en/players/0bc4e720/Manu-Vallejo"
2023,"Girona","La Liga","Toni Villa","ESP","MF,FW","27",1995,9.9,25,18,9,11,5,10,23,43.5,13,8,0,8,8,33,3,0,"https://fbref.com/en/players/636eae97/Toni-Villa"
2023,"Hellas Verona","Serie A","Oliver Abildgaard","DEN","MF","26",1996,6.6,10,6,6,3,1,7,16,43.8,9,7,1,6,5,15,17,0,"https://fbref.com/en/players/8f5cdf66/Oliver-Abildgaard"
2023,"Hellas Verona","Serie A","Bruno Amione","ARG","DF","20",2002,0.6,1,1,1,0,0,1,2,50,1,1,0,1,0,1,4,0,"https://fbref.com/en/players/2df7cc43/Bruno-Amione"
2023,"Hellas Verona","Serie A","Antonín Barák","CZE","MF","27",1994,0.3,0,0,0,0,0,0,0,NA,0,0,0,0,0,0,0,0,"https://fbref.com/en/players/01efac19/Antonin-Barak"
2023,"Hellas Verona","Serie A","Jayden Braaf","NED","MF,FW","19",2002,3.2,5,3,2,3,0,0,0,NA,0,1,0,1,2,7,1,0,"https://fbref.com/en/players/c609e90e/Jayden-Braaf"
2023,"Hellas Verona","Serie A","Juan Cabal","COL","DF","21",2001,4.9,10,6,7,3,0,7,12,58.3,5,8,5,3,13,23,12,0,"https://fbref.com/en/players/ef6eef89/Juan-Cabal"
2023,"Hellas Verona","Serie A","Federico Ceccherini","ITA","DF","30",1992,15.7,25,19,15,9,1,13,23,56.5,10,17,10,7,19,44,55,0,"https://fbref.com/en/players/d9624b51/Federico-Ceccherini"
2023,"Hellas Verona","Serie A","Diego Coppola","ITA","DF","18",2003,13.1,25,17,15,10,0,11,24,45.8,13,20,6,14,14,39,38,0,"https://fbref.com/en/players/22ae86f9/Diego-Coppola"
2023,"Hellas Verona","Serie A","Alessandro Cortinovis","ITA","MF","21",2001,0.1,1,0,1,0,0,0,0,NA,0,1,0,1,0,1,0,0,"https://fbref.com/en/players/bfc359ed/Alessandro-Cortinovis"
2023,"Hellas Verona","Serie A","Paweł Dawidowicz","POL","DF","27",1995,18.1,48,31,28,17,3,22,31,71,9,14,9,5,23,71,71,0,"https://fbref.com/en/players/16bb656a/Pawel-Dawidowicz"
2023,"Hellas Verona","Serie A","Fabio Depaoli","ITA","DF","25",1997,24.1,48,28,25,16,7,25,44,56.8,19,32,6,26,18,66,33,3,"https://fbref.com/en/players/d97f2e8d/Fabio-Depaoli"
2023,"Hellas Verona","Serie A","Josh Doig","SCO","DF","20",2002,15,19,8,6,7,6,6,16,37.5,10,25,6,19,11,30,13,1,"https://fbref.com/en/players/2f69d881/Josh-Doig"
2023,"Hellas Verona","Serie A","Ondrej Duda","SVK","MF","27",1994,11.8,22,14,7,12,3,9,16,56.3,7,11,0,11,13,35,8,0,"https://fbref.com/en/players/79ca3e23/Ondrej-Duda"
2023,"Hellas Verona","Serie A","Davide Faraoni","ITA","DF","30",1991,16.5,34,24,19,13,2,16,41,39,25,30,11,19,15,49,37,0,"https://fbref.com/en/players/aae9d04a/Davide-Faraoni"
2023,"Hellas Verona","Serie A","Adolfo Gaich","ARG","FW","23",1999,8.1,5,3,0,3,2,1,6,16.7,5,7,2,5,3,8,7,1,"https://fbref.com/en/players/8dfed6e9/Adolfo-Gaich"
2023,"Hellas Verona","Serie A","Koray Günter","GER","DF","27",1994,11.1,10,6,1,8,1,4,7,57.1,3,24,15,9,30,40,46,0,"https://fbref.com/en/players/f1f1f238/Koray-Gunter"
2023,"Hellas Verona","Serie A","Thomas Henry","FRA","FW","27",1994,11.4,5,3,1,1,3,1,5,20,4,6,2,4,0,5,14,0,"https://fbref.com/en/players/9ef42479/Thomas-Henry"
2023,"Hellas Verona","Serie A","Isak Hien","SWE","DF","23",1999,29,73,36,54,19,0,38,61,62.3,23,40,17,23,31,104,92,1,"https://fbref.com/en/players/12806697/Isak-Hien"
2023,"Hellas Verona","Serie A","Martin Hongla","CMR","MF","24",1998,5.8,8,5,4,4,0,5,5,100,0,7,1,6,6,14,9,0,"https://fbref.com/en/players/b85bf253/Martin-Hongla"
2023,"Hellas Verona","Serie A","Ajdin Hrustic","AUS","MF","26",1996,2.5,2,1,1,1,0,1,2,50,1,2,0,2,0,2,2,1,"https://fbref.com/en/players/1f2d714c/Ajdin-Hrustic"
2023,"Hellas Verona","Serie A","Ivan Ilić","SRB","MF","21",2001,9.5,16,10,9,7,0,6,11,54.5,5,10,1,9,8,24,14,0,"https://fbref.com/en/players/bb376bed/Ivan-Ilic"
2023,"Hellas Verona","Serie A","Yayah Kallon","SLE","MF,FW","21",2001,9.6,14,10,5,4,5,7,12,58.3,5,10,0,10,8,22,5,0,"https://fbref.com/en/players/f95f49d2/Yayah-Kallon"
2023,"Hellas Verona","Serie A","Kevin Lasagna","ITA","FW,MF","29",1992,17.5,12,6,7,3,2,6,14,42.9,8,17,1,16,5,17,13,0,"https://fbref.com/en/players/09538fdb/Kevin-Lasagna"
2023,"Hellas Verona","Serie A","Darko Lazović","SRB","MF,DF","31",1990,24.9,24,13,9,12,3,13,29,44.8,16,14,3,11,16,40,19,0,"https://fbref.com/en/players/5128bde4/Darko-Lazovic"
2023,"Hellas Verona","Serie A","Giangiacomo Magnani","ITA","DF","26",1995,17,33,22,20,11,2,19,25,76,6,20,15,5,21,54,76,0,"https://fbref.com/en/players/cce9f582/Giangiacomo-Magnani"
2023,"Hellas Verona","Serie A","Lorenzo Montipò","ITA","GK","26",1996,37,1,0,1,0,0,0,3,0,3,1,0,1,0,1,26,3,"https://fbref.com/en/players/c1d95617/Lorenzo-Montipo"
2023,"Hellas Verona","Serie A","Cyril Ngonge","BEL","MF,FW","22",2000,8.3,7,3,2,2,3,3,11,27.3,8,7,0,7,6,13,4,0,"https://fbref.com/en/players/2b8360f1/Cyril-Ngonge"
2023,"Hellas Verona","Serie A","Simone Perilli","ITA","GK","27",1995,1,0,0,0,0,0,0,0,NA,0,0,0,0,0,0,0,0,"https://fbref.com/en/players/b9e11c1d/Simone-Perilli"
2023,"Hellas Verona","Serie A","Roberto Piccoli","ITA","FW","21",2001,2.1,1,0,1,0,0,0,2,0,2,2,0,2,0,1,2,0,"https://fbref.com/en/players/1cadaf34/Roberto-Piccoli"
2023,"Hellas Verona","Serie A","Panagiotis Retsos","GRE","DF","23",1998,1.4,5,4,2,2,1,3,3,100,0,4,1,3,2,7,3,0,"https://fbref.com/en/players/4bd00a50/Panagiotis-Retsos"
2023,"Hellas Verona","Serie A","Ibrahim Sulemana","GHA","MF","19",2003,7.2,19,13,10,7,2,6,12,50,6,8,2,6,14,33,15,0,"https://fbref.com/en/players/230c3f3a/Ibrahim-Sulemana"
2023,"Hellas Verona","Serie A","Adrien Tameze","CMR","MF","28",1994,33.7,51,30,21,26,4,28,63,44.4,35,51,14,37,37,88,55,2,"https://fbref.com/en/players/8da74c05/Adrien-Tameze"
2023,"Hellas Verona","Serie A","Filippo Terracciano","ITA","DF,MF","19",2003,9.1,20,13,11,7,2,15,20,75,5,7,4,3,10,30,14,0,"https://fbref.com/en/players/5cbb5ad6/Filippo-Terracciano"
2023,"Hellas Verona","Serie A","Miguel Veloso","POR","MF","36",1986,12.9,33,10,20,12,1,16,26,61.5,10,26,6,20,6,39,14,0,"https://fbref.com/en/players/ab1ca213/Miguel-Veloso"
2023,"Hellas Verona","Serie A","Simone Verdi","ITA","MF,FW","30",1992,12.2,15,10,7,5,3,6,17,35.3,11,8,1,7,0,15,2,0,"https://fbref.com/en/players/0375723e/Simone-Verdi"
2023,"Hellas Verona","Serie A","Deyovaisio Zeefuik","NED","DF","24",1998,0.1,1,1,0,1,0,0,0,NA,0,0,0,0,0,1,0,0,"https://fbref.com/en/players/58a2e9f6/Deyovaisio-Zeefuik"
2023,"Hellas Verona","Serie A","Milan Đurić","BIH","FW","32",1990,15.2,2,1,1,0,1,1,3,33.3,2,7,4,3,1,3,24,0,"https://fbref.com/en/players/405f6586/Milan-Djuric"
2023,"Hertha BSC","Bundesliga","Kevin-Prince Boateng","GHA","MF","35",1987,5.2,8,6,4,2,2,3,9,33.3,6,11,3,8,3,11,5,0,"https://fbref.com/en/players/f4ec4fd0/Kevin-Prince-Boateng"
2023,"Hertha BSC","Bundesliga","Jean-Paul Boëtius","NED","MF","28",1994,11.7,30,16,19,9,2,8,25,32,17,25,5,20,14,44,10,0,"https://fbref.com/en/players/635f2732/Jean-Paul-Boetius"
2023,"Hertha BSC","Bundesliga","Oliver Christensen","DEN","GK","23",1999,33,1,0,1,0,0,0,2,0,2,0,0,0,0,1,22,2,"https://fbref.com/en/players/af104654/Oliver-Christensen"
2023,"Hertha BSC","Bundesliga","Tolga Ciğerci","TUR","MF","30",1992,7.5,16,13,6,9,1,10,16,62.5,6,6,2,4,8,24,5,0,"https://fbref.com/en/players/6e17c802/Tolga-Cigerci"
2023,"Hertha BSC","Bundesliga","Márton Dárdai","GER","DF,MF","20",2002,10.5,17,8,9,8,0,9,18,50,9,14,9,5,11,28,45,1,"https://fbref.com/en/players/41bff4fa/Marton-Dardai"
2023,"Hertha BSC","Bundesliga","Vladimír Darida","CZE","MF","31",1990,0.3,1,1,0,1,0,0,0,NA,0,1,0,1,0,1,0,0,"https://fbref.com/en/players/3eb0f2df/Vladimir-Darida"
2023,"Hertha BSC","Bundesliga","Julian Eitschberger","GER","FW","18",2004,0,0,0,0,0,0,0,0,NA,0,0,0,0,0,0,0,0,"https://fbref.com/en/players/943b9602/Julian-Eitschberger"
2023,"Hertha BSC","Bundesliga","Chidera Ejuke","NGA","FW,MF","24",1998,9.9,5,4,1,4,0,1,5,20,4,4,0,4,4,9,1,0,"https://fbref.com/en/players/e7f3e8a7/Chidera-Ejuke"
2023,"Hertha BSC","Bundesliga","Tjark Ernst","GER","GK","19",2003,1,0,0,0,0,0,0,0,NA,0,0,0,0,0,0,1,0,"https://fbref.com/en/players/3f6c3ae0/Tjark-Ernst"
2023,"Hertha BSC","Bundesliga","Stevan Jovetić","MNE","FW,MF","32",1989,9.9,3,2,2,1,0,1,11,9.1,10,2,1,1,2,5,10,0,"https://fbref.com/en/players/f36c432f/Stevan-Jovetic"
2023,"Hertha BSC","Bundesliga","Wilfried Kanga","CIV","FW","24",1998,15.7,5,4,2,1,2,2,4,50,2,14,3,11,2,7,13,0,"https://fbref.com/en/players/b4c816a9/Wilfried-Kanga"
2023,"Hertha BSC","Bundesliga","Marc-Oliver Kempf","GER","DF","27",1995,30.1,44,27,29,14,1,16,22,72.7,6,42,32,10,51,95,143,0,"https://fbref.com/en/players/815c314f/Marc-Oliver-Kempf"
2023,"Hertha BSC","Bundesliga","Jonjoe Kenny","ENG","DF","25",1997,24.9,46,34,27,16,3,24,42,57.1,18,38,9,29,46,92,74,0,"https://fbref.com/en/players/099e666f/Jonjoe-Kenny"
2023,"Hertha BSC","Bundesliga","Pascal Klemens","GER","DF","17",2005,1,0,0,0,0,0,0,1,0,1,1,0,1,1,1,3,0,"https://fbref.com/en/players/90d88154/Pascal-Klemens"
2023,"Hertha BSC","Bundesliga","Dodi Lukebakio","BEL","FW,MF","24",1997,26.6,18,11,7,8,3,6,27,22.2,21,23,5,18,13,31,17,0,"https://fbref.com/en/players/0c61c77c/Dodi-Lukebakio"
2023,"Hertha BSC","Bundesliga","Myziane Maolida","FRA","FW,MF","23",1999,1.1,1,1,1,0,0,1,2,50,1,0,0,0,0,1,1,0,"https://fbref.com/en/players/706a60e1/Myziane-Maolida"
2023,"Hertha BSC","Bundesliga","Ibrahim Maza","GER","MF,FW","16",2005,0.8,1,1,1,0,0,0,1,0,1,2,0,2,0,1,1,0,"https://fbref.com/en/players/89b3bc5e/Ibrahim-Maza"
2023,"Hertha BSC","Bundesliga","Maximilian Mittelstädt","GER","DF,MF","25",1997,9.4,39,20,31,6,2,17,39,43.6,22,13,2,11,26,65,27,0,"https://fbref.com/en/players/88d4144a/Maximilian-Mittelstadt"
2023,"Hertha BSC","Bundesliga","Jessic Ngankam","GER","FW,MF","22",2000,9.2,14,9,7,4,3,6,14,42.9,8,6,1,5,1,15,4,0,"https://fbref.com/en/players/bc249af8/Jessic-Ngankam"
2023,"Hertha BSC","Bundesliga","Florian Niederlechner","GER","FW","31",1990,8.7,9,7,2,4,3,2,8,25,6,7,0,7,3,12,10,0,"https://fbref.com/en/players/d6862409/Florian-Niederlechner"
2023,"Hertha BSC","Bundesliga","Peter Pekarík","SVK","DF","35",1986,2.3,4,3,4,0,0,4,6,66.7,2,6,2,4,4,8,7,0,"https://fbref.com/en/players/c18d22f5/Peter-Pekarik"
2023,"Hertha BSC","Bundesliga","Marvin Plattenhardt","GER","DF","30",1992,26.7,43,33,24,15,4,29,47,61.7,18,25,11,14,15,58,82,0,"https://fbref.com/en/players/f7aa75bd/Marvin-Plattenhardt"
2023,"Hertha BSC","Bundesliga","Marco Richter","GER","MF,FW","24",1997,20.4,43,23,18,17,8,19,48,39.6,29,29,2,27,24,67,25,0,"https://fbref.com/en/players/f972644c/Marco-Richter"
2023,"Hertha BSC","Bundesliga","Agustín Rogel","URU","DF","24",1997,15.8,18,9,13,5,0,11,17,64.7,6,15,8,7,11,29,74,1,"https://fbref.com/en/players/ea42c03f/Agustin-Rogel"
2023,"Hertha BSC","Bundesliga","Tony Rölke","GER","FW","19",2003,0.2,0,0,0,0,0,0,0,NA,0,1,0,1,0,0,1,0,"https://fbref.com/en/players/779aa25c/Tony-Rolke"
2023,"Hertha BSC","Bundesliga","Derry Scherhant","GER","FW,MF","19",2002,3.2,7,6,3,3,1,4,8,50,4,3,0,3,0,7,5,0,"https://fbref.com/en/players/93cba339/Derry-Scherhant"
2023,"Hertha BSC","Bundesliga","Davie Selke","GER","FW","27",1995,3.1,2,1,1,1,0,0,1,0,1,3,1,2,1,3,5,0,"https://fbref.com/en/players/1238a3f9/Davie-Selke"
2023,"Hertha BSC","Bundesliga","Suat Serdar","GER","MF","25",1997,22.5,51,23,14,30,7,20,41,48.8,21,48,12,36,29,80,24,0,"https://fbref.com/en/players/b3325a30/Suat-Serdar"
2023,"Hertha BSC","Bundesliga","Veit Stange","GER","MF","18",2004,0.1,1,1,1,0,0,1,1,100,0,0,0,0,0,1,0,0,"https://fbref.com/en/players/e52d33d0/Veit-Stange"
2023,"Hertha BSC","Bundesliga","Ivan Šunjić","CRO","MF","25",1996,11,38,20,16,21,1,16,24,66.7,8,17,5,12,13,51,19,1,"https://fbref.com/en/players/e18098de/Ivan-Sunjic"
2023,"Hertha BSC","Bundesliga","Lucas Tousart","FRA","MF","25",1997,32.7,73,38,35,28,10,27,60,45,33,42,6,36,48,121,75,1,"https://fbref.com/en/players/71ec39ef/Lucas-Tousart"
2023,"Hertha BSC","Bundesliga","Filip Uremović","CRO","DF","25",1997,19.2,38,23,29,8,1,14,22,63.6,8,18,13,5,36,74,88,2,"https://fbref.com/en/players/af842091/Filip-Uremovic"
2023,"Hoffenheim","Bundesliga","Kevin Akpoguma","NGA","DF","27",1995,21.7,75,44,45,27,3,32,45,71.1,13,45,16,29,24,99,70,1,"https://fbref.com/en/players/6ec6fde0/Kevin-Akpoguma"
2023,"Hoffenheim","Bundesliga","Angeliño","ESP","DF","25",1997,29.1,40,24,19,18,3,23,37,62.2,14,32,6,26,25,65,67,0,"https://fbref.com/en/players/30941e96/Angelino"
2023,"Hoffenheim","Bundesliga","Fisnik Asllani","KVX","FW","19",2002,1.9,0,0,0,0,0,0,4,0,4,2,0,2,3,3,3,0,"https://fbref.com/en/players/35f67a30/Fisnik-Asllani"
2023,"Hoffenheim","Bundesliga","Oliver Baumann","GER","GK","32",1990,34,0,0,0,0,0,0,0,NA,0,0,0,0,0,0,15,1,"https://fbref.com/en/players/47064058/Oliver-Baumann"
2023,"Hoffenheim","Bundesliga","Christoph Baumgartner","AUT","MF,FW","22",1999,28.5,36,19,12,17,7,9,52,17.3,43,57,5,52,15,51,19,1,"https://fbref.com/en/players/437f2b00/Christoph-Baumgartner"
2023,"Hoffenheim","Bundesliga","Ihlas Bebou","TOG","FW,DF","28",1994,15.7,19,16,8,7,4,11,17,64.7,6,9,2,7,7,26,15,0,"https://fbref.com/en/players/a53b661f/Ihlas-Bebou"
2023,"Hoffenheim","Bundesliga","Ermin Bičakčić","BIH","DF","32",1990,2.9,8,4,6,1,1,2,6,33.3,4,4,3,1,5,13,14,0,"https://fbref.com/en/players/7aac47fe/Ermin-Bicakcic"
2023,"Hoffenheim","Bundesliga","Tom Bischof","GER","MF,FW","17",2005,3.5,15,10,8,3,4,7,10,70,3,5,1,4,1,16,1,0,"https://fbref.com/en/players/07d3bfec/Tom-Bischof"
2023,"Hoffenheim","Bundesliga","John Brooks","USA","DF","29",1993,15,18,12,10,8,0,13,18,72.2,5,17,12,5,10,28,105,0,"https://fbref.com/en/players/e27da244/John-Brooks"
2023,"Hoffenheim","Bundesliga","Jacob Bruun Larsen","DEN","FW","23",1998,3.6,4,3,0,1,3,3,4,75,1,3,1,2,1,5,0,0,"https://fbref.com/en/players/4e204552/Jacob-Bruun-Larsen"
2023,"Hoffenheim","Bundesliga","Moanes Dabbur","ISR","FW","30",1992,10.4,11,8,4,5,2,3,9,33.3,6,8,0,8,5,16,0,0,"https://fbref.com/en/players/eac044ad/Moanes-Dabbur"
2023,"Hoffenheim","Bundesliga","Muhammed Damar","GER","MF","18",2004,1.8,6,3,1,2,3,1,2,50,1,3,0,3,0,6,0,0,"https://fbref.com/en/players/d3d77413/Muhammed-Damar"
2023,"Hoffenheim","Bundesliga","Thomas Delaney","DEN","MF","30",1991,3.3,6,3,3,2,1,3,8,37.5,5,5,0,5,1,7,4,0,"https://fbref.com/en/players/fe641c1a/Thomas-Delaney"
2023,"Hoffenheim","Bundesliga","Kasper Dolberg","DEN","FW,MF","24",1997,4.5,7,5,1,4,2,4,6,66.7,2,6,2,4,0,7,5,0,"https://fbref.com/en/players/cc83b74d/Kasper-Dolberg"
2023,"Hoffenheim","Bundesliga","Dennis Geiger","GER","MF","24",1998,21.7,45,25,15,28,2,22,35,62.9,13,27,3,24,24,69,18,2,"https://fbref.com/en/players/37f606f0/Dennis-Geiger"
2023,"Hoffenheim","Bundesliga","Ozan Kabak","TUR","DF","22",2000,26.5,51,34,27,21,3,17,30,56.7,13,35,23,12,45,96,83,0,"https://fbref.com/en/players/2d61d13a/Ozan-Kabak"
2023,"Hoffenheim","Bundesliga","Pavel Kadeřábek","CZE","DF","30",1992,18.5,26,20,10,9,7,15,23,65.2,8,12,2,10,14,40,37,1,"https://fbref.com/en/players/79c90e45/Pavel-Kaderabek"
2023,"Hoffenheim","Bundesliga","Andrej Kramarić","CRO","MF,FW","31",1991,26.5,5,2,2,1,2,1,11,9.1,10,14,2,12,6,11,13,0,"https://fbref.com/en/players/603cb947/Andrej-Kramaric"
2023,"Hoffenheim","Bundesliga","Stanley N'Soki","FRA","DF","23",1999,14.3,22,13,14,7,1,12,22,54.5,10,22,5,17,24,46,34,0,"https://fbref.com/en/players/61590953/Stanley-NSoki"
2023,"Hoffenheim","Bundesliga","Finn Ole Becker","GER","MF","22",2000,5.7,10,2,4,6,0,4,7,57.1,3,4,0,4,5,15,8,0,"https://fbref.com/en/players/dd2e62da/Finn-Ole-Becker"
2023,"Hoffenheim","Bundesliga","Stefan Posch","AUT","DF","25",1997,0.2,0,0,0,0,0,0,0,NA,0,0,0,0,0,0,0,0,"https://fbref.com/en/players/7f609bfc/Stefan-Posch"
2023,"Hoffenheim","Bundesliga","Grischa Prömel","GER","MF","27",1995,16.2,27,19,14,11,2,9,25,36,16,22,4,18,8,35,23,0,"https://fbref.com/en/players/924f9191/Grischa-Promel"
2023,"Hoffenheim","Bundesliga","Eduardo Quaresma","POR","DF","20",2002,1,5,3,3,2,0,1,3,33.3,2,3,2,1,0,5,3,0,"https://fbref.com/en/players/7ec723b7/Eduardo-Quaresma"
2023,"Hoffenheim","Bundesliga","Joshua Quarshie","GER","MF","18",2004,0,0,0,0,0,0,0,0,NA,0,0,0,0,0,0,0,0,"https://fbref.com/en/players/3c200e05/Joshua-Quarshie"
2023,"Hoffenheim","Bundesliga","Sebastian Rudy","GER","MF","32",1990,8.8,26,12,10,16,0,13,27,48.1,14,27,7,20,11,37,13,0,"https://fbref.com/en/players/80f36c88/Sebastian-Rudy"
2023,"Hoffenheim","Bundesliga","Georginio Rutter","FRA","FW","20",2002,11.2,7,4,1,4,2,1,3,33.3,2,10,2,8,5,12,6,0,"https://fbref.com/en/players/c64c01fc/Georginio-Rutter"
2023,"Hoffenheim","Bundesliga","Diadie Samassékou","MLI","MF,FW","26",1996,0.4,1,0,0,1,0,0,1,0,1,0,0,0,0,1,0,0,"https://fbref.com/en/players/08593525/Diadie-Samassekou"
2023,"Hoffenheim","Bundesliga","Robert Skov","DEN","DF","26",1996,15,22,11,14,7,1,10,26,38.5,16,22,8,14,8,30,20,2,"https://fbref.com/en/players/ff98492b/Robert-Skov"
2023,"Hoffenheim","Bundesliga","Angelo Stiller","GER","MF","21",2001,7.8,26,12,9,13,4,8,12,66.7,4,12,2,10,10,36,14,0,"https://fbref.com/en/players/3b1ed320/Angelo-Stiller"
2023,"Hoffenheim","Bundesliga","Umut Tohumcu","GER","MF,DF","17",2004,3,10,5,4,5,1,3,9,33.3,6,4,0,4,2,12,8,0,"https://fbref.com/en/players/e547d3cf/Umut-Tohumcu"
2023,"Hoffenheim","Bundesliga","Kevin Vogt","GER","DF","30",1991,19.7,15,10,10,5,0,9,22,40.9,13,18,11,7,26,41,67,0,"https://fbref.com/en/players/1d8e9add/Kevin-Vogt"
2023,"Inter","Serie A","Francesco Acerbi","ITA","DF","34",1988,26.9,33,19,22,7,4,20,27,74.1,7,25,18,7,41,74,85,2,"https://fbref.com/en/players/b96b595c/Francesco-Acerbi"
2023,"Inter","Serie A","Kristjan Asllani","ALB","MF","20",2002,6.6,11,5,1,8,2,7,10,70,3,3,1,2,6,17,4,0,"https://fbref.com/en/players/0fdcef0e/Kristjan-Asllani"
2023,"Inter","Serie A","Nicolò Barella","ITA","MF","25",1997,29,49,25,17,26,6,28,53,52.8,25,29,5,24,12,61,12,0,"https://fbref.com/en/players/6928979a/Nicolo-Barella"
2023,"Inter","Serie A","Alessandro Bastoni","ITA","DF","23",1999,24,41,20,20,14,7,11,27,40.7,16,27,13,14,24,65,45,0,"https://fbref.com/en/players/75b86fb3/Alessandro-Bastoni"
2023,"Inter","Serie A","Raoul Bellanova","ITA","DF","22",2000,5.5,14,6,11,2,1,9,14,64.3,5,6,1,5,4,18,14,0,"https://fbref.com/en/players/e3756e72/Raoul-Bellanova"
2023,"Inter","Serie A","Marcelo Brozović","CRO","MF","29",1992,19.7,37,22,13,22,2,11,37,29.7,26,23,7,16,22,59,28,0,"https://fbref.com/en/players/33b8d077/Marcelo-Brozovic"
2023,"Inter","Serie A","Hakan Çalhanoğlu","TUR","MF","28",1994,26.3,48,27,17,26,5,16,43,37.2,27,30,5,25,25,73,13,1,"https://fbref.com/en/players/cd0fa27b/Hakan-Calhanoglu"
2023,"Inter","Serie A","Valentin Carboni","ARG","MF,DF","17",2005,0.3,1,1,0,1,0,1,3,33.3,2,1,0,1,0,1,0,0,"https://fbref.com/en/players/707b98f1/Valentin-Carboni"
2023,"Inter","Serie A","Alex Cordaz","ITA","GK","39",1983,0.3,0,0,0,0,0,0,0,NA,0,0,0,0,0,0,0,0,"https://fbref.com/en/players/e66ebabb/Alex-Cordaz"
2023,"Inter","Serie A","Joaquín Correa","ARG","FW","27",1994,10.6,12,7,3,6,3,4,15,26.7,11,4,1,3,3,15,0,0,"https://fbref.com/en/players/45b9b619/Joaquin-Correa"
2023,"Inter","Serie A","Danilo D'Ambrosio","ITA","DF","33",1988,8.1,25,17,17,7,1,15,27,55.6,12,12,4,8,10,35,17,0,"https://fbref.com/en/players/44eb9093/Danilo-DAmbrosio"
2023,"Inter","Serie A","Matteo Darmian","ITA","DF","32",1989,22.5,56,30,29,15,12,31,47,66,16,33,5,28,21,77,36,0,"https://fbref.com/en/players/96e0490d/Matteo-Darmian"
2023,"Inter","Serie A","Federico Dimarco","ITA","DF","24",1997,23,31,25,6,18,7,9,19,47.4,10,15,4,11,18,49,20,0,"https://fbref.com/en/players/970b8574/Federico-Dimarco"
2023,"Inter","Serie A","Denzel Dumfries","NED","DF","26",1996,24.6,35,18,17,13,5,22,34,64.7,12,33,9,24,12,47,26,0,"https://fbref.com/en/players/481c9ece/Denzel-Dumfries"
2023,"Inter","Serie A","Edin Džeko","BIH","FW","36",1986,19.2,3,2,0,3,0,0,4,0,4,15,1,14,3,6,25,0,"https://fbref.com/en/players/3bb7f478/Edin-Dzeko"
2023,"Inter","Serie A","Roberto Gagliardini","ITA","MF","28",1994,8.7,16,6,9,6,1,10,21,47.6,11,14,5,9,4,20,15,0,"https://fbref.com/en/players/ce30bfc8/Roberto-Gagliardini"
2023,"Inter","Serie A","Robin Gosens","GER","DF","28",1994,13.2,34,18,15,10,9,15,25,60,10,16,2,14,23,57,15,0,"https://fbref.com/en/players/2d970560/Robin-Gosens"
2023,"Inter","Serie A","Samir Handanović","SVN","GK","38",1984,13.7,0,0,0,0,0,0,0,NA,0,0,0,0,0,0,5,0,"https://fbref.com/en/players/74419746/Samir-Handanovic"
2023,"Inter","Serie A","Romelu Lukaku","BEL","FW","29",1993,18.4,3,1,1,0,2,2,5,40,3,3,1,2,0,3,16,0,"https://fbref.com/en/players/5eae500a/Romelu-Lukaku"
2023,"Inter","Serie A","Lautaro Martínez","ARG","FW","24",1997,28.6,25,14,3,15,7,7,23,30.4,16,31,1,30,13,38,16,1,"https://fbref.com/en/players/f7036e1c/Lautaro-Martinez"
2023,"Inter","Serie A","Henrikh Mkhitaryan","ARM","MF","33",1989,22.1,41,26,13,22,6,14,41,34.1,27,27,4,23,21,62,18,0,"https://fbref.com/en/players/dd0daf32/Henrikh-Mkhitaryan"
2023,"Inter","Serie A","André Onana","CMR","GK","26",1996,24,0,0,0,0,0,0,1,0,1,0,0,0,0,0,5,0,"https://fbref.com/en/players/e9c0c1b2/Andre-Onana"
2023,"Inter","Serie A","Milan Škriniar","SVK","DF","27",1995,19.7,29,18,14,11,4,18,32,56.3,14,18,13,5,13,42,46,3,"https://fbref.com/en/players/30f5ffa9/Milan-Skriniar"
2023,"Inter","Serie A","Stefan de Vrij","NED","DF","30",1992,21.6,28,18,19,9,0,8,14,57.1,6,18,10,8,40,68,80,0,"https://fbref.com/en/players/d0d8dd44/Stefan-de-Vrij"
2023,"Inter","Serie A","Mattia Zanotti","ITA","DF","19",2003,0.3,0,0,0,0,0,0,1,0,1,2,0,2,0,0,0,0,"https://fbref.com/en/players/875d65d1/Mattia-Zanotti"
2023,"Juventus","Serie A","Tommaso Barbieri","ITA","DF","19",2002,1.2,3,3,3,0,0,3,8,37.5,5,3,0,3,0,3,2,0,"https://fbref.com/en/players/6f1d7aa8/Tommaso-Barbieri"
2023,"Juventus","Serie A","Enzo Barrenechea","ARG","MF","21",2001,1.8,8,3,3,4,1,3,5,60,2,3,0,3,2,10,3,0,"https://fbref.com/en/players/6caffe81/Enzo-Barrenechea"
2023,"Juventus","Serie A","Leonardo Bonucci","ITA","DF","35",1987,9.8,5,4,1,4,0,2,4,50,2,12,8,4,13,18,29,0,"https://fbref.com/en/players/52ec54d0/Leonardo-Bonucci"
2023,"Juventus","Serie A","Gleison Bremer","BRA","DF","25",1997,29.3,29,20,23,5,1,19,26,73.1,7,44,22,22,42,71,120,2,"https://fbref.com/en/players/5fd5ed86/Gleison-Bremer"
2023,"Juventus","Serie A","Federico Chiesa","ITA","DF,MF","24",1997,9.5,22,11,6,6,10,5,14,35.7,9,13,1,12,0,22,1,0,"https://fbref.com/en/players/b0f7e36c/Federico-Chiesa"
2023,"Juventus","Serie A","Juan Cuadrado","COL","DF,FW","34",1988,23.1,50,34,34,13,3,27,65,41.5,38,15,2,13,24,74,32,0,"https://fbref.com/en/players/0ab1f153/Juan-Cuadrado"
2023,"Juventus","Serie A","Danilo","BRA","DF","31",1991,35.4,92,62,61,23,8,52,73,71.2,21,39,20,19,47,139,114,1,"https://fbref.com/en/players/94b2001f/Danilo"
2023,"Juventus","Serie A","Mattia De Sciglio","ITA","DF","29",1992,11.6,14,7,8,3,3,9,14,64.3,5,9,3,6,4,18,20,0,"https://fbref.com/en/players/ae4e2852/Mattia-De-Sciglio"
2023,"Juventus","Serie A","Ángel Di María","ARG","FW,MF","34",1988,15.1,10,5,3,5,2,3,19,15.8,16,15,0,15,7,17,0,0,"https://fbref.com/en/players/19cda00b/Angel-Di-Maria"
2023,"Juventus","Serie A","Nicolò Fagioli","ITA","MF","21",2001,16.9,29,19,12,15,2,8,27,29.6,19,16,2,14,8,37,7,1,"https://fbref.com/en/players/366be751/Nicolo-Fagioli"
2023,"Juventus","Serie A","Federico Gatti","ITA","DF","24",1998,16.1,15,11,9,4,2,9,15,60,6,20,14,6,21,36,54,2,"https://fbref.com/en/players/18dd3219/Federico-Gatti"
2023,"Juventus","Serie A","Samuel Iling-Junior","ENG","DF,FW","18",2003,3.5,7,2,3,1,3,4,9,44.4,5,5,1,4,2,9,6,0,"https://fbref.com/en/players/ba492306/Samuel-Iling-Junior"
2023,"Juventus","Serie A","Moise Kean","ITA","FW","22",2000,11.1,8,6,2,5,1,3,7,42.9,4,4,0,4,5,13,2,0,"https://fbref.com/en/players/3d50bcdb/Moise-Kean"
2023,"Juventus","Serie A","Filip Kostić","SRB","DF,FW","29",1992,28.5,41,26,17,20,4,21,47,44.7,26,30,4,26,16,57,32,0,"https://fbref.com/en/players/b1cd37e6/Filip-Kostic"
2023,"Juventus","Serie A","Manuel Locatelli","ITA","MF","24",1998,27.2,59,33,26,23,10,30,53,56.6,23,50,22,28,27,86,59,0,"https://fbref.com/en/players/a8a874f1/Manuel-Locatelli"
2023,"Juventus","Serie A","Weston McKennie","USA","MF,DF","23",1998,11.7,14,5,3,9,2,5,8,62.5,3,15,4,11,11,25,15,1,"https://fbref.com/en/players/01c3aff5/Weston-McKennie"
2023,"Juventus","Serie A","Arkadiusz Milik","POL","FW","28",1994,17.6,12,8,2,8,2,2,8,25,6,10,1,9,1,13,14,0,"https://fbref.com/en/players/85613cf0/Arkadiusz-Milik"
2023,"Juventus","Serie A","Fabio Miretti","ITA","MF,FW","18",2003,13.7,24,11,15,6,3,12,29,41.4,17,20,1,19,4,28,11,0,"https://fbref.com/en/players/34693494/Fabio-Miretti"
2023,"Juventus","Serie A","Leandro Paredes","ARG","MF","28",1994,10.9,19,13,7,11,1,10,22,45.5,12,8,0,8,17,36,22,0,"https://fbref.com/en/players/dff153a4/Leandro-Paredes"
2023,"Juventus","Serie A","Mattia Perin","ITA","GK","29",1992,10.5,0,0,0,0,0,0,0,NA,0,0,0,0,0,0,0,0,"https://fbref.com/en/players/4c62d0c8/Mattia-Perin"
2023,"Juventus","Serie A","Paul Pogba","FRA","MF,FW","29",1993,1.2,0,0,0,0,0,0,1,0,1,0,0,0,0,0,2,0,"https://fbref.com/en/players/867239d3/Paul-Pogba"
2023,"Juventus","Serie A","Adrien Rabiot","FRA","MF","27",1995,30.5,65,35,31,23,11,30,57,52.6,27,37,7,30,26,91,44,1,"https://fbref.com/en/players/8794e251/Adrien-Rabiot"
2023,"Juventus","Serie A","Nicolò Rovella","ITA","MF","20",2001,0.3,1,1,0,1,0,1,1,100,0,0,0,0,0,1,0,0,"https://fbref.com/en/players/e58cbfd5/Nicolo-Rovella"
2023,"Juventus","Serie A","Daniele Rugani","ITA","DF","28",1994,6.3,7,0,6,1,0,4,4,100,0,7,5,2,7,14,32,0,"https://fbref.com/en/players/14b8fcdf/Daniele-Rugani"
2023,"Juventus","Serie A","Alex Sandro","BRA","DF","31",1991,19.9,35,20,16,16,3,15,22,68.2,7,27,10,17,15,50,64,1,"https://fbref.com/en/players/0d82903c/Alex-Sandro"
2023,"Juventus","Serie A","Matìas Soulé","ARG","MF,FW","19",2003,4.7,7,4,3,2,2,5,7,71.4,2,7,1,6,3,10,3,0,"https://fbref.com/en/players/c13ddd3e/Matias-Soule"
2023,"Juventus","Serie A","Wojciech Szczęsny","POL","GK","32",1990,27.5,1,0,1,0,0,0,1,0,1,0,0,0,0,1,7,0,"https://fbref.com/en/players/01b8a2b2/Wojciech-Szczesny"
2023,"Juventus","Serie A","Dušan Vlahović","SRB","FW","22",2000,21.4,11,6,0,7,4,4,10,40,6,10,3,7,3,14,8,1,"https://fbref.com/en/players/79443529/Dusan-Vlahovic"
2023,"Juventus","Serie A","Denis Zakaria","SUI","MF","25",1996,1.4,6,3,1,4,1,2,2,100,0,2,0,2,2,8,1,0,"https://fbref.com/en/players/384d58d9/Denis-Zakaria"
2023,"Köln","Bundesliga","Sargis Adamyan","ARM","FW,MF","29",1993,7.2,14,7,5,3,6,7,17,41.2,10,12,0,12,4,18,5,0,"https://fbref.com/en/players/22919e97/Sargis-Adamyan"
2023,"Köln","Bundesliga","Julian Chabot","GER","DF","24",1998,20,36,23,19,14,3,20,35,57.1,15,30,18,12,41,77,105,0,"https://fbref.com/en/players/ae7058f9/Julian-Chabot"
2023,"Köln","Bundesliga","Justin Diehl","GER","MF,FW","17",2004,0.2,0,0,0,0,0,0,0,NA,0,0,0,0,0,0,0,0,"https://fbref.com/en/players/d82a310a/Justin-Diehl"
2023,"Köln","Bundesliga","Florian Dietz","GER","FW","23",1998,4.4,2,1,0,2,0,1,4,25,3,4,1,3,0,2,2,0,"https://fbref.com/en/players/8779ddf8/Florian-Dietz"
2023,"Köln","Bundesliga","Ondrej Duda","SVK","MF","27",1994,7.7,9,8,2,5,2,4,11,36.4,7,7,1,6,2,11,3,0,"https://fbref.com/en/players/79ca3e23/Ondrej-Duda"
2023,"Köln","Bundesliga","Kingsley Ehizibue","NED","DF","27",1995,0.7,0,0,0,0,0,0,0,NA,0,1,0,1,2,2,1,0,"https://fbref.com/en/players/76b2817e/Kingsley-Ehizibue"
2023,"Köln","Bundesliga","Jonas Hector","GER","DF","32",1990,31.4,112,66,59,43,10,66,113,58.4,47,61,9,52,39,151,74,1,"https://fbref.com/en/players/c2009df3/Jonas-Hector"
2023,"Köln","Bundesliga","Timo Hübers","GER","DF","26",1996,28.4,43,28,35,8,0,24,52,46.2,28,27,13,14,58,101,153,0,"https://fbref.com/en/players/94302c52/Timo-Hubers"
2023,"Köln","Bundesliga","Denis Huseinbasic","GER","MF,FW","21",2001,8.8,23,9,8,11,4,10,25,40,15,16,2,14,4,27,5,0,"https://fbref.com/en/players/b116c6e3/Denis-Huseinbasic"
2023,"Köln","Bundesliga","Florian Kainz","AUT","MF,FW","29",1992,26,21,10,7,12,2,8,26,30.8,18,27,6,21,32,53,30,1,"https://fbref.com/en/players/94c18565/Florian-Kainz"
2023,"Köln","Bundesliga","Luca Kilian","GER","DF","22",1999,12.5,22,16,14,7,1,12,21,57.1,9,16,8,8,11,33,48,0,"https://fbref.com/en/players/610aa1e9/Luca-Kilian"
2023,"Köln","Bundesliga","Tim Lemperle","GER","FW,MF","20",2002,1.5,6,4,3,1,2,3,5,60,2,5,0,5,1,7,4,0,"https://fbref.com/en/players/792ffa71/Tim-Lemperle"
2023,"Köln","Bundesliga","Dimitris Limnios","GRE","FW","24",1998,0.4,0,0,0,0,0,0,0,NA,0,0,0,0,1,1,0,0,"https://fbref.com/en/players/62c7067a/Dimitris-Limnios"
2023,"Köln","Bundesliga","Dejan Ljubicic","AUT","MF,FW","24",1997,19,25,14,7,14,4,13,40,32.5,27,20,1,19,8,33,8,1,"https://fbref.com/en/players/c455a2b2/Dejan-Ljubicic"
2023,"Köln","Bundesliga","Linton Maina","GER","FW,MF","23",1999,24.9,18,12,5,11,2,7,30,23.3,23,19,0,19,5,23,9,0,"https://fbref.com/en/players/e5d85da8/Linton-Maina"
2023,"Köln","Bundesliga","Eric Martel","GER","MF","20",2002,22.4,66,41,29,30,7,30,60,50,30,29,9,20,33,99,49,0,"https://fbref.com/en/players/92a16062/Eric-Martel"
2023,"Köln","Bundesliga","Mathias Olesen","LUX","MF","21",2001,5.3,10,5,4,4,2,5,8,62.5,3,6,1,5,2,12,3,0,"https://fbref.com/en/players/86adbcc7/Mathias-Olesen"
2023,"Köln","Bundesliga","Kristian Pedersen","DEN","DF","27",1994,3.1,5,4,4,1,0,0,2,0,2,3,0,3,6,11,17,0,"https://fbref.com/en/players/5154b2ba/Kristian-Pedersen"
2023,"Köln","Bundesliga","Kingsley Schindler","GHA","DF,MF","29",1993,12.1,23,12,13,8,2,18,28,64.3,10,14,2,12,15,38,24,0,"https://fbref.com/en/players/bd527260/Kingsley-Schindler"
2023,"Köln","Bundesliga","Benno Schmitz","GER","DF","27",1994,26.9,64,42,31,28,5,42,82,51.2,40,34,4,30,26,90,57,0,"https://fbref.com/en/players/ad00b1a8/Benno-Schmitz"
2023,"Köln","Bundesliga","Marvin Schwäbe","GER","GK","27",1995,34,1,0,1,0,0,1,1,100,0,0,0,0,2,3,8,2,"https://fbref.com/en/players/87436846/Marvin-Schwabe"
2023,"Köln","Bundesliga","Davie Selke","GER","FW","27",1995,9.7,0,0,0,0,0,0,4,0,4,4,1,3,0,0,11,0,"https://fbref.com/en/players/1238a3f9/Davie-Selke"
2023,"Köln","Bundesliga","Ellyes Skhiri","TUN","MF","27",1995,31.7,79,44,29,42,8,26,66,39.4,40,52,12,40,56,135,48,0,"https://fbref.com/en/players/c2211709/Ellyes-Skhiri"
2023,"Köln","Bundesliga","Nikola Soldo","CRO","DF","21",2001,6.6,15,9,8,7,0,7,11,63.6,4,7,6,1,7,22,28,0,"https://fbref.com/en/players/4f627629/Nikola-Soldo"
2023,"Köln","Bundesliga","Jan Thielmann","GER","FW","20",2002,9.7,9,8,3,4,2,2,11,18.2,9,16,3,13,9,18,7,0,"https://fbref.com/en/players/fd53759d/Jan-Thielmann"
2023,"Köln","Bundesliga","Steffen Tigges","GER","FW","24",1998,17.7,12,7,1,8,3,4,14,28.6,10,13,2,11,8,20,17,0,"https://fbref.com/en/players/6b8887c2/Steffen-Tigges"
2023,"Köln","Bundesliga","Mark Uth","GER","MF,FW","30",1991,0.5,0,0,0,0,0,0,0,NA,0,0,0,0,0,0,0,0,"https://fbref.com/en/players/a3ddb1b9/Mark-Uth"
2023,"Lazio","Serie A","Luis Alberto","ESP","MF","29",1992,27.1,49,29,18,20,11,23,72,31.9,49,35,6,29,9,58,4,0,"https://fbref.com/en/players/5294a83f/Luis-Alberto"
2023,"Lazio","Serie A","Felipe Anderson","BRA","FW","29",1993,32.9,80,50,31,41,8,31,88,35.2,57,58,6,52,31,111,27,0,"https://fbref.com/en/players/9f1893b9/Felipe-Anderson"
2023,"Lazio","Serie A","Marcos Antônio","BRA","MF","22",2000,6.6,9,6,4,5,0,9,20,45,11,7,2,5,11,20,18,0,"https://fbref.com/en/players/108fe016/Marcos-Antonio"
2023,"Lazio","Serie A","Toma Bašić","CRO","MF","25",1996,5.7,6,4,4,1,1,3,8,37.5,5,9,0,9,7,13,8,0,"https://fbref.com/en/players/80556f08/Toma-Basic"
2023,"Lazio","Serie A","Marco Bertini","ITA","MF","19",2002,0,0,0,0,0,0,0,0,NA,0,0,0,0,0,0,0,0,"https://fbref.com/en/players/4b520f96/Marco-Bertini"
2023,"Lazio","Serie A","Matteo Cancellieri","ITA","FW","20",2002,2.8,10,4,5,3,2,5,9,55.6,4,4,0,4,1,11,2,0,"https://fbref.com/en/players/b6a1cdf9/Matteo-Cancellieri"
2023,"Lazio","Serie A","Nicolò Casale","ITA","DF","24",1998,27.1,42,20,28,14,0,22,34,64.7,12,25,17,8,17,59,73,1,"https://fbref.com/en/players/3f5f38fb/Nicolo-Casale"
2023,"Lazio","Serie A","Danilo Cataldi","ITA","MF","27",1994,21.3,25,16,7,15,3,14,40,35,26,23,9,14,24,49,33,0,"https://fbref.com/en/players/ba3d3bea/Danilo-Cataldi"
2023,"Lazio","Serie A","Mario Gila","ESP","DF","21",2000,1,3,1,3,0,0,0,1,0,1,0,0,0,3,6,3,0,"https://fbref.com/en/players/9c435456/Mario-Gila"
2023,"Lazio","Serie A","Elseid Hysaj","ALB","DF","28",1994,22.2,39,23,24,11,4,23,41,56.1,18,31,7,24,20,59,42,0,"https://fbref.com/en/players/2f3452eb/Elseid-Hysaj"
2023,"Lazio","Serie A","Ciro Immobile","ITA","FW","32",1990,24.7,11,5,4,4,3,6,9,66.7,3,10,2,8,1,12,14,0,"https://fbref.com/en/players/4431aed2/Ciro-Immobile"
2023,"Lazio","Serie A","Manuel Lazzari","ITA","DF","28",1993,20.9,33,21,13,14,6,21,36,58.3,15,20,6,14,18,51,36,1,"https://fbref.com/en/players/02caf6e0/Manuel-Lazzari"
2023,"Lazio","Serie A","Adam Marušić","MNE","DF","29",1992,30.7,41,30,23,14,4,25,39,64.1,14,20,6,14,38,79,63,1,"https://fbref.com/en/players/d4535821/Adam-Marusic"
2023,"Lazio","Serie A","Luís Maximiano","POR","GK","23",1999,0.1,0,0,0,0,0,0,0,NA,0,0,0,0,0,0,0,0,"https://fbref.com/en/players/3318286e/Luis-Maximiano"
2023,"Lazio","Serie A","Sergej Milinković-Savić","SRB","MF","27",1995,33.6,58,35,22,23,13,24,67,35.8,43,50,12,38,28,86,49,0,"https://fbref.com/en/players/4e6dbac4/Sergej-Milinkovic-Savic"
2023,"Lazio","Serie A","Patric","ESP","DF","29",1993,15.7,17,11,12,3,2,11,16,68.8,5,17,12,5,11,28,53,1,"https://fbref.com/en/players/f7223718/Patric"
2023,"Lazio","Serie A","Pedro","ESP","FW","35",1987,21.1,35,24,14,10,11,11,30,36.7,19,18,2,16,6,41,4,1,"https://fbref.com/en/players/3ca7254a/Pedro"
2023,"Lazio","Serie A","Luca Pellegrini","ITA","DF","23",1999,2,1,0,0,1,0,1,4,25,3,3,0,3,7,8,4,0,"https://fbref.com/en/players/3b61c9ec/Luca-Pellegrini"
2023,"Lazio","Serie A","Ivan Provedel","ITA","GK","28",1994,37.9,1,0,1,0,0,0,0,NA,0,0,0,0,0,1,15,1,"https://fbref.com/en/players/277da414/Ivan-Provedel"
2023,"Lazio","Serie A","Ștefan Radu","ROU","FW","35",1986,0,0,0,0,0,0,0,0,NA,0,0,0,0,0,0,0,0,"https://fbref.com/en/players/53de807a/Stefan-Radu"
2023,"Lazio","Serie A","Alessio Romagnoli","ITA","DF","27",1995,32.5,33,15,19,14,0,11,22,50,11,33,26,7,38,71,108,0,"https://fbref.com/en/players/3ead85f9/Alessio-Romagnoli"
2023,"Lazio","Serie A","Luka Romero","ARG","FW","17",2004,1.7,0,0,0,0,0,0,3,0,3,4,0,4,3,3,1,0,"https://fbref.com/en/players/ca6edaa0/Luka-Romero"
2023,"Lazio","Serie A","Matías Vecino","URU","MF","30",1991,18.8,47,27,13,23,11,23,48,47.9,25,33,10,23,16,63,39,1,"https://fbref.com/en/players/44ac04e9/Matias-Vecino"
2023,"Lazio","Serie A","Mattia Zaccagni","ITA","FW","27",1995,30.8,42,28,16,18,8,14,38,36.8,24,37,3,34,21,63,10,1,"https://fbref.com/en/players/d85c238b/Mattia-Zaccagni"
2023,"Lecce","Serie A","Kristoffer Askildsen","NOR","MF","21",2001,8.1,7,3,2,3,2,4,10,40,6,15,4,11,11,18,6,0,"https://fbref.com/en/players/a69cc629/Kristoffer-Askildsen"
2023,"Lecce","Serie A","Lameck Banda","ZAM","FW,MF","21",2001,18.2,30,20,13,14,3,15,41,36.6,26,24,2,22,8,38,5,0,"https://fbref.com/en/players/8a6de8c7/Lameck-Banda"
2023,"Lecce","Serie A","Federico Baschirotto","ITA","DF","25",1996,37,40,30,35,5,0,22,36,61.1,14,45,29,16,36,76,192,0,"https://fbref.com/en/players/5a08ee41/Federico-Baschirotto"
2023,"Lecce","Serie A","Kristijan Bistrović","CRO","MF","24",1998,5.1,3,1,3,0,0,0,5,0,5,3,0,3,0,3,4,0,"https://fbref.com/en/players/79370f8c/Kristijan-Bistrovic"
2023,"Lecce","Serie A","Alexis Blin","FRA","MF","25",1996,26.4,69,39,27,33,9,38,73,52.1,35,55,15,40,34,103,74,0,"https://fbref.com/en/players/c69ef855/Alexis-Blin"
2023,"Lecce","Serie A","Tommaso Cassandro","ITA","DF","22",2000,0.1,1,1,0,1,0,0,0,NA,0,1,1,0,0,1,0,0,"https://fbref.com/en/players/6c4307ee/Tommaso-Cassandro"
2023,"Lecce","Serie A","Pietro Ceccaroni","ITA","DF","26",1995,0.5,0,0,0,0,0,0,0,NA,0,1,1,0,3,3,2,0,"https://fbref.com/en/players/4d1efb48/Pietro-Ceccaroni"
2023,"Lecce","Serie A","Assan Ceesay","GAM","FW","28",1994,20.1,23,18,7,8,8,9,17,52.9,8,15,2,13,3,26,24,0,"https://fbref.com/en/players/07f8bcc8/Assan-Ceesay"
2023,"Lecce","Serie A","Lorenzo Colombo","ITA","FW","20",2002,16.8,17,9,1,9,7,6,14,42.9,8,22,0,22,2,19,7,0,"https://fbref.com/en/players/04df29a5/Lorenzo-Colombo"
2023,"Lecce","Serie A","Kastriot Dermaku","ALB","DF","30",1992,0.4,0,0,0,0,0,0,0,NA,0,0,0,0,0,0,0,0,"https://fbref.com/en/players/2990c466/Kastriot-Dermaku"
2023,"Lecce","Serie A","Federico Di Francesco","ITA","FW,MF","28",1994,22.6,28,16,7,11,10,9,19,47.4,10,16,0,16,8,36,14,0,"https://fbref.com/en/players/1fca9171/Federico-Di-Francesco"
2023,"Lecce","Serie A","Wladimiro Falcone","ITA","GK","27",1995,38,2,0,2,0,0,2,2,100,0,0,0,0,2,4,21,3,"https://fbref.com/en/players/9f5a610b/Wladimiro-Falcone"
2023,"Lecce","Serie A","Antonino Gallo","ITA","DF","22",2000,27.6,56,36,35,12,9,38,57,66.7,19,37,6,31,13,69,71,0,"https://fbref.com/en/players/c74d63ac/Antonino-Gallo"
2023,"Lecce","Serie A","Valentin Gendrey","FRA","DF","22",2000,34.5,88,57,54,25,9,40,71,56.3,31,45,4,41,37,125,89,0,"https://fbref.com/en/players/822ed0ec/Valentin-Gendrey"
2023,"Lecce","Serie A","Joan Gonzàlez","ESP","MF","20",2002,24.4,48,28,20,18,10,17,51,33.3,34,37,8,29,16,64,28,0,"https://fbref.com/en/players/f025eade/Joan-Gonzalez"
2023,"Lecce","Serie A","Morten Hjulmand","DEN","MF","23",1999,32.9,90,52,49,40,1,37,67,55.2,30,43,11,32,72,162,54,0,"https://fbref.com/en/players/d4456fb3/Morten-Hjulmand"
2023,"Lecce","Serie A","Þórir Jóhann Helgason","ISL","MF","21",2000,2.5,2,2,1,0,1,2,3,66.7,1,3,1,2,3,5,3,0,"https://fbref.com/en/players/dc765618/Thorir-Johann-Helgason"
2023,"Lecce","Serie A","Marcin Listkowski","POL","MF,FW","24",1998,0.9,0,0,0,0,0,0,0,NA,0,0,0,0,3,3,2,0,"https://fbref.com/en/players/a3695ac2/Marcin-Listkowski"
2023,"Lecce","Serie A","Youssef Maleh","MAR","MF","23",1998,7.5,17,8,3,7,7,6,14,42.9,8,20,1,19,5,22,10,0,"https://fbref.com/en/players/4c8845f7/Youssef-Maleh"
2023,"Lecce","Serie A","Yıldırım Mert Çetin","TUR","DF","25",1997,0.2,1,0,1,0,0,0,0,NA,0,0,0,0,1,2,1,0,"https://fbref.com/en/players/c730da00/Yildirim-Mert-Cetin"
2023,"Lecce","Serie A","Remi Oudin","FRA","FW,MF","25",1996,14.7,25,13,9,12,4,10,23,43.5,13,16,2,14,29,54,23,0,"https://fbref.com/en/players/ea02beaf/Remi-Oudin"
2023,"Lecce","Serie A","Giuseppe Pezzella","ITA","DF","24",1997,10.2,21,9,16,2,3,9,16,56.3,7,11,3,8,8,29,31,1,"https://fbref.com/en/players/149c5f5d/Giuseppe-Pezzella"
2023,"Lecce","Serie A","Marin Pongračić","CRO","DF","24",1997,8.8,16,14,8,7,1,5,7,71.4,2,4,3,1,16,32,31,0,"https://fbref.com/en/players/2a6cd437/Marin-Pongracic"
2023,"Lecce","Serie A","Pablo Rodríguez","ESP","FW,MF","20",2001,0.6,2,1,2,0,0,0,2,0,2,3,0,3,0,2,0,0,"https://fbref.com/en/players/1d4e63b6/Pablo-Rodriguez"
2023,"Lecce","Serie A","Simone Romagnoli","ITA","DF","32",1990,1.9,6,5,3,3,0,2,2,100,0,4,1,3,1,7,11,0,"https://fbref.com/en/players/09899de8/Simone-Romagnoli"
2023,"Lecce","Serie A","Gabriel Strefezza","BRA","FW,MF","25",1997,27.1,50,24,18,20,12,27,53,50.9,26,36,3,33,16,66,15,0,"https://fbref.com/en/players/674cfc5a/Gabriel-Strefezza"
2023,"Lecce","Serie A","Alessandro Tuia","ITA","DF","32",1990,5.7,10,6,6,4,0,3,9,33.3,6,3,1,2,15,25,29,0,"https://fbref.com/en/players/26c54058/Alessandro-Tuia"
2023,"Lecce","Serie A","Samuel Umtiti","FRA","DF","28",1993,23.5,52,34,25,25,2,18,26,69.2,8,26,14,12,26,78,79,0,"https://fbref.com/en/players/3eed9821/Samuel-Umtiti"
2023,"Lecce","Serie A","Joel Voelkerling Persson","SWE","FW,MF","19",2003,1.1,1,1,0,0,1,0,1,0,1,1,0,1,0,1,0,0,"https://fbref.com/en/players/b3ef6517/Joel-Voelkerling-Persson"
2023,"Leeds United","Premier League","Brenden Aaronson","USA","MF,FW","21",2000,26.4,45,18,16,22,7,15,46,32.6,31,43,3,40,5,50,6,1,"https://fbref.com/en/players/5bc43860/Brenden-Aaronson"
2023,"Leeds United","Premier League","Tyler Adams","USA","MF","23",1999,24,89,46,44,35,10,50,77,64.9,27,48,8,40,35,124,29,0,"https://fbref.com/en/players/2b09d998/Tyler-Adams"
2023,"Leeds United","Premier League","Luke Ayling","ENG","DF","30",1991,22.8,66,37,42,15,9,42,85,49.4,43,34,11,23,26,92,52,2,"https://fbref.com/en/players/420d7c7d/Luke-Ayling"
2023,"Leeds United","Premier League","Patrick Bamford","ENG","FW","28",1993,16.8,9,6,0,6,3,4,20,20,16,12,5,7,5,14,13,0,"https://fbref.com/en/players/93feac6e/Patrick-Bamford"
2023,"Leeds United","Premier League","Liam Cooper","SCO","DF","30",1991,15.8,38,23,27,9,2,23,36,63.9,13,16,8,8,34,72,57,3,"https://fbref.com/en/players/dc64b8b3/Liam-Cooper"
2023,"Leeds United","Premier League","Cody Drameh","ENG","DF","20",2001,0.8,5,4,0,4,1,2,3,66.7,1,0,0,0,1,6,1,0,"https://fbref.com/en/players/e0d1510a/Cody-Drameh"
2023,"Leeds United","Premier League","Junior Firpo","ESP","DF","25",1996,15.2,47,25,27,15,5,24,46,52.2,22,23,7,16,24,71,40,0,"https://fbref.com/en/players/24f59bb2/Junior-Firpo"
2023,"Leeds United","Premier League","Adam Forshaw","ENG","MF","30",1991,5.3,12,9,5,7,0,7,17,41.2,10,9,1,8,4,16,2,0,"https://fbref.com/en/players/9f1938ab/Adam-Forshaw"
2023,"Leeds United","Premier League","Joe Gelhardt","ENG","FW","20",2002,2.4,6,2,1,3,2,3,5,60,2,5,0,5,0,6,4,0,"https://fbref.com/en/players/01962d0d/Joe-Gelhardt"
2023,"Leeds United","Premier League","Degnand Gnonto","ITA","FW,MF","18",2003,15,27,17,7,15,5,10,30,33.3,20,24,1,23,5,32,7,0,"https://fbref.com/en/players/75fdd638/Degnand-Gnonto"
2023,"Leeds United","Premier League","Sam Greenwood","ENG","MF,FW","20",2002,4.7,15,7,7,8,0,8,21,38.1,13,10,2,8,1,16,1,0,"https://fbref.com/en/players/f3354c07/Sam-Greenwood"
2023,"Leeds United","Premier League","Darko Gyabi","ENG","FW","18",2004,0.1,2,2,1,1,0,0,0,NA,0,2,0,2,0,2,0,0,"https://fbref.com/en/players/56d838f7/Darko-Gyabi"
2023,"Leeds United","Premier League","Jack Harrison","ENG","FW,MF","25",1996,30.1,41,17,5,15,21,12,52,23.1,40,47,2,45,22,63,25,0,"https://fbref.com/en/players/aa849a12/Jack-Harrison"
2023,"Leeds United","Premier League","Daniel James","WAL","FW","24",1997,2.2,6,2,1,3,2,3,6,50,3,4,0,4,2,8,2,0,"https://fbref.com/en/players/c931d9f9/Daniel-James"
2023,"Leeds United","Premier League","Mateo Joseph","ENG","FW,MF","18",2003,0.3,0,0,0,0,0,0,0,NA,0,1,0,1,0,0,1,0,"https://fbref.com/en/players/6ad43f9a/Mateo-Joseph"
2023,"Leeds United","Premier League","Mateusz Klich","POL","MF,FW","32",1990,3.1,12,8,3,4,5,7,13,53.8,6,4,0,4,0,12,1,0,"https://fbref.com/en/players/282679b4/Mateusz-Klich"
2023,"Leeds United","Premier League","Robin Koch","GER","DF","26",1996,35.3,53,30,32,16,5,24,56,42.9,32,44,21,23,43,96,152,1,"https://fbref.com/en/players/ea6bc03a/Robin-Koch"
2023,"Leeds United","Premier League","Diego Llorente","ESP","DF","28",1993,7.2,13,10,8,5,0,4,8,50,4,6,2,4,15,28,24,2,"https://fbref.com/en/players/bba30585/Diego-Llorente"
2023,"Leeds United","Premier League","Weston McKennie","USA","MF","23",1998,16,30,13,5,18,7,10,29,34.5,19,22,3,19,22,52,26,0,"https://fbref.com/en/players/01c3aff5/Weston-McKennie"
2023,"Leeds United","Premier League","Illan Meslier","FRA","GK","22",2000,34,2,1,2,0,0,2,4,50,2,0,0,0,1,3,30,3,"https://fbref.com/en/players/6b625ac2/Illan-Meslier"
2023,"Leeds United","Premier League","Rasmus Nissen","DEN","DF","25",1997,21.8,62,35,35,21,6,42,76,55.3,34,32,14,18,35,97,61,0,"https://fbref.com/en/players/39769cff/Rasmus-Nissen"
2023,"Leeds United","Premier League","Joel Robles","ESP","GK","32",1990,4,0,0,0,0,0,0,1,0,1,0,0,0,0,0,2,1,"https://fbref.com/en/players/cda0b317/Joel-Robles"
2023,"Leeds United","Premier League","Marc Roca","ESP","MF","25",1996,25.7,66,40,27,34,5,20,65,30.8,45,34,10,24,23,89,24,2,"https://fbref.com/en/players/da27e268/Marc-Roca"
2023,"Leeds United","Premier League","Rodrigo","ESP","FW,MF","31",1991,21.5,24,10,2,15,7,8,19,42.1,11,16,4,12,6,30,21,1,"https://fbref.com/en/players/1fb1c435/Rodrigo"
2023,"Leeds United","Premier League","Georginio Rutter","FRA","FW,MF","20",2002,3,10,9,5,3,2,5,8,62.5,3,5,0,5,3,13,3,0,"https://fbref.com/en/players/c64c01fc/Georginio-Rutter"
2023,"Leeds United","Premier League","Luis Sinisterra","COL","FW","23",1999,9.6,21,14,8,9,4,11,18,61.1,7,11,1,10,8,29,2,0,"https://fbref.com/en/players/8e16dd48/Luis-Sinisterra"
2023,"Leeds United","Premier League","Pascal Struijk","NED","DF","22",1999,24.4,84,57,43,31,10,49,75,65.3,26,32,12,20,32,116,70,1,"https://fbref.com/en/players/f4d296e4/Pascal-Struijk"
2023,"Leeds United","Premier League","Crysencio Summerville","NED","FW","20",2001,15.8,30,20,14,14,2,11,23,47.8,12,20,2,18,13,43,11,0,"https://fbref.com/en/players/df04eb4b/Crysencio-Summerville"
2023,"Leeds United","Premier League","Maximilian Wöber","AUT","DF","24",1998,14.1,25,18,9,15,1,16,24,66.7,8,32,14,18,27,52,67,1,"https://fbref.com/en/players/4b803b3c/Maximilian-Wober"
2023,"Leicester City","Premier League","Marc Albrighton","ENG","FW,MF","32",1989,2.6,4,1,0,2,2,1,8,12.5,7,6,2,4,1,5,5,0,"https://fbref.com/en/players/b827d5b3/Marc-Albrighton"
2023,"Leicester City","Premier League","Daniel Amartey","GHA","DF","27",1994,17.9,19,8,13,5,1,12,14,85.7,2,24,17,7,8,27,71,0,"https://fbref.com/en/players/1a4ef233/Daniel-Amartey"
2023,"Leicester City","Premier League","Harvey Barnes","ENG","FW,MF","24",1997,30.1,26,14,8,14,4,14,42,33.3,28,32,1,31,8,34,12,0,"https://fbref.com/en/players/3ea50f67/Harvey-Barnes"
2023,"Leicester City","Premier League","Victor Bernth Kristiansen","DEN","DF","19",2002,9.9,38,23,18,16,4,22,30,73.3,8,16,4,12,3,41,26,0,"https://fbref.com/en/players/505486d6/Victor-Bernth-Kristiansen"
2023,"Leicester City","Premier League","Lewis Brunt","ENG","DF","21",2000,0.3,0,0,0,0,0,0,0,NA,0,0,0,0,0,0,2,0,"https://fbref.com/en/players/a2081c6b/Lewis-Brunt"
2023,"Leicester City","Premier League","Timothy Castagne","BEL","DF","26",1995,36.2,87,44,53,27,7,41,84,48.8,43,50,13,37,43,130,110,0,"https://fbref.com/en/players/197640fd/Timothy-Castagne"
2023,"Leicester City","Premier League","Patson Daka","ZAM","FW","23",1998,13.2,14,8,6,8,0,3,12,25,9,14,2,12,7,21,7,0,"https://fbref.com/en/players/ca45605e/Patson-Daka"
2023,"Leicester City","Premier League","Kiernan Dewsbury-Hall","ENG","MF","23",1998,25.6,53,29,14,34,5,19,47,40.4,28,55,13,42,28,81,21,0,"https://fbref.com/en/players/5c74c0f5/Kiernan-Dewsbury-Hall"
2023,"Leicester City","Premier League","Jonny Evans","NIR","DF","34",1988,11.7,13,5,12,1,0,7,11,63.6,4,15,11,4,18,31,51,0,"https://fbref.com/en/players/f8fcd2a5/Jonny-Evans"
2023,"Leicester City","Premier League","Wout Faes","BEL","DF","24",1998,31,56,33,28,26,2,28,44,63.6,16,53,37,16,41,97,113,2,"https://fbref.com/en/players/9c221d14/Wout-Faes"
2023,"Leicester City","Premier League","Wesley Fofana","FRA","DF","21",2000,2,4,2,1,2,1,1,3,33.3,2,1,1,0,9,13,5,0,"https://fbref.com/en/players/132a82f1/Wesley-Fofana"
2023,"Leicester City","Premier League","Kelechi Iheanacho","NGA","FW,MF","25",1996,12.5,7,2,0,3,4,3,10,30,7,9,1,8,0,7,8,0,"https://fbref.com/en/players/c92e1a31/Kelechi-Iheanacho"
2023,"Leicester City","Premier League","Daniel Iversen","DEN","GK","25",1997,12,0,0,0,0,0,0,0,NA,0,0,0,0,0,0,6,1,"https://fbref.com/en/players/10d221cd/Daniel-Iversen"
2023,"Leicester City","Premier League","James Justin","ENG","DF","24",1998,13.9,20,18,7,12,1,9,14,64.3,5,24,6,18,15,35,47,0,"https://fbref.com/en/players/fb614c44/James-Justin"
2023,"Leicester City","Premier League","James Maddison","ENG","MF,FW","25",1996,27.6,51,26,25,19,7,19,50,38,31,19,1,18,13,64,6,1,"https://fbref.com/en/players/ee38d9c5/James-Maddison"
2023,"Leicester City","Premier League","Nampalys Mendy","SEN","MF","30",1992,8.4,13,9,7,6,0,8,15,53.3,7,20,4,16,13,26,2,0,"https://fbref.com/en/players/1598599e/Nampalys-Mendy"
2023,"Leicester City","Premier League","Wilfred Ndidi","NGA","MF","25",1996,18.7,61,42,34,24,3,17,43,39.5,26,32,14,18,38,99,48,3,"https://fbref.com/en/players/6b47c5db/Wilfred-Ndidi"
2023,"Leicester City","Premier League","Ricardo Pereira","POR","DF,MF","28",1993,5,11,7,8,3,0,7,17,41.2,10,8,2,6,4,15,20,0,"https://fbref.com/en/players/75a72a99/Ricardo-Pereira"
2023,"Leicester City","Premier League","Ayoze Pérez","ESP","MF,FW","29",1993,4.2,11,8,5,4,2,8,19,42.1,11,6,0,6,2,13,3,0,"https://fbref.com/en/players/819aa8e7/Ayoze-Perez"
2023,"Leicester City","Premier League","Dennis Praet","BEL","MF,FW","28",1994,7.2,12,9,5,6,1,6,11,54.5,5,12,2,10,5,17,6,0,"https://fbref.com/en/players/86695068/Dennis-Praet"
2023,"Leicester City","Premier League","Boubakary Soumaré","FRA","MF","23",1999,18.1,57,34,29,26,2,23,43,53.5,20,15,4,11,33,90,27,1,"https://fbref.com/en/players/ae59b359/Boubakary-Soumare"
2023,"Leicester City","Premier League","Harry Souttar","AUS","DF","23",1998,11,15,9,10,5,0,7,18,38.9,11,16,12,4,12,27,45,0,"https://fbref.com/en/players/0a6cb1b1/Harry-Souttar"
2023,"Leicester City","Premier League","Çağlar Söyüncü","TUR","DF","26",1996,5.9,14,9,10,4,0,7,10,70,3,9,8,1,7,21,30,0,"https://fbref.com/en/players/21166ff4/Caglar-Soyuncu"
2023,"Leicester City","Premier League","Tetê","BRA","FW","22",2000,8.2,14,8,5,7,2,6,21,28.6,15,9,0,9,2,16,3,0,"https://fbref.com/en/players/7120a04d/Tete"
2023,"Leicester City","Premier League","Luke Thomas","ENG","DF","21",2001,11.9,23,19,15,5,3,15,32,46.9,17,20,4,16,27,50,35,0,"https://fbref.com/en/players/fc027d02/Luke-Thomas"
2023,"Leicester City","Premier League","Youri Tielemans","BEL","MF","25",1997,26,66,39,27,30,9,23,61,37.7,38,35,8,27,28,94,24,1,"https://fbref.com/en/players/56f7a928/Youri-Tielemans"
2023,"Leicester City","Premier League","Jamie Vardy","ENG","FW","35",1987,20.6,10,5,4,3,3,1,7,14.3,6,17,3,14,2,12,30,0,"https://fbref.com/en/players/45963054/Jamie-Vardy"
2023,"Leicester City","Premier League","Danny Ward","WAL","GK","29",1993,26,1,1,1,0,0,1,3,33.3,2,0,0,0,0,1,14,2,"https://fbref.com/en/players/d3ce0e89/Danny-Ward"
2023,"Lens","Ligue 1","Salis Abdul Samed","GHA","MF","22",2000,32.2,46,26,18,23,5,29,52,55.8,23,38,9,29,36,82,26,0,"https://fbref.com/en/players/82464ce3/Salis-Abdul-Samed"
2023,"Lens","Ligue 1","Patrick Berg","NOR","MF,FW","24",1997,0.3,0,0,0,0,0,0,1,0,1,0,0,0,1,1,0,0,"https://fbref.com/en/players/e4114f5d/Patrick-Berg"
2023,"Lens","Ligue 1","Ismaëlben Boura","FRA","DF,FW","21",2000,1,6,4,4,2,0,5,6,83.3,1,2,1,1,2,8,3,0,"https://fbref.com/en/players/62e02107/Ismaelben-Boura"
2023,"Lens","Ligue 1","Adam Buksa","POL","FW,MF","26",1996,1.1,1,0,0,0,1,0,3,0,3,0,0,0,0,1,0,0,"https://fbref.com/en/players/3b676989/Adam-Buksa"
2023,"Lens","Ligue 1","Jimmy Cabot","FRA","DF,MF","28",1994,5.7,20,12,10,8,2,12,26,46.2,14,5,0,5,4,24,12,0,"https://fbref.com/en/players/46359159/Jimmy-Cabot"
2023,"Lens","Ligue 1","Alexis Claude-Maurice","FRA","MF,FW","24",1998,6.7,14,9,5,8,1,6,16,37.5,10,6,0,6,2,16,1,0,"https://fbref.com/en/players/741418c3/Alexis-Claude-Maurice"
2023,"Lens","Ligue 1","David Pereira da Costa","POR","MF,FW","21",2001,15.6,13,7,1,10,2,7,19,36.8,12,19,1,18,11,24,6,0,"https://fbref.com/en/players/59948ef7/David-Pereira-da-Costa"
2023,"Lens","Ligue 1","Kevin Danso","AUT","DF","23",1998,35.9,37,19,25,11,1,19,30,63.3,11,48,34,14,33,70,124,0,"https://fbref.com/en/players/6e33125f/Kevin-Danso"
2023,"Lens","Ligue 1","Seko Fofana","CIV","MF","27",1995,34.1,28,13,8,18,2,15,39,38.5,24,17,4,13,19,47,14,0,"https://fbref.com/en/players/5313ed43/Seko-Fofana"
2023,"Lens","Ligue 1","Steven Fortes","CPV","DF","30",1992,0.1,0,0,0,0,0,0,0,NA,0,0,0,0,0,0,0,0,"https://fbref.com/en/players/574aa9ec/Steven-Fortes"
2023,"Lens","Ligue 1","Przemysław Frankowski","POL","DF,MF","27",1995,31.5,77,51,37,31,9,39,80,48.8,41,38,6,32,41,118,42,2,"https://fbref.com/en/players/00a8d210/Przemyslaw-Frankowski"
2023,"Lens","Ligue 1","Angelo Fulgini","FRA","MF,FW","25",1996,9.5,14,7,2,4,8,5,14,35.7,9,11,0,11,8,22,2,0,"https://fbref.com/en/players/4b96c347/Angelo-Fulgini"
2023,"Lens","Ligue 1","Ignatius Ganago","CMR","FW","23",1999,0.7,0,0,0,0,0,0,0,NA,0,0,0,0,0,0,1,0,"https://fbref.com/en/players/23c63b7f/Ignatius-Ganago"
2023,"Lens","Ligue 1","Jonathan Gradit","FRA","DF","29",1992,31.4,62,40,30,25,7,31,53,58.5,22,40,26,14,38,100,83,0,"https://fbref.com/en/players/06c48679/Jonathan-Gradit"
2023,"Lens","Ligue 1","Massadio Haïdara","MLI","DF,MF","29",1992,18.6,24,16,9,9,6,12,24,50,12,26,9,17,36,60,39,1,"https://fbref.com/en/players/5167c97e/Massadio-Haidara"
2023,"Lens","Ligue 1","Gaël Kakuta","COD","FW","31",1991,0.2,0,0,0,0,0,0,0,NA,0,0,0,0,0,0,1,0,"https://fbref.com/en/players/5b1bf5e3/Gael-Kakuta"
2023,"Lens","Ligue 1","Rémy Labeau Lascary","GLP","FW,MF","19",2003,1.4,4,2,4,0,0,0,0,NA,0,4,0,4,1,5,0,0,"https://fbref.com/en/players/c90f380c/Remy-Labeau-Lascary"
2023,"Lens","Ligue 1","Julien Le Cardinal","FRA","DF","24",1997,1.8,6,4,5,0,1,4,6,66.7,2,3,0,3,2,8,5,0,"https://fbref.com/en/players/547a72ad/Julien-Le-Cardinal"
2023,"Lens","Ligue 1","Jean-Louis Leca","FRA","GK","36",1985,1,0,0,0,0,0,0,0,NA,0,0,0,0,0,0,0,1,"https://fbref.com/en/players/edbe46dc/Jean-Louis-Leca"
2023,"Lens","Ligue 1","Deiver Machado","COL","DF,MF","28",1993,24.3,45,26,18,20,7,21,34,61.8,13,21,4,17,21,66,27,0,"https://fbref.com/en/players/b3f8bdef/Deiver-Machado"
2023,"Lens","Ligue 1","Facundo Medina","ARG","DF","23",1999,30.9,31,20,16,15,0,13,35,37.1,22,25,9,16,26,57,62,1,"https://fbref.com/en/players/6f5ec8bb/Facundo-Medina"
2023,"Lens","Ligue 1","Jean Onana","CMR","MF,DF","22",2000,9,28,17,8,17,3,10,22,45.5,12,15,5,10,18,46,20,0,"https://fbref.com/en/players/b5bb8188/Jean-Onana"
2023,"Lens","Ligue 1","Loïs Openda","BEL","FW","22",2000,28,11,9,2,6,3,2,13,15.4,11,9,0,9,2,13,6,0,"https://fbref.com/en/players/8652a85c/Lois-Openda"
2023,"Lens","Ligue 1","Łukasz Poręba","POL","MF","22",2000,2.9,5,4,2,1,2,2,3,66.7,1,3,0,3,4,9,2,0,"https://fbref.com/en/players/be98f358/Lukasz-Poreba"
2023,"Lens","Ligue 1","Wesley Saïd","FRA","FW,MF","27",1995,7.2,4,1,1,2,1,2,6,33.3,4,4,0,4,1,5,2,0,"https://fbref.com/en/players/90fcf472/Wesley-Said"
2023,"Lens","Ligue 1","Brice Samba","FRA","GK","28",1994,37,1,0,1,0,0,1,2,50,1,1,0,1,0,1,12,2,"https://fbref.com/en/players/60d90c55/Brice-Samba"
2023,"Lens","Ligue 1","Florian Sotoca","FRA","MF,FW","31",1990,33.9,39,19,11,17,11,15,40,37.5,25,41,2,39,29,68,51,0,"https://fbref.com/en/players/7a42d0df/Florian-Sotoca"
2023,"Lens","Ligue 1","Adrien Thomasson","FRA","MF,FW","28",1993,14.2,24,17,8,11,5,12,45,26.7,33,25,2,23,4,28,17,0,"https://fbref.com/en/players/c76b7567/Adrien-Thomasson"
2023,"Lens","Ligue 1","Christopher Wooh","CMR","MF","20",2001,0,0,0,0,0,0,0,1,0,1,0,0,0,0,0,1,0,"https://fbref.com/en/players/b003239d/Christopher-Wooh"
2023,"Leverkusen","Bundesliga","Amine Adli","FRA","FW,MF","22",2000,15.9,18,10,4,6,8,5,17,29.4,12,28,2,26,6,24,7,0,"https://fbref.com/en/players/dcfb17f4/Amine-Adli"
2023,"Leverkusen","Bundesliga","Nadiem Amiri","GER","MF,FW","25",1996,10.9,15,6,5,8,2,9,20,45,11,12,1,11,6,21,10,2,"https://fbref.com/en/players/555d5edd/Nadiem-Amiri"
2023,"Leverkusen","Bundesliga","Robert Andrich","GER","MF","27",1994,26.7,61,38,30,27,4,26,45,57.8,19,27,9,18,42,103,55,2,"https://fbref.com/en/players/e0b113a7/Robert-Andrich"
2023,"Leverkusen","Bundesliga","Charles Aránguiz","CHI","MF","33",1989,5.5,17,7,7,10,0,12,20,60,8,4,0,4,7,24,4,0,"https://fbref.com/en/players/56413b1f/Charles-Aranguiz"
2023,"Leverkusen","Bundesliga","Ayman Azhil","MAR","MF","21",2001,0,0,0,0,0,0,0,0,NA,0,0,0,0,0,0,0,0,"https://fbref.com/en/players/ce81d82d/Ayman-Azhil"
2023,"Leverkusen","Bundesliga","Sardar Azmoun","IRN","FW,MF","27",1995,10.3,6,3,1,4,1,1,7,14.3,6,4,0,4,2,8,14,0,"https://fbref.com/en/players/10549b49/Sardar-Azmoun"
2023,"Leverkusen","Bundesliga","Mitchel Bakker","NED","DF,MF","22",2000,18.4,16,8,9,7,0,6,15,40,9,20,2,18,15,31,20,2,"https://fbref.com/en/players/a8567629/Mitchel-Bakker"
2023,"Leverkusen","Bundesliga","Karim Bellarabi","GER","FW,MF","32",1990,0.9,2,0,1,1,0,2,3,66.7,1,0,0,0,0,2,0,0,"https://fbref.com/en/players/bee0bab1/Karim-Bellarabi"
2023,"Leverkusen","Bundesliga","Kerem Demirbay","GER","MF","29",1993,17.2,36,18,16,17,3,18,34,52.9,16,26,6,20,16,52,11,0,"https://fbref.com/en/players/54b4dc4e/Kerem-Demirbay"
2023,"Leverkusen","Bundesliga","Moussa Diaby","FRA","FW,MF","23",1999,30,14,8,4,8,2,7,14,50,7,8,0,8,5,19,3,0,"https://fbref.com/en/players/aeed5c06/Moussa-Diaby"
2023,"Leverkusen","Bundesliga","Timothy Fosu-Mensah","NED","DF","24",1998,2.1,7,5,3,3,1,4,4,100,0,2,0,2,0,7,1,0,"https://fbref.com/en/players/a9142dc3/Timothy-Fosu-Mensah"
2023,"Leverkusen","Bundesliga","Jeremie Frimpong","NED","DF,MF","21",2000,30.1,53,27,22,26,5,23,44,52.3,21,24,3,21,16,69,40,0,"https://fbref.com/en/players/74f2e748/Jeremie-Frimpong"
2023,"Leverkusen","Bundesliga","Piero Hincapié","ECU","DF","20",2002,27.3,51,34,28,20,3,25,38,65.8,13,41,20,21,31,82,83,1,"https://fbref.com/en/players/0c7a48f8/Piero-Hincapie"
2023,"Leverkusen","Bundesliga","Adam Hložek","CZE","FW,MF","20",2002,14.3,9,4,4,3,2,3,9,33.3,6,9,2,7,6,15,9,0,"https://fbref.com/en/players/5521f419/Adam-Hlozek"
2023,"Leverkusen","Bundesliga","Lukáš Hrádecký","FIN","GK","32",1989,33,0,0,0,0,0,0,0,NA,0,0,0,0,0,0,3,3,"https://fbref.com/en/players/ad3389d5/Lukas-Hradecky"
2023,"Leverkusen","Bundesliga","Callum Hudson-Odoi","ENG","FW,MF","21",2000,6.7,5,3,4,0,1,1,1,100,0,0,0,0,2,7,4,0,"https://fbref.com/en/players/15f3ec41/Callum-Hudson-Odoi"
2023,"Leverkusen","Bundesliga","Odilon Kossonou","CIV","DF","21",2001,16.9,21,14,12,7,2,8,16,50,8,26,11,15,24,45,58,1,"https://fbref.com/en/players/1f3afdcb/Odilon-Kossonou"
2023,"Leverkusen","Bundesliga","Andrey Lunyov","RUS","GK","30",1991,1,0,0,0,0,0,0,0,NA,0,0,0,0,0,0,0,0,"https://fbref.com/en/players/8a6ab963/Andrey-Lunyov"
2023,"Leverkusen","Bundesliga","Noah Mbamba","BEL","MF","17",2005,0,0,0,0,0,0,0,0,NA,0,0,0,0,0,0,0,0,"https://fbref.com/en/players/e75129bd/Noah-Mbamba"
2023,"Leverkusen","Bundesliga","Exequiel Palacios","ARG","MF","23",1998,18.4,59,36,20,33,6,29,48,60.4,19,29,2,27,33,92,28,0,"https://fbref.com/en/players/e82adcab/Exequiel-Palacios"
2023,"Leverkusen","Bundesliga","Paulinho","BRA","FW","22",2000,0.9,0,0,0,0,0,0,0,NA,0,1,0,1,0,0,2,0,"https://fbref.com/en/players/53070b63/Paulinho"
2023,"Leverkusen","Bundesliga","Joel Pohjanpalo","FIN","FW,MF","27",1994,0,0,0,0,0,0,0,0,NA,0,0,0,0,0,0,0,0,"https://fbref.com/en/players/ea003d07/Joel-Pohjanpalo"
2023,"Leverkusen","Bundesliga","Patrik Schick","CZE","FW","26",1996,10.5,0,0,0,0,0,0,1,0,1,4,1,3,1,1,7,0,"https://fbref.com/en/players/5d4f7d61/Patrik-Schick"
2023,"Leverkusen","Bundesliga","Daley Sinkgraven","NED","DF,MF","27",1995,3.8,10,7,7,3,0,7,9,77.8,2,8,4,4,5,15,7,0,"https://fbref.com/en/players/73000a79/Daley-Sinkgraven"
2023,"Leverkusen","Bundesliga","Jonathan Tah","GER","DF","26",1996,27.6,25,12,21,4,0,12,18,66.7,6,30,18,12,40,65,118,0,"https://fbref.com/en/players/bd142efb/Jonathan-Tah"
2023,"Leverkusen","Bundesliga","Edmond Tapsoba","BFA","DF","23",1999,31.9,51,30,35,12,4,30,42,71.4,12,40,17,23,36,87,109,1,"https://fbref.com/en/players/a73c8f95/Edmond-Tapsoba"
2023,"Leverkusen","Bundesliga","Florian Wirtz","GER","FW,MF","19",2003,12.1,18,10,9,7,2,8,16,50,8,15,1,14,1,19,6,0,"https://fbref.com/en/players/e7fcf289/Florian-Wirtz"
2023,"Lille","Ligue 1","Benjamin André","FRA","MF","31",1990,32.4,128,74,51,60,17,65,121,53.7,56,50,8,42,47,175,60,0,"https://fbref.com/en/players/ef9c1c95/Benjamin-Andre"
2023,"Lille","Ligue 1","Carlos Baleba","CMR","MF","18",2004,5.3,13,11,2,9,2,9,14,64.3,5,13,3,10,1,14,3,2,"https://fbref.com/en/players/a1390d2f/Carlos-Baleba"
2023,"Lille","Ligue 1","Jonathan Bamba","CIV","FW","26",1996,30.9,37,17,12,14,11,14,45,31.1,31,36,1,35,22,59,14,0,"https://fbref.com/en/players/b2bd0f6c/Jonathan-Bamba"
2023,"Lille","Ligue 1","Rémy Cabella","FRA","MF,FW","32",1990,28.1,64,37,21,28,15,29,64,45.3,35,41,5,36,17,81,7,1,"https://fbref.com/en/players/148e136f/Remy-Cabella"
2023,"Lille","Ligue 1","Leonardo César Jardim","BRA","GK","27",1995,6,NA,0,NA,NA,NA,NA,NA,NA,NA,NA,NA,NA,0,NA,NA,NA,"https://fbref.com/en/players/f5dfc256/Leonardo-Cesar-Jardim"
2023,"Lille","Ligue 1","Lucas Chevalier","FRA","GK","20",2001,32,2,1,2,0,0,2,2,100,0,1,0,1,2,4,7,2,"https://fbref.com/en/players/b3d76d84/Lucas-Chevalier"
2023,"Lille","Ligue 1","Jonathan David","CAN","FW","22",2000,35.2,24,17,6,11,7,10,27,37,17,20,2,18,8,32,13,0,"https://fbref.com/en/players/ce50fd99/Jonathan-David"
2023,"Lille","Ligue 1","Bafodé Diakité","FRA","DF","21",2001,29.5,54,35,23,24,7,32,57,56.1,25,37,8,29,17,71,58,0,"https://fbref.com/en/players/1bfb6fef/Bafode-Diakite"
2023,"Lille","Ligue 1","Tiago Djaló","POR","DF","22",2000,22.4,31,21,23,7,1,13,20,65,7,17,11,6,23,54,60,1,"https://fbref.com/en/players/b2336681/Tiago-Djalo"
2023,"Lille","Ligue 1","José Fonte","POR","DF","38",1983,28.8,23,17,18,4,1,10,21,47.6,11,27,14,13,25,48,112,2,"https://fbref.com/en/players/90f87966/Jose-Fonte"
2023,"Lille","Ligue 1","André Gomes","POR","MF","29",1993,18.1,37,19,12,17,8,19,52,36.5,33,20,5,15,9,46,16,1,"https://fbref.com/en/players/1961b2aa/Andre-Gomes"
2023,"Lille","Ligue 1","Angel Gomes","ENG","MF","21",2000,31.3,41,19,12,21,8,18,49,36.7,31,22,2,20,13,54,11,1,"https://fbref.com/en/players/645a3363/Angel-Gomes"
2023,"Lille","Ligue 1","Gabriel Gudmundsson","SWE","DF,FW","23",1999,9.3,19,11,7,10,2,12,22,54.5,10,11,2,9,10,29,20,0,"https://fbref.com/en/players/d5d22a58/Gabriel-Gudmundsson"
2023,"Lille","Ligue 1","Ismaily","BRA","DF","32",1990,19.8,41,18,16,16,9,17,32,53.1,15,25,5,20,21,62,39,0,"https://fbref.com/en/players/cf182add/Ismaily"
2023,"Lille","Ligue 1","Mohamed Lamine Bayo","GUI","FW,MF","24",1998,7.2,3,3,0,2,1,0,12,0,12,3,1,2,0,3,1,0,"https://fbref.com/en/players/01870104/Mohamed-Lamine-Bayo"
2023,"Lille","Ligue 1","Jonas Martin","FRA","MF","32",1990,3.1,9,7,4,5,0,5,14,35.7,9,3,1,2,7,16,3,0,"https://fbref.com/en/players/468fdbad/Jonas-Martin"
2023,"Lille","Ligue 1","Amine Messoussa","FRA","FW","17",2004,0,0,0,0,0,0,0,0,NA,0,0,0,0,0,0,0,0,"https://fbref.com/en/players/f29131b5/Amine-Messoussa"
2023,"Lille","Ligue 1","Adam Ounas","ALG","FW,MF","25",1996,11.8,20,11,4,10,6,8,13,61.5,5,16,0,16,7,27,5,0,"https://fbref.com/en/players/ed90babd/Adam-Ounas"
2023,"Lille","Ligue 1","Simon Ramet","FRA","DF","19",2003,0,0,0,0,0,0,0,0,NA,0,0,0,0,0,0,0,0,"https://fbref.com/en/players/ed8cecc9/Simon-Ramet"
2023,"Lille","Ligue 1","Alexsandro Ribeiro","BRA","DF","22",1999,17.9,32,18,24,7,1,19,28,67.9,9,11,2,9,25,57,59,1,"https://fbref.com/en/players/102c9665/Alexsandro-Ribeiro"
2023,"Lille","Ligue 1","Alan Virginius","FRA","FW","19",2003,2.9,3,2,1,1,1,0,4,0,4,0,0,0,2,5,1,0,"https://fbref.com/en/players/01becd60/Alan-Virginius"
2023,"Lille","Ligue 1","Timothy Weah","USA","DF,FW","22",2000,19.4,24,14,13,9,2,16,29,55.2,13,17,3,14,23,47,18,0,"https://fbref.com/en/players/8eec784d/Timothy-Weah"
2023,"Lille","Ligue 1","Yusuf Yazıcı","TUR","MF","25",1997,2.2,0,0,0,0,0,0,0,NA,0,2,0,2,0,0,1,0,"https://fbref.com/en/players/f5c8b425/Yusuf-Yazici"
2023,"Lille","Ligue 1","Leny Yoro","FRA","DF","16",2005,8.5,11,5,8,3,0,4,9,44.4,5,6,1,5,18,29,27,1,"https://fbref.com/en/players/6763f716/Leny-Yoro"
2023,"Lille","Ligue 1","Akim Zedadka","ALG","DF,MF","27",1995,3.9,1,1,1,0,0,0,2,0,2,3,0,3,2,3,6,0,"https://fbref.com/en/players/0ff630d0/Akim-Zedadka"
2023,"Lille","Ligue 1","Edon Zhegrova","KVX","FW,MF","23",1999,11.7,18,12,6,7,5,12,20,60,8,9,0,9,2,20,2,0,"https://fbref.com/en/players/34a88e3e/Edon-Zhegrova"
2023,"Liverpool","Premier League","Thiago Alcántara","ESP","MF","31",1991,13.9,43,24,20,21,2,14,23,60.9,9,15,3,12,21,64,13,2,"https://fbref.com/en/players/77e84962/Thiago-Alcantara"
2023,"Liverpool","Premier League","Trent Alexander-Arnold","ENG","DF","23",1998,32.5,57,40,32,16,9,42,79,53.2,37,25,7,18,43,100,41,2,"https://fbref.com/en/players/cd1acf9d/Trent-Alexander-Arnold"
2023,"Liverpool","Premier League","Alisson","BRA","GK","29",1992,37,0,0,0,0,0,0,3,0,3,3,0,3,0,0,20,0,"https://fbref.com/en/players/7a2e46a8/Alisson"
2023,"Liverpool","Premier League","Stefan Bajcetic","ESP","MF","17",2004,5.8,9,6,5,3,1,8,27,29.6,19,7,0,7,9,18,4,0,"https://fbref.com/en/players/32e8417f/Stefan-Bajcetic"
2023,"Liverpool","Premier League","Fabio Carvalho","POR","MF,FW","19",2002,3.9,8,8,3,3,2,3,6,50,3,6,0,6,6,14,0,0,"https://fbref.com/en/players/966e28d0/Fabio-Carvalho"
2023,"Liverpool","Premier League","Bobby Clark","ENG","MF","17",2005,0.1,0,0,0,0,0,0,0,NA,0,2,0,2,0,0,0,0,"https://fbref.com/en/players/73341ace/Bobby-Clark"
2023,"Liverpool","Premier League","Luis Díaz","COL","FW","25",1997,11.1,17,11,4,8,5,8,15,53.3,7,8,0,8,6,23,2,0,"https://fbref.com/en/players/4a1a9578/Luis-Diaz"
2023,"Liverpool","Premier League","Ben Doak","SCO","FW","16",2005,0.3,3,2,1,2,0,1,1,100,0,1,0,1,0,3,0,0,"https://fbref.com/en/players/733f1a7d/Ben-Doak"
2023,"Liverpool","Premier League","Harvey Elliott","ENG","MF,FW","19",2003,17.9,27,18,6,12,9,9,36,25,27,26,1,25,15,42,8,0,"https://fbref.com/en/players/c8387671/Harvey-Elliott"
2023,"Liverpool","Premier League","Fabinho","BRA","MF","28",1993,29.7,65,38,18,40,7,24,62,38.7,38,38,11,27,37,102,40,0,"https://fbref.com/en/players/7f3b388c/Fabinho"
2023,"Liverpool","Premier League","Roberto Firmino","BRA","FW,MF","30",1991,13.5,17,12,2,12,3,4,21,19,17,16,1,15,7,24,2,0,"https://fbref.com/en/players/4c370d81/Roberto-Firmino"
2023,"Liverpool","Premier League","Cody Gakpo","NED","FW,MF","23",1999,16.2,26,15,4,13,9,13,38,34.2,25,13,1,12,4,30,2,0,"https://fbref.com/en/players/1971591f/Cody-Gakpo"
2023,"Liverpool","Premier League","Joe Gomez","ENG","DF","25",1997,16.3,28,21,15,11,2,11,19,57.9,8,17,11,6,24,52,51,2,"https://fbref.com/en/players/7a11550b/Joe-Gomez"
2023,"Liverpool","Premier League","Jordan Henderson","ENG","MF","32",1990,23,32,23,10,18,4,15,36,41.7,21,21,3,18,21,53,16,1,"https://fbref.com/en/players/935e6b8f/Jordan-Henderson"
2023,"Liverpool","Premier League","Curtis Jones","ENG","MF","21",2001,11.5,34,17,8,12,14,18,31,58.1,13,12,2,10,3,37,9,0,"https://fbref.com/en/players/4fb9c88f/Curtis-Jones"
2023,"Liverpool","Premier League","Diogo Jota","POR","FW","25",1996,12.6,23,15,8,8,7,12,37,32.4,25,5,0,5,3,26,11,0,"https://fbref.com/en/players/178ae8f8/Diogo-Jota"
2023,"Liverpool","Premier League","Naby Keïta","GUI","MF","27",1995,3.3,5,4,2,3,0,1,4,25,3,1,0,1,2,7,3,0,"https://fbref.com/en/players/f25c8e3a/Naby-Keita"
2023,"Liverpool","Premier League","Caoimhín Kelleher","IRL","GK","23",1998,1,0,0,0,0,0,0,0,NA,0,0,0,0,0,0,0,0,"https://fbref.com/en/players/62d7ef38/Caoimhin-Kelleher"
2023,"Liverpool","Premier League","Ibrahima Konaté","FRA","DF","23",1999,17.2,38,26,25,13,0,16,27,59.3,11,12,5,7,26,64,61,4,"https://fbref.com/en/players/5ed9b537/Ibrahima-Konate"
2023,"Liverpool","Premier League","Joël Matip","CMR","DF","30",1991,12.1,14,8,12,2,0,11,23,47.8,12,8,3,5,21,35,45,3,"https://fbref.com/en/players/b217ef29/Joel-Matip"
2023,"Liverpool","Premier League","James Milner","ENG","MF,DF","36",1986,10.1,26,16,11,11,4,15,34,44.1,19,14,2,12,12,38,15,0,"https://fbref.com/en/players/2f90f6b8/James-Milner"
2023,"Liverpool","Premier League","Darwin Núñez","URU","FW","23",1999,18.8,11,5,2,4,5,4,17,23.5,13,10,0,10,3,14,13,0,"https://fbref.com/en/players/4d77b365/Darwin-Nunez"
2023,"Liverpool","Premier League","Alex Oxlade-Chamberlain","ENG","FW,MF","28",1993,3.7,5,4,1,2,2,1,5,20,4,5,2,3,1,6,4,0,"https://fbref.com/en/players/38c7feef/Alex-Oxlade-Chamberlain"
2023,"Liverpool","Premier League","Nathaniel Phillips","ENG","DF","25",1997,0.7,2,1,0,2,0,2,2,100,0,0,0,0,2,4,1,0,"https://fbref.com/en/players/515ebe8d/Nathaniel-Phillips"
2023,"Liverpool","Premier League","Andrew Robertson","SCO","DF","28",1994,28.7,38,21,12,16,10,21,41,51.2,20,32,5,27,18,56,50,3,"https://fbref.com/en/players/2e4f5f03/Andrew-Robertson"
2023,"Liverpool","Premier League","Mohamed Salah","EGY","FW","30",1992,36.6,21,12,4,5,12,10,26,38.5,16,21,0,21,6,27,4,0,"https://fbref.com/en/players/e342ad68/Mohamed-Salah"
2023,"Liverpool","Premier League","Kostas Tsimikas","GRE","DF","26",1996,8.6,14,9,10,2,2,10,16,62.5,6,8,1,7,12,26,15,0,"https://fbref.com/en/players/f315ca93/Kostas-Tsimikas"
2023,"Liverpool","Premier League","Virgil van Dijk","NED","DF","31",1991,31.5,27,14,13,11,3,8,19,42.1,11,24,16,8,31,58,138,2,"https://fbref.com/en/players/e06683ca/Virgil-van-Dijk"
2023,"Lorient","Ligue 1","Laurent Abergel","FRA","MF","29",1993,26,92,52,59,30,3,39,92,42.4,53,47,8,39,34,126,39,0,"https://fbref.com/en/players/31626657/Laurent-Abergel"
2023,"Lorient","Ligue 1","Adil Aouchiche","FRA","MF","20",2002,2.8,5,2,3,1,1,1,9,11.1,8,1,0,1,4,9,1,0,"https://fbref.com/en/players/b94b8be1/Adil-Aouchiche"
2023,"Lorient","Ligue 1","Quentin Boisgard","FRA","MF","25",1997,2,6,2,1,4,1,3,4,75,1,3,1,2,4,10,2,0,"https://fbref.com/en/players/f6496133/Quentin-Boisgard"
2023,"Lorient","Ligue 1","Igor Carioca","BRA","DF","25",1996,5.1,18,11,12,2,4,12,21,57.1,9,7,0,7,5,23,17,0,"https://fbref.com/en/players/e3e32fbb/Igor-Carioca"
2023,"Lorient","Ligue 1","Yoann Cathline","FRA","FW,MF","20",2002,12.1,19,12,7,6,6,5,12,41.7,7,10,1,9,8,27,16,1,"https://fbref.com/en/players/4db5915d/Yoann-Cathline"
2023,"Lorient","Ligue 1","Stéphane Diarra","FRA","FW,MF","23",1998,11.8,25,17,14,9,2,11,29,37.9,18,13,1,12,22,47,9,0,"https://fbref.com/en/players/29939a1d/Stephane-Diarra"
2023,"Lorient","Ligue 1","Bamba Dieng","SEN","FW","22",2000,8.3,19,10,5,12,2,3,11,27.3,8,6,0,6,2,21,6,0,"https://fbref.com/en/players/40774c6b/Bamba-Dieng"
2023,"Lorient","Ligue 1","Ckene Doucouré","COM","FW,MF","20",2002,1.5,2,2,2,0,0,1,2,50,1,0,0,0,1,3,0,0,"https://fbref.com/en/players/92d90c8f/Ckene-Doucoure"
2023,"Lorient","Ligue 1","Romain Faivre","FRA","MF,FW","24",1998,13.8,13,8,5,4,4,5,25,20,20,11,0,11,1,14,4,0,"https://fbref.com/en/players/745ca0a3/Romain-Faivre"
2023,"Lorient","Ligue 1","Adrian Grbić","AUT","MF,FW","25",1996,0.3,0,0,0,0,0,0,1,0,1,3,0,3,0,0,0,0,"https://fbref.com/en/players/4a987ffa/Adrian-Grbic"
2023,"Lorient","Ligue 1","Bonke Innocent","NGA","MF","26",1996,13.1,28,17,13,14,1,11,36,30.6,25,22,5,17,26,54,31,0,"https://fbref.com/en/players/546bb36e/Bonke-Innocent"
2023,"Lorient","Ligue 1","Eli Junior Kroupi","FRA","FW,MF","16",2006,0.1,0,0,0,0,0,0,1,0,1,0,0,0,1,1,0,0,"https://fbref.com/en/players/b2fe86e5/Eli-Junior-Kroupi"
2023,"Lorient","Ligue 1","Gedeon Kalulu","COD","DF","24",1997,27.1,64,34,43,14,7,30,48,62.5,18,32,3,29,28,92,79,2,"https://fbref.com/en/players/dd211559/Gedeon-Kalulu"
2023,"Lorient","Ligue 1","Ayman Kari","FRA","MF,DF","17",2004,1.1,0,0,0,0,0,0,0,NA,0,4,0,4,3,3,0,0,"https://fbref.com/en/players/0e8d7b6c/Ayman-Kari"
2023,"Lorient","Ligue 1","Ibrahima Koné","MLI","FW","23",1999,17.5,24,13,3,13,8,5,11,45.5,6,13,0,13,4,28,18,0,"https://fbref.com/en/players/04bb2b06/Ibrahima-Kone"
2023,"Lorient","Ligue 1","Julien Laporte","FRA","DF","28",1993,18.4,22,16,18,3,1,16,22,72.7,6,33,27,6,18,40,108,2,"https://fbref.com/en/players/f066022d/Julien-Laporte"
2023,"Lorient","Ligue 1","Armand Lauriente","FRA","FW","23",1998,3,8,7,3,4,1,3,7,42.9,4,5,1,4,4,12,1,0,"https://fbref.com/en/players/2d22cea7/Armand-Lauriente"
2023,"Lorient","Ligue 1","Théo Le Bris","FRA","MF,DF","19",2002,16.1,31,19,17,11,3,15,33,45.5,18,21,2,19,18,49,31,0,"https://fbref.com/en/players/afe39ca8/Theo-Le-Bris"
2023,"Lorient","Ligue 1","Enzo Le Fée","FRA","MF","22",2000,33.6,108,64,52,40,16,43,113,38.1,70,50,5,45,34,142,38,1,"https://fbref.com/en/players/6f806d99/Enzo-Le-Fee"
2023,"Lorient","Ligue 1","Vincent Le Goff","FRA","DF","32",1989,37,75,32,56,16,3,45,62,72.6,17,29,9,20,41,116,105,1,"https://fbref.com/en/players/2321ea6e/Vincent-Le-Goff"
2023,"Lorient","Ligue 1","Jean-Victor Makengo","FRA","MF","24",1998,11.8,16,8,5,10,1,6,20,30,14,8,5,3,10,26,13,1,"https://fbref.com/en/players/22bfb57e/Jean-Victor-Makengo"
2023,"Lorient","Ligue 1","Vito Mannone","ITA","GK","34",1988,17.9,0,0,0,0,0,0,0,NA,0,0,0,0,0,0,4,3,"https://fbref.com/en/players/c4173f1a/Vito-Mannone"
2023,"Lorient","Ligue 1","Chrislain Matsima","FRA","DF,MF","20",2002,2.5,0,0,0,0,0,0,0,NA,0,3,3,0,2,2,7,0,"https://fbref.com/en/players/cf1ef7ec/Chrislain-Matsima"
2023,"Lorient","Ligue 1","Bamo Meïté","CIV","DF","21",2001,16.7,18,8,13,4,1,7,16,43.8,9,33,23,10,16,34,70,0,"https://fbref.com/en/players/04ac78d2/Bamo-Meite"
2023,"Lorient","Ligue 1","Terem Moffi","NGA","FW","23",1999,15.4,8,5,1,4,3,3,5,60,2,11,3,8,3,11,10,0,"https://fbref.com/en/players/065dc209/Terem-Moffi"
2023,"Lorient","Ligue 1","Yvon Mvogo","SUI","GK","28",1994,20.1,0,0,0,0,0,0,0,NA,0,0,0,0,2,2,6,3,"https://fbref.com/en/players/dc29b608/Yvon-Mvogo"
2023,"Lorient","Ligue 1","Dango Ouattara","BFA","FW,MF","20",2002,17.2,41,26,20,11,10,15,28,53.6,13,24,6,18,19,60,21,0,"https://fbref.com/en/players/2f9e4435/Dango-Ouattara"
2023,"Lorient","Ligue 1","Julien Ponceau","FRA","MF","21",2000,18.4,28,19,10,14,4,10,32,31.3,22,27,3,24,14,42,12,0,"https://fbref.com/en/players/e546b2e3/Julien-Ponceau"
2023,"Lorient","Ligue 1","Montassar Talbi","TUN","DF","24",1998,38,53,25,40,13,0,22,35,62.9,13,55,34,21,40,93,190,3,"https://fbref.com/en/players/a4a44eb0/Montassar-Talbi"
2023,"Lorient","Ligue 1","Darlin Yongwa","CMR","DF","21",2000,8.7,13,11,7,5,1,4,15,26.7,11,13,1,12,5,18,11,0,"https://fbref.com/en/players/061266cd/Darlin-Yongwa"
2023,"Lyon","Ligue 1","Houssem Aouar","ALG","MF","24",1998,5.8,12,5,5,5,2,3,9,33.3,6,12,2,10,8,20,3,0,"https://fbref.com/en/players/a5db0bec/Houssem-Aouar"
2023,"Lyon","Ligue 1","Mohamed El Arouch","FRA","MF","18",2004,0,1,1,1,0,0,0,0,NA,0,0,0,0,0,1,0,0,"https://fbref.com/en/players/508a9011/Mohamed-El-Arouch"
2023,"Lyon","Ligue 1","Bradley Barcola","FRA","FW,MF","19",2002,16,25,16,8,10,7,8,39,20.5,31,29,0,29,19,44,10,0,"https://fbref.com/en/players/a0d55a09/Bradley-Barcola"
2023,"Lyon","Ligue 1","Jérôme Boateng","GER","DF","33",1988,4.8,3,0,2,1,0,2,6,33.3,4,8,5,3,6,9,16,0,"https://fbref.com/en/players/2db2fd7b/Jerome-Boateng"
2023,"Lyon","Ligue 1","Maxence Caqueret","FRA","MF","22",2000,30.7,87,54,27,38,22,43,109,39.4,66,45,3,42,39,126,27,0,"https://fbref.com/en/players/f81ef10d/Maxence-Caqueret"
2023,"Lyon","Ligue 1","Rayan Cherki","FRA","MF,FW","18",2003,20.8,14,8,2,5,7,8,23,34.8,15,6,0,6,5,19,1,0,"https://fbref.com/en/players/b34c63a5/Rayan-Cherki"
2023,"Lyon","Ligue 1","Damien Da Silva","FRA","DF","34",1988,3.8,8,7,5,3,0,3,3,100,0,4,3,1,5,13,12,0,"https://fbref.com/en/players/1ec7e1c5/Damien-Da-Silva"
2023,"Lyon","Ligue 1","Moussa Dembélé","FRA","FW,MF","26",1996,9.7,8,4,3,3,2,4,7,57.1,3,5,0,5,2,10,6,0,"https://fbref.com/en/players/e7986081/Moussa-Dembele"
2023,"Lyon","Ligue 1","Sinaly Diomande","CIV","DF","21",2001,21.7,42,24,26,15,1,31,49,63.3,18,26,13,13,49,91,75,1,"https://fbref.com/en/players/6de23ab0/Sinaly-Diomande"
2023,"Lyon","Ligue 1","Romain Faivre","FRA","MF","24",1998,3.3,6,3,2,2,2,1,3,33.3,2,3,0,3,0,6,0,0,"https://fbref.com/en/players/745ca0a3/Romain-Faivre"
2023,"Lyon","Ligue 1","Malo Gusto","FRA","DF","19",2003,17.7,42,26,23,11,8,21,43,48.8,22,22,5,17,28,70,23,1,"https://fbref.com/en/players/d56b9520/Malo-Gusto"
2023,"Lyon","Ligue 1","Henrique","BRA","DF,FW","28",1994,4,9,4,3,2,4,6,13,46.2,7,3,1,2,5,14,8,0,"https://fbref.com/en/players/f28474a4/Henrique"
2023,"Lyon","Ligue 1","Jefferson","BRA","FW","22",1999,5,17,4,4,9,4,6,15,40,9,6,0,6,1,18,0,0,"https://fbref.com/en/players/45cce300/Jefferson"
2023,"Lyon","Ligue 1","Sael Kumbedi","FRA","DF","17",2005,14.7,47,27,27,13,7,20,38,52.6,18,23,7,16,10,57,16,0,"https://fbref.com/en/players/c385bf49/Sael-Kumbedi"
2023,"Lyon","Ligue 1","Alexandre Lacazette","FRA","FW","31",1991,32.5,43,23,7,17,19,10,29,34.5,19,23,3,20,15,58,4,0,"https://fbref.com/en/players/9dbb75ca/Alexandre-Lacazette"
2023,"Lyon","Ligue 1","Johann Lepenant","FRA","MF","19",2002,21.5,58,34,24,27,7,32,86,37.2,54,29,5,24,28,86,17,3,"https://fbref.com/en/players/1e52971c/Johann-Lepenant"
2023,"Lyon","Ligue 1","Anthony Lopes","POR","GK","31",1990,31.3,1,0,1,0,0,1,4,25,3,0,0,0,3,4,10,0,"https://fbref.com/en/players/f00de885/Anthony-Lopes"
2023,"Lyon","Ligue 1","Dejan Lovren","CRO","DF","33",1989,16.2,25,19,20,5,0,20,29,69,9,20,10,10,26,51,70,1,"https://fbref.com/en/players/1a2935f6/Dejan-Lovren"
2023,"Lyon","Ligue 1","Castello Lukeba","FRA","DF","19",2002,33.2,39,23,27,8,4,21,31,67.7,10,42,24,18,75,114,105,1,"https://fbref.com/en/players/5b9512c5/Castello-Lukeba"
2023,"Lyon","Ligue 1","Thiago Mendes","BRA","MF,DF","30",1992,22.9,48,27,24,21,3,30,40,75,10,28,8,20,47,95,51,4,"https://fbref.com/en/players/c6e5d20f/Thiago-Mendes"
2023,"Lyon","Ligue 1","Lucas Paquetá","BRA","MF","24",1997,1.8,5,4,0,5,0,1,3,33.3,2,2,0,2,1,6,3,0,"https://fbref.com/en/players/9b6f7fd5/Lucas-Paqueta"
2023,"Lyon","Ligue 1","Jeff Reine-Adélaïde","FRA","MF","24",1998,3.7,8,5,1,5,2,5,9,55.6,4,4,0,4,6,14,0,0,"https://fbref.com/en/players/d504b3e1/Jeff-Reine-Adelaide"
2023,"Lyon","Ligue 1","Rémy Riou","FRA","GK","34",1987,6.7,1,0,1,0,0,1,1,100,0,0,0,0,0,1,3,0,"https://fbref.com/en/players/7f41ee30/Remy-Riou"
2023,"Lyon","Ligue 1","Amin Sarr","SWE","FW","21",2001,6,9,6,1,4,4,1,4,25,3,2,0,2,0,9,4,0,"https://fbref.com/en/players/d5326924/Amin-Sarr"
2023,"Lyon","Ligue 1","Mamadou Sarr","FRA","MF","16",2005,0.1,0,0,0,0,0,0,0,NA,0,0,0,0,0,0,0,0,"https://fbref.com/en/players/61f80c89/Mamadou-Sarr"
2023,"Lyon","Ligue 1","Nicolás Tagliafico","ARG","DF","29",1992,33.2,91,53,36,41,14,50,78,64.1,28,45,11,34,57,148,47,0,"https://fbref.com/en/players/f0661424/Nicolas-Tagliafico"
2023,"Lyon","Ligue 1","Tetê","BRA","FW,MF","22",2000,12.3,21,10,8,5,8,10,19,52.6,9,9,0,9,13,34,2,0,"https://fbref.com/en/players/7120a04d/Tete"
2023,"Lyon","Ligue 1","Karl Toko Ekambi","CMR","FW,MF","29",1992,15,9,9,2,4,3,4,15,26.7,11,12,2,10,9,18,6,0,"https://fbref.com/en/players/5ceba7fc/Karl-Toko-Ekambi"
2023,"Lyon","Ligue 1","Corentin Tolisso","FRA","MF","27",1994,22.6,44,27,16,23,5,25,66,37.9,41,25,5,20,24,68,23,1,"https://fbref.com/en/players/652d4c37/Corentin-Tolisso"
2023,"M'Gladbach","Bundesliga","Ramy Bensebaini","ALG","DF","27",1995,27.6,34,21,21,10,3,26,39,66.7,13,44,14,30,36,70,98,1,"https://fbref.com/en/players/378825c7/Ramy-Bensebaini"
2023,"M'Gladbach","Bundesliga","Yvandro Borges Sanches","LUX","FW,MF","18",2004,0.3,2,2,0,2,0,2,2,100,0,0,0,0,0,2,0,0,"https://fbref.com/en/players/36578017/Yvandro-Borges-Sanches"
2023,"M'Gladbach","Bundesliga","Nico Elvedi","SUI","DF","25",1996,31.4,46,24,32,12,2,27,41,65.9,14,31,16,15,35,81,149,3,"https://fbref.com/en/players/48035304/Nico-Elvedi"
2023,"M'Gladbach","Bundesliga","Oscar Fraulo","DEN","FW,MF","18",2003,0.1,0,0,0,0,0,0,0,NA,0,0,0,0,0,0,0,0,"https://fbref.com/en/players/458e3479/Oscar-Fraulo"
2023,"M'Gladbach","Bundesliga","Marvin Friedrich","GER","DF","26",1995,13.9,17,11,13,3,1,10,13,76.9,3,14,6,8,11,28,52,0,"https://fbref.com/en/players/b77f44a4/Marvin-Friedrich"
2023,"M'Gladbach","Bundesliga","Patrick Herrmann","GER","FW,MF","31",1991,1.8,6,2,4,1,1,2,4,50,2,2,0,2,2,8,1,0,"https://fbref.com/en/players/dfb6490a/Patrick-Herrmann"
2023,"M'Gladbach","Bundesliga","Jonas Hofmann","GER","FW,MF","30",1992,29.8,31,16,17,8,6,15,52,28.8,37,36,2,34,16,47,21,0,"https://fbref.com/en/players/2903a856/Jonas-Hofmann"
2023,"M'Gladbach","Bundesliga","Ko Itakura","JPN","DF","25",1997,22,29,17,18,7,4,16,30,53.3,14,41,25,16,27,56,95,0,"https://fbref.com/en/players/97d545ae/Ko-Itakura"
2023,"M'Gladbach","Bundesliga","Jan Jakob Olschowsky","GER","GK","20",2001,4,0,0,0,0,0,0,1,0,1,1,0,1,0,0,1,0,"https://fbref.com/en/players/fa4cabd1/Jan-Jakob-Olschowsky"
2023,"M'Gladbach","Bundesliga","Tony Jantschke","GER","DF,MF","32",1990,1.1,2,1,1,1,0,1,1,100,0,5,3,2,0,2,5,0,"https://fbref.com/en/players/34b54da7/Tony-Jantschke"
2023,"M'Gladbach","Bundesliga","Kouadio Koné","FRA","MF","21",2001,29,74,39,37,33,4,24,47,51.1,23,44,12,32,32,106,21,0,"https://fbref.com/en/players/86574238/Kouadio-Kone"
2023,"M'Gladbach","Bundesliga","Christoph Kramer","GER","MF","31",1991,24.7,44,33,24,15,5,22,55,40,33,34,2,32,17,61,40,0,"https://fbref.com/en/players/496aeede/Christoph-Kramer"
2023,"M'Gladbach","Bundesliga","Stefan Lainer","AUT","DF","29",1992,9.1,16,8,10,5,1,10,23,43.5,13,8,1,7,14,30,34,1,"https://fbref.com/en/players/4aea5077/Stefan-Lainer"
2023,"M'Gladbach","Bundesliga","Nathan N'Goumou","FRA","FW","22",2000,7.7,11,5,5,5,1,7,13,53.8,6,9,0,9,1,12,4,0,"https://fbref.com/en/players/e110ea4b/Nathan-NGoumou"
2023,"M'Gladbach","Bundesliga","Luca Netz","GER","DF","19",2003,7.8,25,13,19,3,3,19,32,59.4,13,5,1,4,6,31,27,0,"https://fbref.com/en/players/e79269bd/Luca-Netz"
2023,"M'Gladbach","Bundesliga","Florian Neuhaus","GER","MF","25",1997,15.6,19,9,9,5,5,8,27,29.6,19,20,3,17,12,31,5,0,"https://fbref.com/en/players/36a59ba4/Florian-Neuhaus"
2023,"M'Gladbach","Bundesliga","Jonas Omlin","SUI","GK","28",1994,14.3,1,1,1,0,0,1,3,33.3,2,1,0,1,0,1,9,1,"https://fbref.com/en/players/c631f952/Jonas-Omlin"
2023,"M'Gladbach","Bundesliga","Alassane Pléa","FRA","FW","29",1993,19.7,16,8,5,7,4,8,26,30.8,18,23,3,20,12,28,14,0,"https://fbref.com/en/players/bc6bd723/Alassane-Plea"
2023,"M'Gladbach","Bundesliga","Rocco Reitz","GER","MF","20",2002,0,0,0,0,0,0,0,0,NA,0,0,0,0,0,0,0,0,"https://fbref.com/en/players/cc971106/Rocco-Reitz"
2023,"M'Gladbach","Bundesliga","Joe Scally","USA","DF","19",2002,24.5,31,20,25,5,1,24,31,77.4,7,17,6,11,8,39,61,0,"https://fbref.com/en/players/236f02cd/Joe-Scally"
2023,"M'Gladbach","Bundesliga","Tobias Sippel","GER","GK","34",1988,5.7,0,0,0,0,0,0,0,NA,0,0,0,0,0,0,1,1,"https://fbref.com/en/players/0d8a37c2/Tobias-Sippel"
2023,"M'Gladbach","Bundesliga","Yann Sommer","SUI","GK","33",1988,10,1,0,1,0,0,1,1,100,0,0,0,0,0,1,8,0,"https://fbref.com/en/players/420c18a1/Yann-Sommer"
2023,"M'Gladbach","Bundesliga","Lars Stindl","GER","FW,MF","33",1988,19.3,24,14,4,17,3,10,28,35.7,18,24,5,19,11,35,19,0,"https://fbref.com/en/players/7cd6badb/Lars-Stindl"
2023,"M'Gladbach","Bundesliga","Semir Telalovic","GER","MF,FW","22",1999,0.1,0,0,0,0,0,0,0,NA,0,0,0,0,0,0,0,0,"https://fbref.com/en/players/0b45a8d7/Semir-Telalovic"
2023,"M'Gladbach","Bundesliga","Marcus Thuram","FRA","FW","24",1997,27.9,14,7,3,6,5,6,13,46.2,7,20,3,17,6,20,22,0,"https://fbref.com/en/players/6f8cd6d0/Marcus-Thuram"
2023,"M'Gladbach","Bundesliga","Julian Weigl","GER","MF","26",1995,21,43,16,21,21,1,23,41,56.1,18,23,2,21,18,61,32,0,"https://fbref.com/en/players/346d51d9/Julian-Weigl"
2023,"M'Gladbach","Bundesliga","Hannes Wolf","AUT","FW","23",1999,5,11,8,4,5,2,5,13,38.5,8,3,0,3,3,14,9,0,"https://fbref.com/en/players/be42a291/Hannes-Wolf"
2023,"Mainz 05","Bundesliga","Ludovic Ajorque","FRA","FW,MF","28",1994,13.5,6,5,1,4,1,1,9,11.1,8,8,2,6,1,7,8,0,"https://fbref.com/en/players/462475ed/Ludovic-Ajorque"
2023,"Mainz 05","Bundesliga","Aymen Barkok","MAR","MF","24",1998,6.5,18,8,10,5,3,5,10,50,5,7,0,7,3,21,9,0,"https://fbref.com/en/players/a2a85828/Aymen-Barkok"
2023,"Mainz 05","Bundesliga","Leandro Barreiro Martins","LUX","MF","22",2000,23.8,60,38,19,28,13,22,49,44.9,27,38,13,25,41,101,39,1,"https://fbref.com/en/players/00242b75/Leandro-Barreiro-Martins"
2023,"Mainz 05","Bundesliga","Stefan Bell","GER","DF","30",1991,26.6,43,28,32,10,1,22,44,50,22,42,15,27,44,87,133,0,"https://fbref.com/en/players/857a5abe/Stefan-Bell"
2023,"Mainz 05","Bundesliga","Delano Burgzorg","NED","FW,MF","23",1998,2.7,3,3,1,1,1,2,3,66.7,1,2,0,2,0,3,2,0,"https://fbref.com/en/players/05e2d5ea/Delano-Burgzorg"
2023,"Mainz 05","Bundesliga","Jonathan Burkardt","GER","MF,FW","22",2000,5.9,3,1,0,1,2,1,4,25,3,6,1,5,1,4,1,0,"https://fbref.com/en/players/05f99a4a/Jonathan-Burkardt"
2023,"Mainz 05","Bundesliga","Anthony Caci","FRA","DF","25",1997,22.6,58,33,32,20,6,28,42,66.7,14,28,4,24,54,112,40,0,"https://fbref.com/en/players/0118c54c/Anthony-Caci"
2023,"Mainz 05","Bundesliga","Danny da Costa","GER","DF","29",1993,13.7,20,16,7,8,5,12,20,60,8,22,3,19,9,29,26,0,"https://fbref.com/en/players/5ddb8f9f/Danny-da-Costa"
2023,"Mainz 05","Bundesliga","Finn Dahmen","GER","GK","24",1998,8,0,0,0,0,0,0,0,NA,0,0,0,0,0,0,3,0,"https://fbref.com/en/players/dee3013b/Finn-Dahmen"
2023,"Mainz 05","Bundesliga","Edimilson Fernandes","SUI","DF","26",1996,27.1,35,25,26,5,4,18,34,52.9,16,37,16,21,54,89,87,2,"https://fbref.com/en/players/3bb625ac/Edimilson-Fernandes"
2023,"Mainz 05","Bundesliga","Angelo Fulgini","FRA","MF","25",1996,5.8,6,5,2,3,1,5,12,41.7,7,5,0,5,5,11,7,0,"https://fbref.com/en/players/4b96c347/Angelo-Fulgini"
2023,"Mainz 05","Bundesliga","Brajan Gruda","GER","MF","18",2004,0,0,0,0,0,0,0,0,NA,0,0,0,0,0,0,0,0,"https://fbref.com/en/players/ae9b998d/Brajan-Gruda"
2023,"Mainz 05","Bundesliga","Alexander Hack","GER","DF","28",1993,12.6,30,18,21,9,0,19,33,57.6,14,18,5,13,24,54,45,1,"https://fbref.com/en/players/a5ec3ede/Alexander-Hack"
2023,"Mainz 05","Bundesliga","Andreas Hanche-Olsen","NOR","DF","25",1997,16.6,35,23,24,7,4,22,39,56.4,17,16,8,8,33,68,77,2,"https://fbref.com/en/players/2e77d607/Andreas-Hanche-Olsen"
2023,"Mainz 05","Bundesliga","Marcus Ingvartsen","DEN","FW,MF","26",1996,14.6,4,1,0,2,2,1,10,10,9,9,1,8,4,8,10,0,"https://fbref.com/en/players/271b8617/Marcus-Ingvartsen"
2023,"Mainz 05","Bundesliga","Lee Jae-sung","KOR","MF","29",1992,21,38,17,9,21,8,16,36,44.4,20,29,5,24,17,55,21,0,"https://fbref.com/en/players/34b0387f/Lee-Jae-sung"
2023,"Mainz 05","Bundesliga","Dominik Kohr","GER","MF","28",1994,25.5,59,33,23,31,5,29,61,47.5,32,46,9,37,34,93,26,1,"https://fbref.com/en/players/0fbecd11/Dominik-Kohr"
2023,"Mainz 05","Bundesliga","Maxim Leitsch","GER","DF","24",1998,7.4,9,7,6,3,0,4,5,80,1,7,4,3,18,27,26,1,"https://fbref.com/en/players/7e12a98d/Maxim-Leitsch"
2023,"Mainz 05","Bundesliga","Aarón Martín","ESP","DF","25",1997,20.5,42,27,25,11,6,21,40,52.5,19,22,1,21,15,57,31,0,"https://fbref.com/en/players/2f3e911a/Aaron-Martin"
2023,"Mainz 05","Bundesliga","Marlon Mustapha","AUT","FW,MF","21",2001,0.8,2,2,0,2,0,0,0,NA,0,4,0,4,0,2,0,0,"https://fbref.com/en/players/9ff8ec4a/Marlon-Mustapha"
2023,"Mainz 05","Bundesliga","Karim Onisiwo","AUT","FW,MF","30",1992,28.2,19,12,3,10,6,4,21,19,17,19,0,19,2,21,7,0,"https://fbref.com/en/players/f26834c7/Karim-Onisiwo"
2023,"Mainz 05","Bundesliga","Eniss Shabani","GER","MF","19",2003,0.1,0,0,0,0,0,0,0,NA,0,0,0,0,0,0,0,0,"https://fbref.com/en/players/0c88efca/Eniss-Shabani"
2023,"Mainz 05","Bundesliga","Anton Stach","GER","MF","23",1998,23,27,21,10,15,2,16,38,42.1,22,28,2,26,41,68,25,0,"https://fbref.com/en/players/0f59a7bf/Anton-Stach"
2023,"Mainz 05","Bundesliga","Niklas Tauer","GER","DF,MF","21",2001,1,2,1,2,0,0,1,3,33.3,2,2,1,1,2,4,4,0,"https://fbref.com/en/players/27270af4/Niklas-Tauer"
2023,"Mainz 05","Bundesliga","Nelson Weiper","GER","FW,DF","17",2005,1.1,2,0,0,0,2,1,3,33.3,2,2,0,2,0,2,1,0,"https://fbref.com/en/players/231c67ff/Nelson-Weiper"
2023,"Mainz 05","Bundesliga","Silvan Widmer","SUI","DF","29",1993,18.8,26,17,15,10,1,20,39,51.3,19,22,8,14,31,57,28,0,"https://fbref.com/en/players/f68b64fc/Silvan-Widmer"
2023,"Mainz 05","Bundesliga","Robin Zentner","GER","GK","27",1994,26,0,0,0,0,0,0,4,0,4,0,0,0,0,0,17,1,"https://fbref.com/en/players/5c4bf6ba/Robin-Zentner"
2023,"Mallorca","La Liga","Amath","SEN","MF,FW","26",1996,13.6,29,19,14,8,7,14,22,63.6,8,13,1,12,5,34,5,0,"https://fbref.com/en/players/f3b1d9a2/Amath"
2023,"Mallorca","La Liga","Josep Antoni Gayá","ESP","DF,MF","22",2000,1.1,0,0,0,0,0,0,0,NA,0,4,2,2,1,1,6,0,"https://fbref.com/en/players/4a5f2032/Josep-Antoni-Gaya"
2023,"Mallorca","La Liga","Ludwig Augustinsson","SWE","DF","28",1994,1.5,2,1,2,0,0,1,3,33.3,2,1,0,1,1,3,3,0,"https://fbref.com/en/players/9fec8860/Ludwig-Augustinsson"
2023,"Mallorca","La Liga","Iddrisu Baba","GHA","MF,DF","26",1996,18.9,31,17,15,16,0,15,32,46.9,17,18,8,10,11,42,39,0,"https://fbref.com/en/players/bfd381b3/Iddrisu-Baba"
2023,"Mallorca","La Liga","Rodrigo Battaglia","ARG","MF","31",1991,7.6,12,5,7,5,0,6,14,42.9,8,16,7,9,5,17,18,0,"https://fbref.com/en/players/d637fc22/Rodrigo-Battaglia"
2023,"Mallorca","La Liga","Copete","ESP","DF","22",1999,24.5,53,28,35,16,2,26,36,72.2,10,38,17,21,44,97,111,2,"https://fbref.com/en/players/0f26ffd7/Copete"
2023,"Mallorca","La Liga","Jaume Costa","ESP","DF","34",1988,28.9,50,34,26,17,7,29,51,56.9,22,13,5,8,22,72,44,1,"https://fbref.com/en/players/808d48f3/Jaume-Costa"
2023,"Mallorca","La Liga","Braian Cufré","ARG","DF","25",1996,2.4,5,2,2,1,2,2,5,40,3,2,1,1,2,7,1,0,"https://fbref.com/en/players/192c89a6/Braian-Cufre"
2023,"Mallorca","La Liga","Iñigo Ruiz de Galarreta","ESP","MF","28",1993,27.2,54,38,27,23,4,20,52,38.5,32,26,9,17,30,84,19,0,"https://fbref.com/en/players/91f7631f/Inigo-Ruiz-de-Galarreta"
2023,"Mallorca","La Liga","Giovanni González","URU","DF","27",1994,10.3,16,8,11,2,3,9,22,40.9,13,8,2,6,7,23,22,0,"https://fbref.com/en/players/1fc474ae/Giovanni-Gonzalez"
2023,"Mallorca","La Liga","Dominik Greif","SVK","GK","25",1997,1,0,0,0,0,0,0,0,NA,0,0,0,0,0,0,0,0,"https://fbref.com/en/players/30061f53/Dominik-Greif"
2023,"Mallorca","La Liga","Clément Grenier","FRA","MF","31",1991,8,20,8,6,12,2,10,20,50,10,9,1,8,6,26,7,0,"https://fbref.com/en/players/8b298f56/Clement-Grenier"
2023,"Mallorca","La Liga","Dennis Hadzikadunic","BIH","DF","24",1998,6.8,9,6,4,5,0,4,4,100,0,5,4,1,3,12,27,0,"https://fbref.com/en/players/82cfae2a/Dennis-Hadzikadunic"
2023,"Mallorca","La Liga","Lago Junior","CIV","FW,MF","31",1990,0.6,1,0,0,1,0,1,1,100,0,0,0,0,0,1,0,0,"https://fbref.com/en/players/360d70f8/Lago-Junior"
2023,"Mallorca","La Liga","Tino Kadewere","ZIM","FW,MF","26",1996,6,6,3,3,3,0,4,9,44.4,5,6,2,4,2,8,1,0,"https://fbref.com/en/players/7d08063d/Tino-Kadewere"
2023,"Mallorca","La Liga","Lee Kangin","KOR","MF,FW","21",2001,31.4,42,24,10,22,10,18,61,29.5,43,25,2,23,11,53,7,0,"https://fbref.com/en/players/8455ad90/Lee-Kangin"
2023,"Mallorca","La Liga","Javier Llabrés","ESP","FW","19",2002,0.2,0,0,0,0,0,0,0,NA,0,0,0,0,0,0,1,0,"https://fbref.com/en/players/38b0cf42/Javier-Llabres"
2023,"Mallorca","La Liga","Pablo Maffeo","ESP","DF","25",1997,33.1,75,46,54,16,5,45,78,57.7,33,38,11,27,26,101,76,0,"https://fbref.com/en/players/5db04597/Pablo-Maffeo"
2023,"Mallorca","La Liga","Manu Morlanes","ESP","MF","23",1999,7.8,22,9,12,8,2,13,24,54.2,11,10,5,5,5,27,9,0,"https://fbref.com/en/players/a0255c67/Manu-Morlanes"
2023,"Mallorca","La Liga","Vedat Muriqi","KVX","FW","28",1994,32.6,12,7,4,7,1,3,13,23.1,10,19,7,12,12,24,73,0,"https://fbref.com/en/players/0cadc46d/Vedat-Muriqi"
2023,"Mallorca","La Liga","Matija Nastasić","SRB","DF","29",1993,10.1,10,8,7,1,2,3,6,50,3,11,4,7,18,28,43,1,"https://fbref.com/en/players/f35430a4/Matija-Nastasic"
2023,"Mallorca","La Liga","Abdón Prats","ESP","FW,MF","29",1992,4.6,1,0,1,0,0,0,0,NA,0,5,0,5,0,1,2,0,"https://fbref.com/en/players/d1b060e2/Abdon-Prats"
2023,"Mallorca","La Liga","Rubén Quintanilla","ESP","DF","20",2002,0,0,0,0,0,0,0,0,NA,0,1,0,1,0,0,0,0,"https://fbref.com/en/players/2f456b86/Ruben-Quintanilla"
2023,"Mallorca","La Liga","Antonio Raillo","ESP","DF","30",1991,30.7,34,21,23,11,0,10,15,66.7,5,38,29,9,31,65,158,1,"https://fbref.com/en/players/b857bd29/Antonio-Raillo"
2023,"Mallorca","La Liga","Predrag Rajković","SRB","GK","26",1995,36,0,0,0,0,0,0,2,0,2,0,0,0,0,0,16,1,"https://fbref.com/en/players/58ad9383/Predrag-Rajkovic"
2023,"Mallorca","La Liga","Ángel Rodríguez","ESP","FW,MF","35",1987,4.4,1,1,0,1,0,0,2,0,2,3,0,3,1,2,1,0,"https://fbref.com/en/players/8cfc2f69/Angel-Rodriguez"
2023,"Mallorca","La Liga","Dani Rodríguez","ESP","MF","34",1988,23.3,42,23,18,22,2,21,46,45.7,25,31,8,23,21,63,14,0,"https://fbref.com/en/players/70f8e0bd/Dani-Rodriguez"
2023,"Mallorca","La Liga","Leonardo Román","ESP","GK","22",2000,1,0,0,0,0,0,0,0,NA,0,0,0,0,0,0,0,0,"https://fbref.com/en/players/924ff27e/Leonardo-Roman"
2023,"Mallorca","La Liga","Franco Russo","ARG","DF","27",1994,1.6,2,1,2,0,0,0,1,0,1,5,0,5,3,5,5,0,"https://fbref.com/en/players/b75ac54b/Franco-Russo"
2023,"Mallorca","La Liga","Antonio Sánchez","ESP","MF,DF","25",1997,12,19,8,13,4,2,10,34,29.4,24,18,0,18,22,41,14,1,"https://fbref.com/en/players/a254bbe0/Antonio-Sanchez"
2023,"Mallorca","La Liga","Martin Valjent","SVK","DF","26",1995,29.5,35,27,22,12,1,19,28,67.9,9,39,21,18,29,64,137,0,"https://fbref.com/en/players/f2c6ac01/Martin-Valjent"
2023,"Manchester City","Premier League","Manuel Akanji","SUI","DF","27",1995,25.4,36,25,15,18,3,23,36,63.9,13,27,9,18,16,52,33,0,"https://fbref.com/en/players/89ac64a6/Manuel-Akanji"
2023,"Manchester City","Premier League","Nathan Aké","NED","DF","27",1995,20.8,26,12,15,9,2,11,15,73.3,4,20,10,10,20,46,48,0,"https://fbref.com/en/players/eaeca114/Nathan-Ake"
2023,"Manchester City","Premier League","Julián Álvarez","ARG","FW,MF","22",2000,16.3,26,16,3,13,10,9,29,31,20,13,0,13,2,28,6,0,"https://fbref.com/en/players/15ab5a2b/Julian-Alvarez"
2023,"Manchester City","Premier League","João Cancelo","POR","DF","28",1994,14.2,29,21,16,9,4,17,24,70.8,7,7,1,6,19,48,9,1,"https://fbref.com/en/players/bd6351cd/Joao-Cancelo"
2023,"Manchester City","Premier League","Shea Charles","NIR","DF","18",2003,0.3,4,0,4,0,0,1,1,100,0,0,0,0,1,5,2,0,"https://fbref.com/en/players/5cc3ce65/Shea-Charles"
2023,"Manchester City","Premier League","Kevin De Bruyne","BEL","MF","31",1991,26.9,28,12,3,12,13,14,39,35.9,25,27,2,25,9,37,10,0,"https://fbref.com/en/players/e46012d4/Kevin-De-Bruyne"
2023,"Manchester City","Premier League","Rúben Dias","POR","DF","25",1997,22.2,21,13,10,10,1,11,18,61.1,7,21,13,8,18,39,56,1,"https://fbref.com/en/players/31c69ef1/Ruben-Dias"
2023,"Manchester City","Premier League","Ederson","BRA","GK","28",1993,35,3,1,3,0,0,1,2,50,1,0,0,0,1,4,10,2,"https://fbref.com/en/players/3bb7b8b4/Ederson"
2023,"Manchester City","Premier League","Phil Foden","ENG","FW","22",2000,20.5,16,10,9,5,2,8,19,42.1,11,25,2,23,5,21,12,0,"https://fbref.com/en/players/ed1e53f3/Phil-Foden"
2023,"Manchester City","Premier League","Sergio Gómez","ESP","DF,MF","21",2000,3.9,9,4,6,1,2,5,8,62.5,3,5,3,2,2,11,9,1,"https://fbref.com/en/players/01e5f06e/Sergio-Gomez"
2023,"Manchester City","Premier League","Jack Grealish","ENG","FW","26",1995,22.8,25,16,10,12,3,13,22,59.1,9,17,3,14,7,32,9,0,"https://fbref.com/en/players/b0b4fd3e/Jack-Grealish"
2023,"Manchester City","Premier League","İlkay Gündoğan","GER","MF","31",1990,26.1,30,18,7,13,10,12,33,36.4,21,18,3,15,20,50,13,0,"https://fbref.com/en/players/819b3158/Ilkay-Gundogan"
2023,"Manchester City","Premier League","Erling Haaland","NOR","FW","22",2000,30.8,3,2,0,2,1,1,5,20,4,12,4,8,3,6,14,0,"https://fbref.com/en/players/1f44ac21/Erling-Haaland"
2023,"Manchester City","Premier League","Aymeric Laporte","ESP","DF","28",1994,11,11,8,6,4,1,7,11,63.6,4,10,4,6,3,14,30,1,"https://fbref.com/en/players/119b9a8e/Aymeric-Laporte"
2023,"Manchester City","Premier League","Rico Lewis","ENG","DF,MF","17",2004,10,16,9,9,5,2,6,11,54.5,5,8,4,4,6,22,13,1,"https://fbref.com/en/players/b57e066e/Rico-Lewis"
2023,"Manchester City","Premier League","Riyad Mahrez","ALG","FW,MF","31",1991,21.3,30,14,8,13,9,13,38,34.2,25,27,1,26,9,39,5,0,"https://fbref.com/en/players/892d5bb1/Riyad-Mahrez"
2023,"Manchester City","Premier League","Stefan Ortega","GER","GK","29",1992,3,0,0,0,0,0,0,0,NA,0,0,0,0,0,0,0,0,"https://fbref.com/en/players/c1242d4e/Stefan-Ortega"
2023,"Manchester City","Premier League","Cole Palmer","ENG","MF,FW","20",2002,4.1,5,1,0,3,2,3,5,60,2,2,1,1,1,6,2,0,"https://fbref.com/en/players/dc7f8a28/Cole-Palmer"
2023,"Manchester City","Premier League","Máximo Perrone","ARG","MF","19",2003,0.2,0,0,0,0,0,0,0,NA,0,1,0,1,0,0,0,0,"https://fbref.com/en/players/53552942/Maximo-Perrone"
2023,"Manchester City","Premier League","Kalvin Phillips","ENG","MF","26",1995,3.3,6,4,3,3,0,2,9,22.2,7,7,3,4,5,11,10,0,"https://fbref.com/en/players/4f565d77/Kalvin-Phillips"
2023,"Manchester City","Premier League","Rodri","ESP","MF","26",1996,32.3,67,41,28,28,11,26,52,50,26,40,14,26,33,100,43,1,"https://fbref.com/en/players/6434f10d/Rodri"
2023,"Manchester City","Premier League","Bernardo Silva","POR","MF,FW","27",1994,24.5,44,23,11,25,8,18,44,40.9,26,23,6,17,16,60,6,0,"https://fbref.com/en/players/3eb22ec9/Bernardo-Silva"
2023,"Manchester City","Premier League","John Stones","ENG","DF,MF","28",1994,20.5,23,13,11,8,4,7,10,70,3,17,10,7,9,32,40,0,"https://fbref.com/en/players/5eecec3d/John-Stones"
2023,"Manchester City","Premier League","Kyle Walker","ENG","DF","32",1990,21.8,13,9,8,5,0,4,24,16.7,20,12,2,10,18,31,22,0,"https://fbref.com/en/players/86dd77d1/Kyle-Walker"
2023,"Manchester Utd","Premier League","Antony","BRA","FW","22",2000,20,22,9,9,9,4,8,28,28.6,20,18,0,18,11,33,6,0,"https://fbref.com/en/players/99127249/Antony"
2023,"Manchester Utd","Premier League","Donny van de Beek","NED","MF","25",1997,1.9,0,0,0,0,0,0,1,0,1,2,1,1,1,1,1,0,"https://fbref.com/en/players/50dc94ce/Donny-van-de-Beek"
2023,"Manchester Utd","Premier League","Casemiro","BRA","MF","30",1992,23.6,89,46,43,35,11,48,92,52.2,44,49,11,38,34,123,64,0,"https://fbref.com/en/players/4d224fe8/Casemiro"
2023,"Manchester Utd","Premier League","Diogo Dalot","POR","DF","23",1999,23.9,54,41,40,13,1,33,45,73.3,12,25,7,18,37,91,55,2,"https://fbref.com/en/players/d9565625/Diogo-Dalot"
2023,"Manchester Utd","Premier League","Anthony Elanga","SWE","FW","20",2002,4.7,3,0,0,2,1,1,2,50,1,4,0,4,2,5,4,0,"https://fbref.com/en/players/2fba6108/Anthony-Elanga"
2023,"Manchester Utd","Premier League","Christian Eriksen","DEN","MF","30",1992,22.8,22,18,10,7,5,10,32,31.3,22,23,9,14,11,33,20,1,"https://fbref.com/en/players/980522ec/Christian-Eriksen"
2023,"Manchester Utd","Premier League","Bruno Fernandes","POR","MF,FW","27",1994,36.8,68,42,24,25,19,30,71,42.3,41,37,5,32,25,93,40,1,"https://fbref.com/en/players/507c7bdf/Bruno-Fernandes"
2023,"Manchester Utd","Premier League","Fred","BRA","MF","29",1993,13.9,47,30,24,20,3,15,38,39.5,23,38,2,36,19,66,19,0,"https://fbref.com/en/players/b853e0ad/Fred"
2023,"Manchester Utd","Premier League","Alejandro Garnacho","ARG","FW,MF","18",2004,6.3,5,2,2,0,3,1,11,9.1,10,5,0,5,5,10,3,0,"https://fbref.com/en/players/7aa8adfe/Alejandro-Garnacho"
2023,"Manchester Utd","Premier League","David de Gea","ESP","GK","31",1990,38,0,0,0,0,0,0,1,0,1,0,0,0,1,1,15,3,"https://fbref.com/en/players/7ba6d84e/David-de-Gea"
2023,"Manchester Utd","Premier League","Victor Lindelöf","SWE","DF","28",1994,15.2,22,17,10,9,3,9,17,52.9,8,18,9,9,21,43,63,1,"https://fbref.com/en/players/f5deef4c/Victor-Lindelof"
2023,"Manchester Utd","Premier League","Harry Maguire","ENG","DF","29",1993,8.5,8,6,6,1,1,4,5,80,1,18,11,7,13,21,41,0,"https://fbref.com/en/players/d8931174/Harry-Maguire"
2023,"Manchester Utd","Premier League","Kobbie Mainoo","ENG","MF","17",2005,0.1,0,0,0,0,0,0,0,NA,0,1,1,0,0,0,0,0,"https://fbref.com/en/players/c6220452/Kobbie-Mainoo"
2023,"Manchester Utd","Premier League","Tyrell Malacia","NED","DF","22",1999,15.5,46,33,33,12,1,14,25,56,11,13,3,10,25,71,49,0,"https://fbref.com/en/players/6b6c793c/Tyrell-Malacia"
2023,"Manchester Utd","Premier League","Anthony Martial","FRA","FW","26",1995,10.9,5,3,0,2,3,1,4,25,3,11,2,9,1,6,4,0,"https://fbref.com/en/players/8b788c01/Anthony-Martial"
2023,"Manchester Utd","Premier League","Lisandro Martínez","ARG","DF","24",1998,23.5,54,28,33,18,3,30,43,69.8,13,51,27,24,33,87,103,0,"https://fbref.com/en/players/bac46a10/Lisandro-Martinez"
2023,"Manchester Utd","Premier League","Scott McTominay","SCO","MF","25",1996,12.9,32,19,16,10,6,13,22,59.1,9,15,6,9,14,46,45,0,"https://fbref.com/en/players/d93c2511/Scott-McTominay"
2023,"Manchester Utd","Premier League","Facundo Pellistri","URU","FW,MF","20",2001,0.7,1,1,0,1,0,0,0,NA,0,0,0,0,0,1,3,0,"https://fbref.com/en/players/ac7e7b1c/Facundo-Pellistri"
2023,"Manchester Utd","Premier League","Marcus Rashford","ENG","FW","24",1997,32,20,10,7,8,5,9,24,37.5,15,31,4,27,7,27,14,0,"https://fbref.com/en/players/a1d5bd30/Marcus-Rashford"
2023,"Manchester Utd","Premier League","Cristiano Ronaldo","POR","FW","37",1985,5.8,2,2,1,0,1,1,2,50,1,0,0,0,1,3,9,0,"https://fbref.com/en/players/dea698d9/Cristiano-Ronaldo"
2023,"Manchester Utd","Premier League","Marcel Sabitzer","AUT","MF","28",1994,7,12,8,3,8,1,2,11,18.2,9,6,2,4,8,20,11,0,"https://fbref.com/en/players/e280527c/Marcel-Sabitzer"
2023,"Manchester Utd","Premier League","Jadon Sancho","ENG","FW,MF","22",2000,18.7,16,10,7,5,4,8,28,28.6,20,25,2,23,7,23,6,0,"https://fbref.com/en/players/dbf053da/Jadon-Sancho"
2023,"Manchester Utd","Premier League","Luke Shaw","ENG","DF","27",1995,28.4,55,36,31,22,2,32,45,71.1,13,51,17,34,36,91,55,2,"https://fbref.com/en/players/9c94165b/Luke-Shaw"
2023,"Manchester Utd","Premier League","Raphaël Varane","FRA","DF","29",1993,21.2,24,9,18,6,0,7,17,41.2,10,24,17,7,11,35,91,0,"https://fbref.com/en/players/9f8e9423/Raphael-Varane"
2023,"Manchester Utd","Premier League","Aaron Wan-Bissaka","ENG","DF","24",1997,15.9,40,25,20,17,3,23,25,92,2,24,8,16,22,62,41,0,"https://fbref.com/en/players/9e525177/Aaron-Wan-Bissaka"
2023,"Manchester Utd","Premier League","Wout Weghorst","NED","FW,MF","29",1992,8.9,11,5,6,1,4,2,9,22.2,7,7,2,5,7,18,9,0,"https://fbref.com/en/players/c4e87b8b/Wout-Weghorst"
2023,"Marseille","Ligue 1","Eric Bailly","CIV","DF","28",1994,6,13,10,6,6,1,7,7,100,0,15,12,3,12,25,18,1,"https://fbref.com/en/players/a1232f4e/Eric-Bailly"
2023,"Marseille","Ligue 1","Cédric Bakambu","COD","MF","31",1991,0.7,2,1,2,0,0,2,2,100,0,0,0,0,0,2,0,0,"https://fbref.com/en/players/0af4dcf0/Cedric-Bakambu"
2023,"Marseille","Ligue 1","Leonardo Balerdi","ARG","DF","23",1999,29.3,57,37,43,12,2,32,45,71.1,13,48,29,19,63,120,91,1,"https://fbref.com/en/players/7c3ed041/Leonardo-Balerdi"
2023,"Marseille","Ligue 1","Salim Ben Seghir","FRA","MF","19",2003,0,0,0,0,0,0,0,0,NA,0,1,0,1,0,0,0,0,"https://fbref.com/en/players/1f6298f2/Salim-Ben-Seghir"
2023,"Marseille","Ligue 1","Rubén Blanco","ESP","GK","27",1995,5.5,0,0,0,0,0,0,0,NA,0,0,0,0,0,0,1,0,"https://fbref.com/en/players/967f34d3/Ruben-Blanco"
2023,"Marseille","Ligue 1","Duje Ćaleta-Car","CRO","DF","25",1996,0.1,0,0,0,0,0,0,0,NA,0,0,0,0,0,0,1,0,"https://fbref.com/en/players/94f8d10c/Duje-Caleta-Car"
2023,"Marseille","Ligue 1","Jonathan Clauss","FRA","DF","29",1992,28.8,46,28,21,16,9,23,52,44.2,29,29,4,25,31,77,40,2,"https://fbref.com/en/players/5219ab4a/Jonathan-Clauss"
2023,"Marseille","Ligue 1","Bamba Dieng","SEN","FW,MF","22",2000,2.2,4,4,2,1,1,3,4,75,1,5,1,4,0,4,0,0,"https://fbref.com/en/players/40774c6b/Bamba-Dieng"
2023,"Marseille","Ligue 1","Gerson","BRA","MF","25",1997,4.6,6,4,1,4,1,3,5,60,2,5,0,5,2,8,4,0,"https://fbref.com/en/players/8827bf46/Gerson"
2023,"Marseille","Ligue 1","Samuel Gigot","FRA","DF","28",1993,20.9,46,24,22,21,3,12,15,80,3,24,7,17,45,91,85,1,"https://fbref.com/en/players/41eebdf5/Samuel-Gigot"
2023,"Marseille","Ligue 1","Mattéo Guendouzi","FRA","MF","23",1999,23.4,39,18,9,21,9,14,38,36.8,24,12,5,7,21,60,18,0,"https://fbref.com/en/players/5ea8ef20/Matteo-Guendouzi"
2023,"Marseille","Ligue 1","Pape Gueye","SEN","MF,DF","23",1999,5.5,18,7,10,7,1,7,15,46.7,8,9,2,7,9,27,2,0,"https://fbref.com/en/players/7155e3e1/Pape-Gueye"
2023,"Marseille","Ligue 1","Amine Harit","MAR","MF,FW","25",1997,5.7,6,4,0,3,3,3,8,37.5,5,4,1,3,4,10,6,0,"https://fbref.com/en/players/e7d59f4f/Amine-Harit"
2023,"Marseille","Ligue 1","Luis Javier Suárez","COL","FW","24",1997,3.3,4,1,1,2,1,1,4,25,3,1,0,1,3,7,6,0,"https://fbref.com/en/players/eeba07f8/Luis-Javier-Suarez"
2023,"Marseille","Ligue 1","Issa Kaboré","BFA","DF","21",2001,11.4,33,19,10,18,5,21,32,65.6,11,11,1,10,12,45,21,1,"https://fbref.com/en/players/c066d1a5/Issa-Kabore"
2023,"Marseille","Ligue 1","Sead Kolašinac","BIH","DF","29",1993,24.6,52,36,24,22,6,24,37,64.9,13,19,2,17,43,95,35,1,"https://fbref.com/en/players/3935e52e/Sead-Kolasinac"
2023,"Marseille","Ligue 1","Pau López","ESP","GK","27",1994,32.5,0,0,0,0,0,0,1,0,1,0,0,0,0,0,5,1,"https://fbref.com/en/players/20b9f052/Pau-Lopez"
2023,"Marseille","Ligue 1","Ruslan Malinovskyi","UKR","MF,FW","29",1993,13.6,21,11,3,12,6,10,26,38.5,16,13,1,12,3,24,9,0,"https://fbref.com/en/players/48d5bd33/Ruslan-Malinovskyi"
2023,"Marseille","Ligue 1","Chancel Mbemba","COD","DF","27",1994,31.7,43,26,24,17,2,22,31,71,9,25,12,13,42,85,89,0,"https://fbref.com/en/players/e76cb9cc/Chancel-Mbemba"
2023,"Marseille","Ligue 1","Arkadiusz Milik","POL","FW","28",1994,1.4,1,1,0,0,1,0,1,0,1,0,0,0,0,1,2,0,"https://fbref.com/en/players/85613cf0/Arkadiusz-Milik"
2023,"Marseille","Ligue 1","François Mughe","CMR","MF","18",2004,0.1,0,0,0,0,0,0,0,NA,0,0,0,0,0,0,0,0,"https://fbref.com/en/players/7af655fe/Francois-Mughe"
2023,"Marseille","Ligue 1","Azzedine Ounahi","MAR","MF,FW","22",2000,1.3,2,1,1,1,0,0,2,0,2,1,0,1,0,2,0,0,"https://fbref.com/en/players/83299cc0/Azzedine-Ounahi"
2023,"Marseille","Ligue 1","Dimitri Payet","FRA","MF,FW","35",1987,9.3,6,4,2,2,2,3,10,30,7,4,0,4,0,6,4,0,"https://fbref.com/en/players/58ae47b2/Dimitri-Payet"
2023,"Marseille","Ligue 1","Valentin Rongier","FRA","MF","27",1994,33.7,93,59,33,47,13,41,77,53.2,36,50,11,39,54,147,38,1,"https://fbref.com/en/players/ed45c4a5/Valentin-Rongier"
2023,"Marseille","Ligue 1","Alexis Sánchez","CHI","FW,MF","33",1988,29.8,27,17,5,16,6,3,24,12.5,21,14,0,14,5,32,6,0,"https://fbref.com/en/players/2c0f8e9e/Alexis-Sanchez"
2023,"Marseille","Ligue 1","Nuno Tavares","POR","DF,MF","22",2000,26.1,56,30,19,24,13,28,55,50.9,27,32,4,28,15,71,25,0,"https://fbref.com/en/players/a65c844b/Nuno-Tavares"
2023,"Marseille","Ligue 1","Souleymane Touré","FRA","DF","19",2003,0.8,2,1,1,1,0,1,2,50,1,1,0,1,0,2,5,0,"https://fbref.com/en/players/01fd01e8/Souleymane-Toure"
2023,"Marseille","Ligue 1","Cengiz Ünder","TUR","MF,DF","25",1997,27.7,37,19,15,13,9,13,34,38.2,21,18,2,16,18,55,13,0,"https://fbref.com/en/players/1880614f/Cengiz-Under"
2023,"Marseille","Ligue 1","Jordan Veretout","FRA","MF","29",1993,31.8,56,35,17,32,7,25,53,47.2,28,22,7,15,36,92,40,2,"https://fbref.com/en/players/4a56052c/Jordan-Veretout"
2023,"Marseille","Ligue 1","Vitinha","POR","FW","22",2000,5.2,15,7,0,6,9,3,11,27.3,8,3,0,3,2,17,6,0,"https://fbref.com/en/players/74d4cec6/Vitinha"
2023,"Milan","Serie A","Yacine Adli","FRA","MF,FW","22",2000,1.6,6,3,2,4,0,2,2,100,0,2,0,2,1,7,1,0,"https://fbref.com/en/players/26777636/Yacine-Adli"
2023,"Milan","Serie A","Tiemoué Bakayoko","FRA","MF","27",1994,0.5,5,5,4,1,0,3,3,100,0,0,0,0,0,5,0,1,"https://fbref.com/en/players/59bf127b/Tiemoue-Bakayoko"
2023,"Milan","Serie A","Fodé Ballo-Touré","SEN","DF","25",1997,5.8,14,9,7,6,1,7,10,70,3,11,3,8,2,16,3,0,"https://fbref.com/en/players/f449640d/Fode-Ballo-Toure"
2023,"Milan","Serie A","Ismaël Bennacer","ALG","MF","24",1997,22.3,59,33,26,31,2,30,51,58.8,21,25,7,18,26,85,16,1,"https://fbref.com/en/players/db092d3b/Ismael-Bennacer"
2023,"Milan","Serie A","Davide Calabria","ITA","DF","25",1996,18.8,71,44,31,32,8,38,61,62.3,23,22,7,15,25,96,34,0,"https://fbref.com/en/players/2146785a/Davide-Calabria"
2023,"Milan","Serie A","Charles De Ketelaere","BEL","MF,FW","21",2001,12.4,26,12,7,14,5,13,30,43.3,17,14,2,12,4,30,9,0,"https://fbref.com/en/players/2ef7c612/Charles-De-Ketelaere"
2023,"Milan","Serie A","Sergiño Dest","USA","DF","21",2000,3.7,12,6,3,5,4,3,4,75,1,1,0,1,4,16,2,0,"https://fbref.com/en/players/5976f83e/Sergino-Dest"
2023,"Milan","Serie A","Brahim Díaz","ESP","MF,FW","22",1999,21.4,32,15,5,22,5,5,15,33.3,10,11,0,11,7,39,6,0,"https://fbref.com/en/players/407feb71/Brahim-Diaz"
2023,"Milan","Serie A","Alessandro Florenzi","ITA","DF","31",1991,2.3,6,4,3,2,1,4,7,57.1,3,1,0,1,4,10,2,0,"https://fbref.com/en/players/e288d4b3/Alessandro-Florenzi"
2023,"Milan","Serie A","Matteo Gabbia","ITA","DF","22",1999,6.8,17,10,12,5,0,6,8,75,2,8,3,5,5,22,29,0,"https://fbref.com/en/players/c235e803/Matteo-Gabbia"
2023,"Milan","Serie A","Olivier Giroud","FRA","FW","35",1986,23.8,8,5,2,4,2,2,10,20,8,11,3,8,3,11,23,0,"https://fbref.com/en/players/16ceb862/Olivier-Giroud"
2023,"Milan","Serie A","Theo Hernández","FRA","DF","24",1997,30.8,43,24,27,15,1,22,38,57.9,16,34,7,27,21,64,35,1,"https://fbref.com/en/players/d4c9725f/Theo-Hernandez"
2023,"Milan","Serie A","Zlatan Ibrahimović","SWE","FW","40",1981,1.6,0,0,0,0,0,0,0,NA,0,1,1,0,0,0,2,0,"https://fbref.com/en/players/4cde5509/Zlatan-Ibrahimovic"
2023,"Milan","Serie A","Pierre Kalulu","FRA","DF","22",2000,28.3,57,39,33,21,3,28,42,66.7,14,41,17,24,41,98,56,1,"https://fbref.com/en/players/85f7d1be/Pierre-Kalulu"
2023,"Milan","Serie A","Simon Kjær","DEN","DF","33",1989,11.2,15,8,9,6,0,7,11,63.6,4,14,11,3,9,24,35,1,"https://fbref.com/en/players/8b8a56ce/Simon-Kjaer"
2023,"Milan","Serie A","Rade Krunić","BIH","MF","28",1993,18.4,40,28,18,18,4,16,50,32,34,31,11,20,16,56,21,0,"https://fbref.com/en/players/817c6964/Rade-Krunic"
2023,"Milan","Serie A","Marko Lazetić","SRB","FW","18",2004,0.1,0,0,0,0,0,0,0,NA,0,0,0,0,0,0,0,0,"https://fbref.com/en/players/93088fbb/Marko-Lazetic"
2023,"Milan","Serie A","Rafael Leão","POR","FW,MF","23",1999,26.9,8,7,2,3,3,6,14,42.9,8,9,2,7,15,23,8,0,"https://fbref.com/en/players/20730eae/Rafael-Leao"
2023,"Milan","Serie A","Mike Maignan","FRA","GK","27",1995,22,1,0,1,0,0,1,1,100,0,0,0,0,1,2,10,1,"https://fbref.com/en/players/fcb38f57/Mike-Maignan"
2023,"Milan","Serie A","Junior Messias","BRA","FW,DF","31",1991,16.6,24,18,9,9,6,5,19,26.3,14,20,4,16,7,31,28,0,"https://fbref.com/en/players/f49c4ae9/Junior-Messias"
2023,"Milan","Serie A","Antonio Mirante","ITA","GK","39",1983,0,0,0,0,0,0,0,0,NA,0,0,0,0,0,0,0,0,"https://fbref.com/en/players/30223b33/Antonio-Mirante"
2023,"Milan","Serie A","Divock Origi","BEL","FW","27",1995,11.4,10,5,4,3,3,5,10,50,5,6,2,4,0,10,13,0,"https://fbref.com/en/players/43a166b4/Divock-Origi"
2023,"Milan","Serie A","Tommaso Pobega","ITA","MF","23",1999,9.8,27,16,8,15,4,13,20,65,7,12,4,8,9,36,11,0,"https://fbref.com/en/players/55a1cac2/Tommaso-Pobega"
2023,"Milan","Serie A","Ante Rebić","CRO","FW,MF","28",1993,10.9,10,8,1,3,6,3,11,27.3,8,6,1,5,1,11,5,0,"https://fbref.com/en/players/536cebe5/Ante-Rebic"
2023,"Milan","Serie A","Alexis Saelemaekers","BEL","FW,DF","23",1999,15.6,31,20,12,16,3,19,41,46.3,22,13,1,12,19,50,11,0,"https://fbref.com/en/players/ee251371/Alexis-Saelemaekers"
2023,"Milan","Serie A","Ciprian Tătărușanu","ROU","GK","36",1986,16,0,0,0,0,0,0,0,NA,0,0,0,0,1,1,2,0,"https://fbref.com/en/players/b056e3da/Ciprian-Tatarusanu"
2023,"Milan","Serie A","Malick Thiaw","GER","DF","20",2001,15.1,31,26,22,9,0,11,20,55,9,11,5,6,12,43,65,1,"https://fbref.com/en/players/ff5ea0bf/Malick-Thiaw"
2023,"Milan","Serie A","Fikayo Tomori","ENG","DF","24",1997,30.7,70,34,44,25,1,22,34,64.7,12,46,25,21,29,99,88,1,"https://fbref.com/en/players/7edfbb8a/Fikayo-Tomori"
2023,"Milan","Serie A","Sandro Tonali","ITA","MF","22",2000,30.1,64,41,35,24,5,27,44,61.4,17,34,9,25,25,89,26,1,"https://fbref.com/en/players/0db169ae/Sandro-Tonali"
2023,"Milan","Serie A","Aster Vranckx","BEL","MF","19",2002,2.7,3,2,0,2,1,2,7,28.6,5,3,1,2,2,5,1,0,"https://fbref.com/en/players/f86cd5df/Aster-Vranckx"
2023,"Monaco","Ligue 1","Ruben Aguilar","FRA","DF","29",1993,13,19,9,7,7,5,8,22,36.4,14,13,1,12,18,37,28,1,"https://fbref.com/en/players/3dd738a1/Ruben-Aguilar"
2023,"Monaco","Ligue 1","Maghnes Akliouche","FRA","MF,FW","20",2002,4.5,7,4,4,3,0,2,8,25,6,2,0,2,3,10,2,0,"https://fbref.com/en/players/b625b241/Maghnes-Akliouche"
2023,"Monaco","Ligue 1","Benoît Badiashile","FRA","DF","21",2001,9.3,10,8,6,4,0,5,10,50,5,9,6,3,17,27,40,1,"https://fbref.com/en/players/06df8256/Benoit-Badiashile"
2023,"Monaco","Ligue 1","Eliesse Ben Seghir","FRA","FW,MF","17",2005,11.7,18,10,4,12,2,4,12,33.3,8,18,1,17,4,22,1,0,"https://fbref.com/en/players/3bd65247/Eliesse-Ben-Seghir"
2023,"Monaco","Ligue 1","Wissam Ben Yedder","FRA","FW","31",1990,23.5,16,9,2,5,9,4,13,30.8,9,15,0,15,4,20,0,0,"https://fbref.com/en/players/942b4f90/Wissam-Ben-Yedder"
2023,"Monaco","Ligue 1","Myron Boadu","NED","FW","21",2001,3.3,3,3,0,2,1,1,7,14.3,6,1,0,1,0,3,1,0,"https://fbref.com/en/players/5b479568/Myron-Boadu"
2023,"Monaco","Ligue 1","Mohamed Camara","MLI","MF","22",2000,24.4,83,45,38,39,6,48,92,52.2,44,45,6,39,27,110,14,1,"https://fbref.com/en/players/489e80e3/Mohamed-Camara"
2023,"Monaco","Ligue 1","Krépin Diatta","SEN","MF,FW","23",1999,23,30,21,4,17,9,13,32,40.6,19,29,1,28,17,47,12,0,"https://fbref.com/en/players/8104e41e/Krepin-Diatta"
2023,"Monaco","Ligue 1","Edan Diop","FRA","DF,FW","17",2004,2.5,13,8,3,3,7,7,15,46.7,8,7,1,6,4,17,1,0,"https://fbref.com/en/players/37143438/Edan-Diop"
2023,"Monaco","Ligue 1","Sofiane Diop","FRA","MF","22",2000,0.7,0,0,0,0,0,0,0,NA,0,0,0,0,1,1,0,0,"https://fbref.com/en/players/19053e31/Sofiane-Diop"
2023,"Monaco","Ligue 1","Axel Disasi","FRA","DF","24",1998,37,30,20,13,13,4,13,27,48.1,14,51,31,20,56,86,112,2,"https://fbref.com/en/players/ad82197c/Axel-Disasi"
2023,"Monaco","Ligue 1","Breel Embolo","SUI","FW","25",1997,20.7,15,9,2,7,6,5,10,50,5,14,3,11,5,20,12,0,"https://fbref.com/en/players/0b4f388a/Breel-Embolo"
2023,"Monaco","Ligue 1","Youssouf Fofana","FRA","MF","23",1999,34.3,81,41,31,42,8,38,74,51.4,36,50,6,44,56,137,32,1,"https://fbref.com/en/players/822d51d7/Youssouf-Fofana"
2023,"Monaco","Ligue 1","Aleksandr Golovin","RUS","MF,FW","26",1996,27.4,62,36,19,32,11,28,72,38.9,44,28,1,27,37,99,10,0,"https://fbref.com/en/players/3708e9fa/Aleksandr-Golovin"
2023,"Monaco","Ligue 1","Ismail Jakobs","SEN","DF,FW","22",1999,12.4,11,5,7,3,1,5,12,41.7,7,9,1,8,9,20,18,0,"https://fbref.com/en/players/a0415710/Ismail-Jakobs"
2023,"Monaco","Ligue 1","Jean Lucas","BRA","MF","24",1998,3.2,9,5,3,5,1,6,12,50,6,2,1,1,4,13,2,0,"https://fbref.com/en/players/a99138af/Jean-Lucas"
2023,"Monaco","Ligue 1","Soungoutou Magassa","FRA","MF","18",2003,0.9,4,1,2,2,0,2,4,50,2,3,0,3,1,5,1,0,"https://fbref.com/en/players/dfc5d4fa/Soungoutou-Magassa"
2023,"Monaco","Ligue 1","Guillermo Maripán","CHI","DF","28",1994,24,46,26,26,20,0,17,33,51.5,16,39,27,12,38,84,87,0,"https://fbref.com/en/players/d9764034/Guillermo-Maripan"
2023,"Monaco","Ligue 1","Gelson Martins","POR","MF,FW","27",1995,3.8,15,8,6,4,5,4,13,30.8,9,4,1,3,3,18,2,0,"https://fbref.com/en/players/3ef0fa48/Gelson-Martins"
2023,"Monaco","Ligue 1","Eliot Matazo","BEL","MF","20",2002,13.1,26,12,11,13,2,11,26,42.3,15,18,4,14,15,41,11,1,"https://fbref.com/en/players/15944afd/Eliot-Matazo"
2023,"Monaco","Ligue 1","Chrislain Matsima","FRA","DF","20",2002,5,11,6,7,2,2,4,7,57.1,3,5,5,0,9,20,16,0,"https://fbref.com/en/players/cf1ef7ec/Chrislain-Matsima"
2023,"Monaco","Ligue 1","Takumi Minamino","JPN","MF,FW","27",1995,8,15,8,5,7,3,7,35,20,28,14,0,14,6,21,4,0,"https://fbref.com/en/players/f833a830/Takumi-Minamino"
2023,"Monaco","Ligue 1","Alexander Nübel","GER","GK","25",1996,38,0,0,0,0,0,0,1,0,1,0,0,0,1,1,10,3,"https://fbref.com/en/players/afb0c500/Alexander-Nubel"
2023,"Monaco","Ligue 1","Malang Sarr","FRA","DF","23",1999,8,6,3,5,1,0,1,5,20,4,11,7,4,15,21,29,2,"https://fbref.com/en/players/4315f30d/Malang-Sarr"
2023,"Monaco","Ligue 1","Caio Henrique Oliveira Silva","BRA","DF","25",1997,32.2,74,51,42,28,4,44,76,57.9,32,28,8,20,26,100,68,1,"https://fbref.com/en/players/30af8b93/Caio-Henrique-Oliveira-Silva"
2023,"Monaco","Ligue 1","Vanderson","BRA","DF,MF","21",2001,24.6,84,48,36,34,14,44,75,58.7,31,36,9,27,48,132,36,1,"https://fbref.com/en/players/ee45fd85/Vanderson"
2023,"Monaco","Ligue 1","Kevin Volland","GER","FW,MF","30",1992,7.1,8,4,1,5,2,2,8,25,6,8,0,8,2,10,0,0,"https://fbref.com/en/players/64f69877/Kevin-Volland"
2023,"Montpellier","Ligue 1","Matis Carvalho","POR","GK","23",1999,1.5,0,0,0,0,0,0,0,NA,0,0,0,0,1,1,0,0,"https://fbref.com/en/players/8608f269/Matis-Carvalho"
2023,"Montpellier","Ligue 1","Joris Chotard","FRA","MF","20",2001,27.3,64,34,37,23,4,40,78,51.3,38,40,11,29,40,104,42,1,"https://fbref.com/en/players/7909ffa4/Joris-Chotard"
2023,"Montpellier","Ligue 1","Nicolas Cozza","FRA","DF","23",1999,14.2,38,21,27,9,2,26,38,68.4,12,11,5,6,21,59,35,1,"https://fbref.com/en/players/8f325097/Nicolas-Cozza"
2023,"Montpellier","Ligue 1","Sacha Delaye","FRA","FW,MF","20",2002,0.2,1,0,0,0,1,1,1,100,0,0,0,0,0,1,0,0,"https://fbref.com/en/players/e4448c8c/Sacha-Delaye"
2023,"Montpellier","Ligue 1","Maxime Estève","FRA","DF","20",2002,18.3,24,13,17,5,2,12,17,70.6,5,28,17,11,34,58,90,0,"https://fbref.com/en/players/1a066e69/Maxime-Esteve"
2023,"Montpellier","Ligue 1","Khalil Fayad","FRA","MF","18",2004,8,30,14,12,16,2,12,21,57.1,9,8,1,7,9,39,4,0,"https://fbref.com/en/players/faf00ab8/Khalil-Fayad"
2023,"Montpellier","Ligue 1","Cheikh Faye","SEN","FW","23",1999,0.4,0,0,0,0,0,0,0,NA,0,0,0,0,1,1,0,0,"https://fbref.com/en/players/4b792f35/Cheikh-Faye"
2023,"Montpellier","Ligue 1","Jordan Ferri","FRA","MF","30",1992,30.4,55,35,32,19,4,30,89,33.7,59,22,6,16,26,81,21,0,"https://fbref.com/en/players/375622c5/Jordan-Ferri"
2023,"Montpellier","Ligue 1","Valère Germain","FRA","FW,MF","32",1990,7.6,13,11,3,5,5,4,12,33.3,8,8,0,8,6,19,12,0,"https://fbref.com/en/players/ea0ff634/Valere-Germain"
2023,"Montpellier","Ligue 1","Axel Gueguin","FRA","FW,MF","17",2005,0.3,0,0,0,0,0,0,0,NA,0,1,0,1,0,0,0,0,"https://fbref.com/en/players/f6857b4f/Axel-Gueguin"
2023,"Montpellier","Ligue 1","Christopher Jullien","FRA","DF","29",1993,29.9,46,28,29,14,3,28,51,54.9,23,35,18,17,43,89,114,1,"https://fbref.com/en/players/f323d995/Christopher-Jullien"
2023,"Montpellier","Ligue 1","Bingourou Kamara","SEN","GK","25",1996,4.5,0,0,0,0,0,0,0,NA,0,0,0,0,0,0,2,0,"https://fbref.com/en/players/3814120d/Bingourou-Kamara"
2023,"Montpellier","Ligue 1","Wahbi Khazri","TUN","FW,MF","31",1991,18.2,26,13,13,7,6,6,25,24,19,17,1,16,9,35,20,0,"https://fbref.com/en/players/2677a1de/Wahbi-Khazri"
2023,"Montpellier","Ligue 1","Boubakar Kouyaté","MLI","DF","25",1997,14,31,18,18,11,2,19,35,54.3,16,24,14,10,34,65,73,1,"https://fbref.com/en/players/562a4799/Boubakar-Kouyate"
2023,"Montpellier","Ligue 1","Benjamin Lecomte","FRA","GK","31",1991,19,0,0,0,0,0,0,2,0,2,0,0,0,0,0,6,0,"https://fbref.com/en/players/2fa2a875/Benjamin-Lecomte"
2023,"Montpellier","Ligue 1","Léo Leroy","FRA","MF","22",2000,13.2,53,38,24,26,3,31,57,54.4,26,25,2,23,14,67,8,0,"https://fbref.com/en/players/fcc84a07/Leo-Leroy"
2023,"Montpellier","Ligue 1","Béni Makouana","CGO","FW,MF","19",2002,2.2,1,0,0,1,0,0,2,0,2,3,1,2,0,1,1,0,"https://fbref.com/en/players/654f49ca/Beni-Makouana"
2023,"Montpellier","Ligue 1","Faitout Maouassa","FRA","FW,DF","24",1998,21.4,52,32,26,20,6,18,41,43.9,23,31,3,28,20,72,23,0,"https://fbref.com/en/players/e54a9890/Faitout-Maouassa"
2023,"Montpellier","Ligue 1","Stephy Mavididi","ENG","FW","24",1998,14.3,24,19,12,8,4,13,27,48.1,14,21,1,20,4,28,10,0,"https://fbref.com/en/players/30144daa/Stephy-Mavididi"
2023,"Montpellier","Ligue 1","Pedro Mendes","POR","DF","31",1990,0.1,0,0,0,0,0,0,0,NA,0,0,0,0,0,0,0,1,"https://fbref.com/en/players/6690ef25/Pedro-Mendes"
2023,"Montpellier","Ligue 1","Arnaud Nordin","FRA","FW","24",1998,26.7,26,14,10,12,4,12,28,42.9,16,19,1,18,14,40,7,0,"https://fbref.com/en/players/7b9a9e25/Arnaud-Nordin"
2023,"Montpellier","Ligue 1","Jonas Omlin","SUI","GK","28",1994,13,1,0,1,0,0,0,0,NA,0,0,0,0,0,1,8,1,"https://fbref.com/en/players/c631f952/Jonas-Omlin"
2023,"Montpellier","Ligue 1","Falaye Sacko","MLI","DF","27",1995,28.7,46,25,25,15,6,32,51,62.7,19,43,14,29,33,79,75,1,"https://fbref.com/en/players/6388e356/Falaye-Sacko"
2023,"Montpellier","Ligue 1","Théo Sainte-Luce","FRA","DF","23",1998,5.9,13,11,8,5,0,7,14,50,7,7,2,5,10,23,11,0,"https://fbref.com/en/players/93c942fb/Theo-Sainte-Luce"
2023,"Montpellier","Ligue 1","Mamadou Sakho","FRA","DF","32",1990,8.5,9,5,4,5,0,3,5,60,2,17,12,5,8,17,35,1,"https://fbref.com/en/players/87935cf3/Mamadou-Sakho"
2023,"Montpellier","Ligue 1","Téji Savanier","FRA","MF","30",1991,28.3,46,30,16,19,11,23,70,32.9,47,30,2,28,30,76,12,1,"https://fbref.com/en/players/6bde367b/Teji-Savanier"
2023,"Montpellier","Ligue 1","Arnaud Souquet","FRA","DF,FW","30",1992,4,22,16,13,7,2,11,14,78.6,3,8,3,5,4,26,4,0,"https://fbref.com/en/players/4e0afc5d/Arnaud-Souquet"
2023,"Montpellier","Ligue 1","Issiaga Sylla","GUI","DF","28",1994,14.5,28,16,19,8,1,15,31,48.4,16,19,3,16,32,60,35,0,"https://fbref.com/en/players/b99bec05/Issiaga-Sylla"
2023,"Montpellier","Ligue 1","Thibault Tamas","FRA","DF","21",2001,0.1,0,0,0,0,0,0,0,NA,0,0,0,0,1,1,0,0,"https://fbref.com/en/players/4a0c6555/Thibault-Tamas"
2023,"Montpellier","Ligue 1","Enzo Tchato","CMR","DF","19",2002,12.2,26,17,14,11,1,13,22,59.1,9,17,2,15,7,33,33,0,"https://fbref.com/en/players/7f783431/Enzo-Tchato"
2023,"Montpellier","Ligue 1","Elye Wahi","FRA","FW","19",2003,27.9,9,3,2,3,4,5,14,35.7,9,14,2,12,3,12,5,0,"https://fbref.com/en/players/0d7b6576/Elye-Wahi"
2023,"Monza","Serie A","Valentin Antov","BUL","DF","21",2000,3.4,6,5,3,3,0,1,5,20,4,5,4,1,4,10,14,1,"https://fbref.com/en/players/8f68aa41/Valentin-Antov"
2023,"Monza","Serie A","Andrea Barberis","ITA","MF","28",1993,3.8,7,2,4,3,0,5,11,45.5,6,0,0,0,8,15,1,0,"https://fbref.com/en/players/32ebfe1e/Andrea-Barberis"
2023,"Monza","Serie A","Samuele Birindelli","ITA","DF","23",1999,15.6,35,19,21,10,4,18,29,62.1,11,28,8,20,16,51,30,0,"https://fbref.com/en/players/204ac005/Samuele-Birindelli"
2023,"Monza","Serie A","Warren Bondo","FRA","MF","18",2003,0.7,1,0,1,0,0,0,0,NA,0,1,0,1,0,1,0,0,"https://fbref.com/en/players/0def2376/Warren-Bondo"
2023,"Monza","Serie A","Luca Caldirola","ITA","DF","31",1991,26.1,26,14,19,4,3,13,26,50,13,32,18,14,25,51,66,1,"https://fbref.com/en/players/226008f1/Luca-Caldirola"
2023,"Monza","Serie A","Gianluca Caprari","ITA","MF,FW","29",1993,27.1,16,6,3,11,2,8,26,30.8,18,22,1,21,8,24,3,0,"https://fbref.com/en/players/54e53b7e/Gianluca-Caprari"
2023,"Monza","Serie A","Andrea Carboni","ITA","DF","21",2001,1.9,3,2,2,0,1,2,5,40,3,3,2,1,3,6,2,1,"https://fbref.com/en/players/f7e2af2c/Andrea-Carboni"
2023,"Monza","Serie A","Franco Carboni","ITA","DF,FW","19",2003,0.7,1,1,1,0,0,0,2,0,2,3,0,3,1,2,0,0,"https://fbref.com/en/players/b033f803/Franco-Carboni"
2023,"Monza","Serie A","Carlos","BRA","DF","23",1999,34.3,73,38,42,23,8,33,54,61.1,21,24,6,18,24,97,85,1,"https://fbref.com/en/players/8d3cd59d/Carlos"
2023,"Monza","Serie A","Patrick Ciurria","ITA","DF,MF","27",1995,30.6,31,18,20,10,1,17,33,51.5,16,24,2,22,7,38,32,0,"https://fbref.com/en/players/5de3866c/Patrick-Ciurria"
2023,"Monza","Serie A","Andrea Colpani","ITA","MF","23",1999,10.5,14,9,6,5,3,8,12,66.7,4,14,2,12,3,17,6,0,"https://fbref.com/en/players/6499048c/Andrea-Colpani"
2023,"Monza","Serie A","Alessio Cragno","ITA","GK","28",1994,1,0,0,0,0,0,0,1,0,1,0,0,0,0,0,0,0,"https://fbref.com/en/players/f554e29b/Alessio-Cragno"
2023,"Monza","Serie A","Marco D'Alessandro","ITA","DF,FW","31",1991,3.2,4,4,3,1,0,2,5,40,3,2,0,2,1,5,3,0,"https://fbref.com/en/players/060606ec/Marco-DAlessandro"
2023,"Monza","Serie A","Michele Di Gregorio","ITA","GK","25",1997,37,0,0,0,0,0,0,3,0,3,1,0,1,4,4,18,3,"https://fbref.com/en/players/4e0c8d66/Michele-Di-Gregorio"
2023,"Monza","Serie A","Giulio Donati","ITA","DF","32",1990,4.7,4,1,1,1,2,3,6,50,3,3,1,2,4,8,11,0,"https://fbref.com/en/players/22051fbe/Giulio-Donati"
2023,"Monza","Serie A","Christian Gytkjær","DEN","FW,MF","32",1990,6.2,6,2,1,4,1,2,5,40,3,6,1,5,0,6,2,0,"https://fbref.com/en/players/9250bcff/Christian-Gytkjaer"
2023,"Monza","Serie A","Armando Izzo","ITA","DF","30",1992,27.4,73,50,44,27,2,29,45,64.4,16,29,17,12,50,123,87,1,"https://fbref.com/en/players/89976232/Armando-Izzo"
2023,"Monza","Serie A","Pablo Marí","ESP","DF","28",1993,27.6,37,19,29,7,1,17,26,65.4,9,22,14,8,31,68,111,3,"https://fbref.com/en/players/aa54ec6f/Pablo-Mari"
2023,"Monza","Serie A","Marlon","BRA","DF","26",1995,17.7,35,21,20,14,1,15,29,51.7,14,13,4,9,18,53,50,0,"https://fbref.com/en/players/cdf65d12/Marlon"
2023,"Monza","Serie A","Luca Marrone","ITA","DF","32",1990,1.5,0,0,0,0,0,0,2,0,2,2,2,0,0,0,4,1,"https://fbref.com/en/players/ea468ea8/Luca-Marrone"
2023,"Monza","Serie A","Salvatore Molina","ITA","DF","30",1992,2.5,6,5,2,4,0,4,5,80,1,4,2,2,1,7,2,0,"https://fbref.com/en/players/54ab971f/Salvatore-Molina"
2023,"Monza","Serie A","Dany Mota","POR","FW,MF","24",1998,21.2,8,7,1,3,4,2,10,20,8,5,1,4,6,14,25,0,"https://fbref.com/en/players/efc9e31f/Dany-Mota"
2023,"Monza","Serie A","Pepín","EQG","MF","25",1996,12.5,28,19,10,11,7,9,27,33.3,18,14,3,11,13,41,17,0,"https://fbref.com/en/players/7afb1573/Pepin"
2023,"Monza","Serie A","Matteo Pessina","ITA","MF","25",1997,32.6,57,36,28,21,8,26,62,41.9,36,50,15,35,37,94,33,1,"https://fbref.com/en/players/780e3631/Matteo-Pessina"
2023,"Monza","Serie A","Andrea Petagna","ITA","FW","27",1995,18.5,7,5,2,3,2,3,6,50,3,16,4,12,3,10,18,0,"https://fbref.com/en/players/03f946ed/Andrea-Petagna"
2023,"Monza","Serie A","Andrea Ranocchia","ITA","DF","34",1988,0.5,3,1,1,2,0,3,4,75,1,5,5,0,0,3,7,0,"https://fbref.com/en/players/539230cf/Andrea-Ranocchia"
2023,"Monza","Serie A","Filippo Ranocchia","ITA","MF","21",2001,5.9,11,6,5,4,2,4,12,33.3,8,5,1,4,4,15,7,0,"https://fbref.com/en/players/d9ebed1c/Filippo-Ranocchia"
2023,"Monza","Serie A","Nicolò Rovella","ITA","MF","20",2001,19.3,45,29,22,21,2,13,36,36.1,23,20,1,19,40,85,17,0,"https://fbref.com/en/players/e58cbfd5/Nicolo-Rovella"
2023,"Monza","Serie A","Stefano Sensi","ITA","MF","26",1995,18,41,26,25,13,3,18,48,37.5,30,13,3,10,20,61,4,0,"https://fbref.com/en/players/b70bde8f/Stefano-Sensi"
2023,"Monza","Serie A","Mattia Valoti","ITA","MF,FW","28",1993,5,17,10,7,9,1,5,16,31.3,11,13,3,10,3,20,6,0,"https://fbref.com/en/players/c414df9d/Mattia-Valoti"
2023,"Monza","Serie A","Samuele Vignato","ITA","MF,FW","18",2004,0.7,0,0,0,0,0,0,0,NA,0,1,0,1,0,0,0,0,"https://fbref.com/en/players/a14d0ab0/Samuele-Vignato"
2023,"Nantes","Ligue 1","Mohamed Achi","FRA","FW","20",2002,0.4,1,1,1,0,0,1,1,100,0,0,0,0,0,1,0,0,"https://fbref.com/en/players/1e93fc5d/Mohamed-Achi"
2023,"Nantes","Ligue 1","Dennis Appiah","FRA","DF,MF","30",1992,8.8,21,11,14,7,0,10,27,37,17,13,5,8,10,31,16,0,"https://fbref.com/en/players/feb5d3ab/Dennis-Appiah"
2023,"Nantes","Ligue 1","Stredair Appuah","FRA","DF,MF","18",2004,0.7,2,1,0,2,0,0,0,NA,0,2,0,2,1,3,0,0,"https://fbref.com/en/players/42f0113f/Stredair-Appuah"
2023,"Nantes","Ligue 1","Ludovic Blas","FRA","MF,FW","24",1997,31.3,47,30,17,19,11,17,49,34.7,32,26,1,25,19,66,8,0,"https://fbref.com/en/players/6191093d/Ludovic-Blas"
2023,"Nantes","Ligue 1","Jean-Charles Castelletto","CMR","DF","27",1995,28.5,43,26,29,12,2,22,36,61.1,14,35,22,13,58,101,90,0,"https://fbref.com/en/players/e0f3a1f6/Jean-Charles-Castelletto"
2023,"Nantes","Ligue 1","Fabien Centonze","FRA","DF","26",1996,18.8,58,37,30,22,6,30,42,71.4,12,24,7,17,44,102,55,1,"https://fbref.com/en/players/3c6bbbab/Fabien-Centonze"
2023,"Nantes","Ligue 1","Pedro Chirivella","ESP","MF","25",1997,22.5,33,22,12,15,6,17,44,38.6,27,24,1,23,20,53,7,0,"https://fbref.com/en/players/68a26d51/Pedro-Chirivella"
2023,"Nantes","Ligue 1","Marcus Coco","FRA","FW,MF","26",1996,7.1,24,15,11,9,4,11,23,47.8,12,13,3,10,14,38,7,0,"https://fbref.com/en/players/3010aefb/Marcus-Coco"
2023,"Nantes","Ligue 1","Sébastien Corchia","FRA","DF","31",1990,8.7,16,6,10,2,4,11,22,50,11,9,3,6,14,30,21,0,"https://fbref.com/en/players/0e7ccfc4/Sebastien-Corchia"
2023,"Nantes","Ligue 1","Andy Delort","ALG","FW","30",1991,5.2,5,4,1,2,2,2,6,33.3,4,3,0,3,0,5,2,0,"https://fbref.com/en/players/d33c706e/Andy-Delort"
2023,"Nantes","Ligue 1","Rémy Descamps","FRA","GK","26",1996,1,0,0,0,0,0,0,0,NA,0,0,0,0,0,0,0,0,"https://fbref.com/en/players/477e50ce/Remy-Descamps"
2023,"Nantes","Ligue 1","Lohann Doucet","FRA","MF,FW","19",2002,1,3,0,2,0,1,3,4,75,1,2,0,2,2,5,4,0,"https://fbref.com/en/players/dff0c299/Lohann-Doucet"
2023,"Nantes","Ligue 1","Fábio","BRA","DF,MF","32",1990,2.5,4,2,1,2,1,4,6,66.7,2,2,0,2,3,7,11,0,"https://fbref.com/en/players/bc7b4580/Fabio"
2023,"Nantes","Ligue 1","Ignatius Ganago","CMR","FW,MF","23",1999,16.9,9,7,2,3,4,4,7,57.1,3,13,1,12,2,11,12,0,"https://fbref.com/en/players/23c63b7f/Ignatius-Ganago"
2023,"Nantes","Ligue 1","Andrei Girotto","BRA","DF,MF","30",1992,35,122,73,71,45,6,74,132,56.1,58,55,24,31,73,195,176,1,"https://fbref.com/en/players/3befc2b6/Andrei-Girotto"
2023,"Nantes","Ligue 1","Evann Guessand","FRA","FW,MF","21",2001,14,24,16,8,13,3,6,12,50,6,17,1,16,9,33,6,0,"https://fbref.com/en/players/b73f17f8/Evann-Guessand"
2023,"Nantes","Ligue 1","Jaouen Hadjam","ALG","DF","19",2003,8.9,27,21,13,9,5,16,25,64,9,10,3,7,12,39,12,0,"https://fbref.com/en/players/576817b7/Jaouen-Hadjam"
2023,"Nantes","Ligue 1","Abdoul Kader Bamba","FRA","FW,MF","28",1994,0.9,0,0,0,0,0,0,2,0,2,3,1,2,0,0,1,0,"https://fbref.com/en/players/32f3d97e/Abdoul-Kader-Bamba"
2023,"Nantes","Ligue 1","Alban Lafont","FRA","GK","23",1999,37,0,0,0,0,0,0,1,0,1,0,0,0,0,0,20,4,"https://fbref.com/en/players/4e7db402/Alban-Lafont"
2023,"Nantes","Ligue 1","Quentin Merlin","FRA","DF","20",2002,19.9,31,19,19,8,4,18,38,47.4,20,27,4,23,24,55,30,0,"https://fbref.com/en/players/0bfca6a1/Quentin-Merlin"
2023,"Nantes","Ligue 1","Mostafa Mohamed","EGY","FW","24",1997,21.5,18,13,5,7,6,9,20,45,11,23,1,22,10,28,33,0,"https://fbref.com/en/players/595e6f3e/Mostafa-Mohamed"
2023,"Nantes","Ligue 1","Florent Mollet","FRA","MF","30",1991,12.1,14,6,5,4,5,7,24,29.2,17,12,1,11,10,24,11,0,"https://fbref.com/en/players/7e82a78f/Florent-Mollet"
2023,"Nantes","Ligue 1","Samuel Moutoussamy","COD","MF","25",1996,26.7,64,34,27,28,9,26,76,34.2,50,23,2,21,24,88,15,0,"https://fbref.com/en/players/af0c835b/Samuel-Moutoussamy"
2023,"Nantes","Ligue 1","Nicolas Pallois","FRA","DF","34",1987,24.6,69,44,51,16,2,42,70,60,28,35,18,17,30,99,131,2,"https://fbref.com/en/players/779847d6/Nicolas-Pallois"
2023,"Nantes","Ligue 1","Moses Simon","NGA","FW,MF","27",1995,26.1,18,9,6,7,5,7,15,46.7,8,14,1,13,11,29,3,0,"https://fbref.com/en/players/5f3eaaf5/Moses-Simon"
2023,"Nantes","Ligue 1","Moussa Sissoko","FRA","MF","32",1989,21.3,26,16,16,7,3,12,18,66.7,6,22,5,17,16,42,17,0,"https://fbref.com/en/players/2acd49b9/Moussa-Sissoko"
2023,"Nantes","Ligue 1","Charles Traore","MLI","DF","30",1992,5.4,8,5,5,2,1,5,7,71.4,2,9,2,7,10,18,12,0,"https://fbref.com/en/players/de488e56/Charles-Traore"
2023,"Nantes","Ligue 1","João Victor","BRA","DF","24",1998,9.4,19,11,9,7,3,12,22,54.5,10,11,1,10,15,34,30,0,"https://fbref.com/en/players/d60cf08d/Joao-Victor"
2023,"Nantes","Ligue 1","Nathan Zeze","FRA","DF","17",2005,0.7,3,2,2,1,0,1,1,100,0,0,0,0,0,3,1,0,"https://fbref.com/en/players/fb4c5b6e/Nathan-Zeze"
2023,"Napoli","Serie A","Bartosz Bereszyński","POL","DF","30",1992,1.8,3,2,1,1,1,2,2,100,0,4,0,4,3,6,3,0,"https://fbref.com/en/players/61b3978f/Bartosz-Bereszynski"
2023,"Napoli","Serie A","Diego Demme","GER","MF","30",1991,1.6,1,0,1,0,0,0,4,0,4,2,0,2,0,1,1,0,"https://fbref.com/en/players/dc3fa3b5/Diego-Demme"
2023,"Napoli","Serie A","Giovanni Di Lorenzo","ITA","DF","28",1993,36.2,60,29,33,19,8,25,49,51,24,30,9,21,30,90,60,0,"https://fbref.com/en/players/230a2fac/Giovanni-Di-Lorenzo"
2023,"Napoli","Serie A","Elif Elmas","MKD","FW,MF","22",1999,18.1,24,13,8,12,4,11,23,47.8,12,18,2,16,11,35,5,0,"https://fbref.com/en/players/cf007308/Elif-Elmas"
2023,"Napoli","Serie A","Gianluca Gaetano","ITA","MF","22",2000,0.8,5,3,1,3,1,0,0,NA,0,1,0,1,1,6,0,0,"https://fbref.com/en/players/3b387cc7/Gianluca-Gaetano"
2023,"Napoli","Serie A","Pierluigi Gollini","ITA","GK","27",1995,4,0,0,0,0,0,0,0,NA,0,0,0,0,0,0,1,0,"https://fbref.com/en/players/f0f7f62f/Pierluigi-Gollini"
2023,"Napoli","Serie A","Juan Jesus","BRA","DF","31",1991,10.4,16,11,9,6,1,9,12,75,3,18,11,7,10,26,29,0,"https://fbref.com/en/players/79083382/Juan-Jesus"
2023,"Napoli","Serie A","Khvicha Kvaratskhelia","GEO","FW","21",2001,28,43,23,12,8,23,17,43,39.5,26,20,0,20,5,48,6,1,"https://fbref.com/en/players/dea88efd/Khvicha-Kvaratskhelia"
2023,"Napoli","Serie A","Stanislav Lobotka","SVK","MF","27",1994,34.5,83,44,35,35,13,43,73,58.9,30,29,7,22,23,106,16,0,"https://fbref.com/en/players/e1cbb531/Stanislav-Lobotka"
2023,"Napoli","Serie A","Hirving Lozano","MEX","FW","27",1995,17.8,24,13,10,6,8,9,21,42.9,12,31,0,31,15,39,6,0,"https://fbref.com/en/players/a69e4806/Hirving-Lozano"
2023,"Napoli","Serie A","Alex Meret","ITA","GK","25",1997,34,0,0,0,0,0,0,0,NA,0,0,0,0,0,0,6,1,"https://fbref.com/en/players/9413b19f/Alex-Meret"
2023,"Napoli","Serie A","Kim Min-jae","KOR","DF","25",1996,33.9,55,30,32,22,1,25,29,86.2,4,36,26,10,41,96,123,1,"https://fbref.com/en/players/e0f8151c/Kim-Min-jae"
2023,"Napoli","Serie A","Tanguy Ndombele","FRA","MF","25",1996,9,14,8,4,8,2,4,7,57.1,3,10,1,9,7,21,7,1,"https://fbref.com/en/players/5cdddffa/Tanguy-Ndombele"
2023,"Napoli","Serie A","Mathías Olivera","URU","DF","24",1997,18.3,39,23,16,16,7,22,43,51.2,21,28,2,26,22,61,26,0,"https://fbref.com/en/players/41c12f75/Mathias-Olivera"
2023,"Napoli","Serie A","Victor Osimhen","NGA","FW","23",1998,28.5,10,6,1,2,7,0,7,0,7,6,1,5,6,16,29,0,"https://fbref.com/en/players/8c90fd7a/Victor-Osimhen"
2023,"Napoli","Serie A","Adam Ounas","ALG","FW","25",1996,0.2,0,0,0,0,0,0,0,NA,0,0,0,0,1,1,0,0,"https://fbref.com/en/players/ed90babd/Adam-Ounas"
2023,"Napoli","Serie A","Matteo Politano","ITA","FW","28",1993,13,18,9,9,5,4,11,25,44,14,6,0,6,7,25,7,0,"https://fbref.com/en/players/5e861944/Matteo-Politano"
2023,"Napoli","Serie A","Giacomo Raspadori","ITA","FW,MF","22",2000,10.1,10,8,0,6,4,4,10,40,6,9,0,9,4,14,4,0,"https://fbref.com/en/players/6e058f06/Giacomo-Raspadori"
2023,"Napoli","Serie A","Amir Rrahmani","KVX","DF","28",1994,27.2,33,18,20,13,0,17,26,65.4,9,36,20,16,14,47,79,1,"https://fbref.com/en/players/4b3e1a38/Amir-Rrahmani"
2023,"Napoli","Serie A","Mário Rui","POR","DF","31",1991,19.4,34,22,17,13,4,20,41,48.8,21,17,4,13,15,49,24,1,"https://fbref.com/en/players/0b5a292a/Mario-Rui"
2023,"Napoli","Serie A","Giovanni Simeone","ARG","FW","27",1995,4.5,12,3,3,5,4,3,8,37.5,5,2,1,1,1,13,4,0,"https://fbref.com/en/players/343c0d52/Giovanni-Simeone"
2023,"Napoli","Serie A","Leo Skiri Østigård","NOR","DF","22",1999,4.7,4,1,3,1,0,1,1,100,0,3,3,0,6,10,18,1,"https://fbref.com/en/players/b35a7399/Leo-Skiri-Ostigard"
2023,"Napoli","Serie A","Andre-Frank Zambo Anguissa","CMR","MF","26",1995,33.9,53,32,16,29,8,16,64,25,48,50,4,46,49,102,25,0,"https://fbref.com/en/players/6bb2c084/Andre-Frank-Zambo-Anguissa"
2023,"Napoli","Serie A","Alessandro Zanoli","ITA","DF","21",2000,0.1,1,0,0,1,0,0,0,NA,0,0,0,0,0,1,1,0,"https://fbref.com/en/players/3b12b11f/Alessandro-Zanoli"
2023,"Napoli","Serie A","Karim Zedadka","FRA","FW","22",2000,0.2,0,0,0,0,0,0,0,NA,0,0,0,0,0,0,1,0,"https://fbref.com/en/players/2f45300d/Karim-Zedadka"
2023,"Napoli","Serie A","Alessio Zerbin","ITA","FW","23",1999,2.2,10,5,4,5,1,4,8,50,4,2,0,2,2,12,2,0,"https://fbref.com/en/players/d19ef4ef/Alessio-Zerbin"
2023,"Napoli","Serie A","Piotr Zieliński","POL","MF","28",1994,25.4,17,10,1,11,5,12,25,48,13,16,5,11,14,31,7,0,"https://fbref.com/en/players/a5296e55/Piotr-Zielinski"
2023,"Newcastle Utd","Premier League","Miguel Almirón","PAR","FW","28",1994,27.7,46,30,16,19,11,18,42,42.9,24,25,2,23,10,56,17,0,"https://fbref.com/en/players/862a1c15/Miguel-Almiron"
2023,"Newcastle Utd","Premier League","Elliot Anderson","SCO","MF,FW","19",2002,4.6,11,5,5,3,3,6,12,50,6,11,2,9,6,17,2,0,"https://fbref.com/en/players/de31038e/Elliot-Anderson"
2023,"Newcastle Utd","Premier League","Sven Botman","NED","DF","22",2000,34.7,38,24,31,7,0,22,28,78.6,6,44,24,20,34,72,126,2,"https://fbref.com/en/players/ccce7025/Sven-Botman"
2023,"Newcastle Utd","Premier League","Dan Burn","ENG","DF","30",1992,34.6,60,38,29,23,8,34,67,50.7,33,42,16,26,32,92,120,2,"https://fbref.com/en/players/b2d31e83/Dan-Burn"
2023,"Newcastle Utd","Premier League","Martin Dúbravka","SVK","GK","33",1989,1.7,0,0,0,0,0,0,1,0,1,0,0,0,0,0,1,0,"https://fbref.com/en/players/3a949a25/Martin-Dubravka"
2023,"Newcastle Utd","Premier League","Ryan Fraser","SCO","FW","28",1994,3.5,2,2,0,0,2,2,5,40,3,3,1,2,0,2,3,0,"https://fbref.com/en/players/d56543a0/Ryan-Fraser"
2023,"Newcastle Utd","Premier League","Anthony Gordon","ENG","FW,MF","21",2001,5.4,14,12,5,7,2,9,20,45,11,9,1,8,2,16,1,1,"https://fbref.com/en/players/2bd83368/Anthony-Gordon"
2023,"Newcastle Utd","Premier League","Bruno Guimarães","BRA","MF","24",1997,30.3,78,40,27,46,5,38,65,58.5,27,28,4,24,36,114,22,1,"https://fbref.com/en/players/82518f62/Bruno-Guimaraes"
2023,"Newcastle Utd","Premier League","Alexander Isak","SWE","FW","22",1999,16.9,18,8,4,7,7,10,28,35.7,18,21,2,19,4,22,8,0,"https://fbref.com/en/players/8e92be30/Alexander-Isak"
2023,"Newcastle Utd","Premier League","Joelinton","BRA","MF,FW","25",1996,29.6,70,49,36,26,8,26,62,41.9,36,52,7,45,48,118,39,0,"https://fbref.com/en/players/c17bfb65/Joelinton"
2023,"Newcastle Utd","Premier League","Emil Krafth","SWE","DF","27",1994,0,0,0,0,0,0,0,0,NA,0,0,0,0,0,0,0,0,"https://fbref.com/en/players/77cf6852/Emil-Krafth"
2023,"Newcastle Utd","Premier League","Jamaal Lascelles","ENG","DF","28",1993,2.4,1,0,1,0,0,1,1,100,0,3,2,1,0,1,17,0,"https://fbref.com/en/players/450ab6fc/Jamaal-Lascelles"
2023,"Newcastle Utd","Premier League","Jamal Lewis","NIR","DF,FW","24",1998,0.1,0,0,0,0,0,0,0,NA,0,0,0,0,0,0,0,0,"https://fbref.com/en/players/efb9215a/Jamal-Lewis"
2023,"Newcastle Utd","Premier League","Sean Longstaff","ENG","MF","24",1997,28,42,21,16,20,6,20,52,38.5,32,35,8,27,16,58,23,0,"https://fbref.com/en/players/a2b105e0/Sean-Longstaff"
2023,"Newcastle Utd","Premier League","Javier Manquillo","ESP","DF","28",1994,0.4,3,2,2,1,0,2,2,100,0,1,0,1,1,4,1,0,"https://fbref.com/en/players/758dd7f0/Javier-Manquillo"
2023,"Newcastle Utd","Premier League","Lewis Miley","ENG","MF","16",2006,0.2,0,0,0,0,0,0,0,NA,0,1,0,1,0,0,0,0,"https://fbref.com/en/players/2c6835e5/Lewis-Miley"
2023,"Newcastle Utd","Premier League","Jacob Murphy","ENG","FW","27",1995,13.9,15,7,3,8,4,8,20,40,12,17,0,17,7,22,3,0,"https://fbref.com/en/players/de112b84/Jacob-Murphy"
2023,"Newcastle Utd","Premier League","Nick Pope","ENG","GK","30",1992,36.2,1,0,1,0,0,1,3,33.3,2,0,0,0,0,1,27,2,"https://fbref.com/en/players/4b40d9ca/Nick-Pope"
2023,"Newcastle Utd","Premier League","Matt Ritchie","SCO","FW,MF","32",1989,0.4,1,1,0,1,0,1,3,33.3,2,0,0,0,1,2,0,0,"https://fbref.com/en/players/71ef519e/Matt-Ritchie"
2023,"Newcastle Utd","Premier League","Allan Saint-Maximin","FRA","FW","25",1997,12.4,10,3,3,6,1,2,11,18.2,9,4,0,4,5,15,2,0,"https://fbref.com/en/players/2b16cb1a/Allan-Saint-Maximin"
2023,"Newcastle Utd","Premier League","Fabian Schär","SUI","DF","30",1991,35.6,47,22,31,13,3,24,39,61.5,15,34,19,15,52,99,139,0,"https://fbref.com/en/players/c8aa95da/Fabian-Schar"
2023,"Newcastle Utd","Premier League","Jonjo Shelvey","ENG","MF","30",1992,0.4,1,0,1,0,0,0,1,0,1,1,0,1,0,1,0,0,"https://fbref.com/en/players/3727dd3c/Jonjo-Shelvey"
2023,"Newcastle Utd","Premier League","Matt Targett","ENG","DF","26",1995,6.8,13,10,8,3,2,9,24,37.5,15,8,3,5,9,22,16,0,"https://fbref.com/en/players/e514ab62/Matt-Targett"
2023,"Newcastle Utd","Premier League","Kieran Trippier","ENG","DF","31",1990,37.1,71,49,36,27,8,46,90,51.1,44,45,15,30,43,114,84,2,"https://fbref.com/en/players/21512407/Kieran-Trippier"
2023,"Newcastle Utd","Premier League","Joe Willock","ENG","MF","22",1999,28.4,51,30,13,26,12,25,58,43.1,33,54,8,46,25,76,17,0,"https://fbref.com/en/players/a3b03921/Joe-Willock"
2023,"Newcastle Utd","Premier League","Callum Wilson","ENG","FW","30",1992,20.9,9,3,0,8,1,0,3,0,3,8,0,8,1,10,5,0,"https://fbref.com/en/players/c596fcb0/Callum-Wilson"
2023,"Newcastle Utd","Premier League","Chris Wood","NZL","FW","30",1991,5,5,4,0,3,2,3,5,60,2,2,2,0,1,6,7,0,"https://fbref.com/en/players/4e9a0555/Chris-Wood"
2023,"Nice","Ligue 1","Ayoub Amraoui","MAR","DF,FW","18",2004,3.3,6,5,3,3,0,2,5,40,3,1,0,1,4,10,4,0,"https://fbref.com/en/players/ae11ba3d/Ayoub-Amraoui"
2023,"Nice","Ligue 1","Youcef Atal","ALG","DF,MF","26",1996,8.7,38,22,18,15,5,23,32,71.9,9,9,0,9,14,52,13,0,"https://fbref.com/en/players/6a827d8e/Youcef-Atal"
2023,"Nice","Ligue 1","Melvin Bard","FRA","DF","21",2000,27.3,96,60,61,29,6,59,89,66.3,30,35,4,31,64,160,40,1,"https://fbref.com/en/players/1ddbc7ca/Melvin-Bard"
2023,"Nice","Ligue 1","Ross Barkley","ENG","MF,FW","28",1993,10.7,16,9,7,4,5,7,13,53.8,6,7,2,5,8,24,6,0,"https://fbref.com/en/players/3a24769f/Ross-Barkley"
2023,"Nice","Ligue 1","Alexis Beka Beka","FRA","MF,DF","21",2001,6.1,16,5,6,9,1,4,15,26.7,11,9,1,8,12,28,6,0,"https://fbref.com/en/players/4a5e83ad/Alexis-Beka-Beka"
2023,"Nice","Ligue 1","Reda Belahyane","FRA","MF","18",2004,2,8,6,5,3,0,3,5,60,2,5,1,4,2,10,0,0,"https://fbref.com/en/players/705a1642/Reda-Belahyane"
2023,"Nice","Ligue 1","Badredine Bouanani","ALG","FW,MF","17",2004,9.6,13,9,2,7,4,7,14,50,7,4,0,4,1,14,2,0,"https://fbref.com/en/players/0400dd2f/Badredine-Bouanani"
2023,"Nice","Ligue 1","Hicham Boudaoui","ALG","MF","22",1999,20.8,67,32,31,30,6,35,53,66,18,34,5,29,36,103,16,0,"https://fbref.com/en/players/f9d5908e/Hicham-Boudaoui"
2023,"Nice","Ligue 1","Bilal Brahimi","ALG","FW,MF","22",2000,8.9,8,5,2,5,1,1,7,14.3,6,4,0,4,4,12,0,0,"https://fbref.com/en/players/02bcaf8e/Bilal-Brahimi"
2023,"Nice","Ligue 1","Joe Bryan","ENG","MF,DF","28",1993,2,5,4,3,2,0,4,4,100,0,2,0,2,1,6,1,0,"https://fbref.com/en/players/af69e7f0/Joe-Bryan"
2023,"Nice","Ligue 1","Marcin Bułka","POL","GK","22",1999,2,0,0,0,0,0,0,1,0,1,0,0,0,1,1,0,0,"https://fbref.com/en/players/db87a2c4/Marcin-Bulka"
2023,"Nice","Ligue 1","Alexis Claude-Maurice","FRA","FW","24",1998,0.7,3,2,2,1,0,3,3,100,0,0,0,0,2,5,1,0,"https://fbref.com/en/players/741418c3/Alexis-Claude-Maurice"
2023,"Nice","Ligue 1","Andréa Dacourt","FRA","MF","17",2005,0,0,0,0,0,0,0,0,NA,0,0,0,0,0,0,0,0,"https://fbref.com/en/players/4a021593/Andrea-Dacourt"
2023,"Nice","Ligue 1","Flavius Daniliuc","AUT","DF","21",2001,1,2,0,2,0,0,1,1,100,0,4,1,3,0,2,1,0,"https://fbref.com/en/players/7ef972c3/Flavius-Daniliuc"
2023,"Nice","Ligue 1","Dante","BRA","DF","38",1983,36.7,70,40,45,21,4,36,59,61,23,52,31,21,47,117,125,2,"https://fbref.com/en/players/fd2bc67d/Dante"
2023,"Nice","Ligue 1","Andy Delort","ALG","FW","30",1991,8.7,2,0,1,1,0,1,2,50,1,0,0,0,1,3,7,0,"https://fbref.com/en/players/d33c706e/Andy-Delort"
2023,"Nice","Ligue 1","Sofiane Diop","FRA","MF,FW","22",2000,13.6,23,11,12,6,5,7,20,35,13,14,2,12,16,39,5,0,"https://fbref.com/en/players/19053e31/Sofiane-Diop"
2023,"Nice","Ligue 1","Amine Gouiri","FRA","FW,MF","22",2000,2.5,1,1,1,0,0,0,1,0,1,1,0,1,0,1,3,0,"https://fbref.com/en/players/aad56ca3/Amine-Gouiri"
2023,"Nice","Ligue 1","Rareş Ilie","ROU","MF,FW","19",2003,1.6,3,3,0,1,2,2,4,50,2,2,0,2,1,4,1,0,"https://fbref.com/en/players/c9f49454/Rares-Ilie"
2023,"Nice","Ligue 1","Gaëtan Laborde","FRA","FW","28",1994,27.8,45,25,13,17,15,18,40,45,22,27,2,25,9,54,13,0,"https://fbref.com/en/players/7cdda3bf/Gaetan-Laborde"
2023,"Nice","Ligue 1","Mario Lemina","GAB","MF,DF","28",1993,9.3,32,21,11,14,7,12,18,66.7,6,13,5,8,11,43,20,0,"https://fbref.com/en/players/2b471f99/Mario-Lemina"
2023,"Nice","Ligue 1","Jordan Lotomba","SUI","DF","23",1998,27.3,65,38,33,24,8,31,48,64.6,17,38,11,27,32,97,53,0,"https://fbref.com/en/players/fc4cf6a7/Jordan-Lotomba"
2023,"Nice","Ligue 1","Antoine Mendy","FRA","DF","18",2004,5.8,22,13,16,5,1,9,15,60,6,6,1,5,2,24,16,0,"https://fbref.com/en/players/3322e296/Antoine-Mendy"
2023,"Nice","Ligue 1","Terem Moffi","NGA","FW","23",1999,14.8,12,6,0,6,6,2,12,16.7,10,3,0,3,2,14,5,0,"https://fbref.com/en/players/065dc209/Terem-Moffi"
2023,"Nice","Ligue 1","Youssouf Ndayishimiye","BDI","MF,DF","23",1998,6.3,13,9,8,5,0,6,11,54.5,5,8,5,3,12,25,22,1,"https://fbref.com/en/players/65c55288/Youssouf-Ndayishimiye"
2023,"Nice","Ligue 1","Nicolas Pépé","CIV","FW,MF","27",1995,16.6,25,13,14,5,6,11,25,44,14,17,0,17,3,28,1,0,"https://fbref.com/en/players/57e3f0c7/Nicolas-Pepe"
2023,"Nice","Ligue 1","Aaron Ramsey","WAL","MF","31",1990,17.6,47,25,18,19,10,16,39,41,23,25,4,21,17,64,18,1,"https://fbref.com/en/players/ef619b0b/Aaron-Ramsey"
2023,"Nice","Ligue 1","Pablo Rosario","NED","MF,DF","25",1997,19.6,46,26,22,20,4,18,34,52.9,16,15,5,10,23,69,32,1,"https://fbref.com/en/players/1a6b7ea4/Pablo-Rosario"
2023,"Nice","Ligue 1","Kasper Schmeichel","DEN","GK","35",1986,36,1,0,1,0,0,1,4,25,3,1,0,1,1,2,11,1,"https://fbref.com/en/players/53af52f3/Kasper-Schmeichel"
2023,"Nice","Ligue 1","Calvin Stengs","NED","FW","23",1998,2.4,2,2,1,0,1,1,2,50,1,0,0,0,0,2,0,0,"https://fbref.com/en/players/8f7e6783/Calvin-Stengs"
2023,"Nice","Ligue 1","Khéphren Thuram","FRA","MF","21",2001,28.3,51,25,22,23,6,19,43,44.2,24,33,13,20,38,89,34,0,"https://fbref.com/en/players/7d9397f8/Khephren-Thuram"
2023,"Nice","Ligue 1","Jean-Clair Todibo","FRA","DF","22",1999,31.9,76,48,54,19,3,41,56,73.2,15,41,19,22,41,117,110,2,"https://fbref.com/en/players/88f130ed/Jean-Clair-Todibo"
2023,"Nice","Ligue 1","Théo Trinker","FRA","MF","21",2001,0,0,0,0,0,0,0,0,NA,0,0,0,0,0,0,0,0,"https://fbref.com/en/players/7a3f8712/Theo-Trinker"
2023,"Nice","Ligue 1","Mattia Viti","ITA","DF","20",2002,7,4,2,1,1,2,2,5,40,3,9,3,6,8,12,22,0,"https://fbref.com/en/players/75438a9a/Mattia-Viti"
2023,"Nott'ham Forest","Premier League","Serge Aurier","CIV","DF","29",1992,21.6,64,41,41,18,5,23,33,69.7,10,34,11,23,29,93,75,0,"https://fbref.com/en/players/5c2b4f07/Serge-Aurier"
2023,"Nott'ham Forest","Premier League","Taiwo Awoniyi","NGA","FW","24",1997,15.6,17,10,2,10,5,6,10,60,4,18,4,14,4,21,20,0,"https://fbref.com/en/players/e5478b87/Taiwo-Awoniyi"
2023,"Nott'ham Forest","Premier League","André Ayew","GHA","FW,MF","32",1989,3.5,5,3,0,4,1,2,4,50,2,6,1,5,0,5,7,0,"https://fbref.com/en/players/5dbefa9d/Andre-Ayew"
2023,"Nott'ham Forest","Premier League","Giulian Biancone","FRA","DF","22",2000,0.2,2,1,2,0,0,1,1,100,0,0,0,0,1,3,0,0,"https://fbref.com/en/players/de40e38c/Giulian-Biancone"
2023,"Nott'ham Forest","Premier League","Willy Boly","CIV","DF","31",1991,7.6,13,6,8,3,2,8,13,61.5,5,13,4,9,12,25,45,0,"https://fbref.com/en/players/a4ac4b8f/Willy-Boly"
2023,"Nott'ham Forest","Premier League","Cafú","POR","MF","29",1993,0.1,0,0,0,0,0,0,0,NA,0,0,0,0,0,0,1,0,"https://fbref.com/en/players/85322440/Cafu"
2023,"Nott'ham Forest","Premier League","Jack Colback","ENG","MF","32",1989,5.5,18,13,12,6,0,5,8,62.5,3,3,0,3,3,21,9,0,"https://fbref.com/en/players/963a9201/Jack-Colback"
2023,"Nott'ham Forest","Premier League","Steve Cook","ENG","DF","31",1991,10.6,8,4,4,4,0,5,7,71.4,2,16,11,5,12,20,51,0,"https://fbref.com/en/players/3e5e4e63/Steve-Cook"
2023,"Nott'ham Forest","Premier League","Danilo","BRA","MF","21",2001,10.8,18,7,7,9,2,6,25,24,19,26,6,20,9,27,19,0,"https://fbref.com/en/players/a816dbfb/Danilo"
2023,"Nott'ham Forest","Premier League","Emmanuel Dennis","NGA","FW,MF","24",1997,8,17,11,5,5,7,8,17,47.1,9,13,1,12,2,19,6,0,"https://fbref.com/en/players/2c44a35d/Emmanuel-Dennis"
2023,"Nott'ham Forest","Premier League","Felipe","BRA","DF","33",1989,15.8,42,23,29,13,0,24,41,58.5,17,34,13,21,36,78,90,0,"https://fbref.com/en/players/51a3c4c8/Felipe"
2023,"Nott'ham Forest","Premier League","Remo Freuler","SUI","MF","30",1992,24,43,23,23,15,5,19,43,44.2,24,36,9,27,29,72,45,0,"https://fbref.com/en/players/98d2c2c4/Remo-Freuler"
2023,"Nott'ham Forest","Premier League","Morgan Gibbs-White","ENG","MF,FW","22",2000,33,26,14,7,7,12,11,32,34.4,21,23,4,19,14,40,15,0,"https://fbref.com/en/players/32f60ed8/Morgan-Gibbs-White"
2023,"Nott'ham Forest","Premier League","Dean Henderson","ENG","GK","25",1997,18,0,0,0,0,0,0,0,NA,0,0,0,0,0,0,12,1,"https://fbref.com/en/players/e5a76dfe/Dean-Henderson"
2023,"Nott'ham Forest","Premier League","Wayne Hennessey","WAL","GK","35",1987,3,1,0,1,0,0,1,1,100,0,0,0,0,0,1,2,0,"https://fbref.com/en/players/76eca7e2/Wayne-Hennessey"
2023,"Nott'ham Forest","Premier League","Brennan Johnson","WAL","FW,MF","21",2001,32.6,34,20,18,8,8,8,28,28.6,20,30,1,29,5,39,7,1,"https://fbref.com/en/players/0cd31129/Brennan-Johnson"
2023,"Nott'ham Forest","Premier League","Cheikhou Kouyaté","SEN","MF","32",1989,9.8,29,21,18,8,3,9,13,69.2,4,14,2,12,10,39,24,0,"https://fbref.com/en/players/8d3c902d/Cheikhou-Kouyate"
2023,"Nott'ham Forest","Premier League","Jesse Lingard","ENG","FW,MF","29",1992,10.3,4,4,2,2,0,1,7,14.3,6,11,0,11,5,9,4,0,"https://fbref.com/en/players/810e3c74/Jesse-Lingard"
2023,"Nott'ham Forest","Premier League","Renan Lodi","BRA","DF","24",1998,24.6,52,39,38,8,6,33,66,50,33,25,6,19,33,85,74,0,"https://fbref.com/en/players/ed9f7cfe/Renan-Lodi"
2023,"Nott'ham Forest","Premier League","Orel Mangala","BEL","MF","24",1998,17.2,28,20,16,10,2,12,29,41.4,17,21,7,14,23,51,15,0,"https://fbref.com/en/players/a572e291/Orel-Mangala"
2023,"Nott'ham Forest","Premier League","Scott McKenna","SCO","DF","25",1996,17.5,12,7,7,3,2,6,10,60,4,20,14,6,12,24,85,1,"https://fbref.com/en/players/4e5a4cbc/Scott-McKenna"
2023,"Nott'ham Forest","Premier League","Alexander Mighten","ENG","FW","20",2002,0.1,0,0,0,0,0,0,1,0,1,0,0,0,0,0,0,0,"https://fbref.com/en/players/10ec4169/Alexander-Mighten"
2023,"Nott'ham Forest","Premier League","Keylor Navas","CRC","GK","35",1986,17,0,0,0,0,0,0,0,NA,0,0,0,0,1,1,11,1,"https://fbref.com/en/players/ecada4fc/Keylor-Navas"
2023,"Nott'ham Forest","Premier League","Moussa Niakhate","SEN","DF","26",1996,12.9,18,9,15,3,0,11,22,50,11,18,8,10,19,37,60,0,"https://fbref.com/en/players/00242715/Moussa-Niakhate"
2023,"Nott'ham Forest","Premier League","Lewis O'Brien","ENG","MF","23",1998,6.5,16,9,4,11,1,6,12,50,6,13,2,11,5,21,9,0,"https://fbref.com/en/players/089667a5/Lewis-OBrien"
2023,"Nott'ham Forest","Premier League","Gustavo Scarpa","BRA","MF,FW","28",1994,2,5,2,3,1,1,2,5,40,3,4,0,4,0,5,3,0,"https://fbref.com/en/players/2964fd20/Gustavo-Scarpa"
2023,"Nott'ham Forest","Premier League","Jonjo Shelvey","ENG","MF","30",1992,6,2,1,0,1,1,1,9,11.1,8,7,2,5,5,7,10,1,"https://fbref.com/en/players/3727dd3c/Jonjo-Shelvey"
2023,"Nott'ham Forest","Premier League","Sam Surridge","ENG","FW","24",1998,3.6,5,0,1,3,1,1,4,25,3,5,2,3,0,5,7,0,"https://fbref.com/en/players/b017b770/Sam-Surridge"
2023,"Nott'ham Forest","Premier League","Harry Toffolo","ENG","DF","26",1995,10.4,17,8,10,4,3,10,14,71.4,4,16,8,8,10,27,33,0,"https://fbref.com/en/players/a105d46a/Harry-Toffolo"
2023,"Nott'ham Forest","Premier League","Neco Williams","WAL","DF","21",2001,20.9,72,47,49,17,6,38,71,53.5,33,33,8,25,33,105,48,0,"https://fbref.com/en/players/dd323728/Neco-Williams"
2023,"Nott'ham Forest","Premier League","Chris Wood","NZL","FW","30",1991,4.1,0,0,0,0,0,0,1,0,1,2,1,1,1,1,2,0,"https://fbref.com/en/players/4e9a0555/Chris-Wood"
2023,"Nott'ham Forest","Premier League","Joe Worrall","ENG","DF","25",1997,24.7,53,25,39,12,2,25,35,71.4,10,33,23,10,26,79,111,1,"https://fbref.com/en/players/a5212312/Joe-Worrall"
2023,"Nott'ham Forest","Premier League","Ryan Yates","ENG","MF","24",1997,20.4,38,19,19,16,3,14,22,63.6,8,26,8,18,10,48,44,0,"https://fbref.com/en/players/c1fe2a48/Ryan-Yates"
2023,"Osasuna","La Liga","Ezequiel Ávila","ARG","FW,MF","28",1994,19,8,5,2,4,2,6,23,26.1,17,12,1,11,8,16,16,0,"https://fbref.com/en/players/253a06b9/Ezequiel-Avila"
2023,"Osasuna","La Liga","Kike Barja","ESP","FW,MF","25",1997,14.6,15,9,6,5,4,8,24,33.3,16,7,0,7,4,19,3,0,"https://fbref.com/en/players/aad53e64/Kike-Barja"
2023,"Osasuna","La Liga","Iker Benito","ESP","FW,MF","19",2002,2,4,3,0,3,1,2,4,50,2,0,0,0,2,6,4,0,"https://fbref.com/en/players/50cbc806/Iker-Benito"
2023,"Osasuna","La Liga","Darko Brašanac","SRB","MF","30",1992,11.6,29,20,12,10,7,12,23,52.2,11,14,2,12,12,41,9,0,"https://fbref.com/en/players/4accb7e0/Darko-Brasanac"
2023,"Osasuna","La Liga","Ante Budimir","CRO","FW","31",1991,20,19,9,0,12,7,2,10,20,8,10,0,10,5,24,19,0,"https://fbref.com/en/players/8f3565b3/Ante-Budimir"
2023,"Osasuna","La Liga","Juan Cruz Armada","ESP","DF","30",1992,22.9,24,14,17,4,3,13,23,56.5,10,21,8,13,13,37,58,0,"https://fbref.com/en/players/a56da3ba/Juan-Cruz-Armada"
2023,"Osasuna","La Liga","Abdessamad Ezzalzouli","MAR","FW,MF","20",2001,16.7,29,19,13,12,4,13,23,56.5,10,20,0,20,4,33,6,0,"https://fbref.com/en/players/bed68338/Abdessamad-Ezzalzouli"
2023,"Osasuna","La Liga","Aitor Fernández","ESP","GK","31",1991,21,1,1,1,0,0,0,1,0,1,0,0,0,2,3,17,0,"https://fbref.com/en/players/a01c3d54/Aitor-Fernandez"
2023,"Osasuna","La Liga","David García","ESP","DF","28",1994,29.8,34,20,22,12,0,19,22,86.4,3,28,13,15,45,79,151,0,"https://fbref.com/en/players/3e42f707/David-Garcia"
2023,"Osasuna","La Liga","Rubén García","ESP","FW,MF","29",1993,12.9,20,11,12,4,4,7,24,29.2,17,14,1,13,12,32,13,0,"https://fbref.com/en/players/5c96b017/Ruben-Garcia"
2023,"Osasuna","La Liga","Unai García","ESP","DF","30",1992,19,23,13,13,8,2,12,17,70.6,5,23,14,9,19,42,60,2,"https://fbref.com/en/players/4a633cfe/Unai-Garcia"
2023,"Osasuna","La Liga","Moi Gómez","ESP","MF,FW","28",1994,27.3,26,17,9,14,3,15,32,46.9,17,15,3,12,10,36,5,1,"https://fbref.com/en/players/5a626448/Moi-Gomez"
2023,"Osasuna","La Liga","Aridane Hernández","ESP","DF","33",1989,19.9,21,15,17,4,0,12,25,48,13,34,21,13,28,49,96,1,"https://fbref.com/en/players/132ac341/Aridane-Hernandez"
2023,"Osasuna","La Liga","Jorge Herrando","ESP","DF","21",2001,0.3,0,0,0,0,0,0,0,NA,0,1,0,1,0,0,3,0,"https://fbref.com/en/players/e19c989c/Jorge-Herrando"
2023,"Osasuna","La Liga","Sergio Herrera","ESP","GK","29",1993,17,2,0,2,0,0,2,2,100,0,1,0,1,1,3,6,2,"https://fbref.com/en/players/a4995f48/Sergio-Herrera"
2023,"Osasuna","La Liga","Pablo Ibáñez","ESP","MF","23",1998,11.8,29,13,7,17,5,12,35,34.3,23,19,2,17,8,37,24,0,"https://fbref.com/en/players/3701906c/Pablo-Ibanez"
2023,"Osasuna","La Liga","Kike","ESP","FW","32",1989,11.3,6,3,0,4,2,2,5,40,3,6,1,5,1,7,13,0,"https://fbref.com/en/players/e897d8ba/Kike"
2023,"Osasuna","La Liga","Jon Moncayola","ESP","MF,DF","24",1998,27.2,55,39,24,22,9,30,76,39.5,46,37,5,32,17,72,32,2,"https://fbref.com/en/players/9939e168/Jon-Moncayola"
2023,"Osasuna","La Liga","Diego Moreno","ESP","DF","21",2001,7.1,4,4,2,2,0,3,8,37.5,5,7,4,3,5,9,21,0,"https://fbref.com/en/players/a21417e2/Diego-Moreno"
2023,"Osasuna","La Liga","Iker Muñoz","ESP","MF","19",2002,2.8,1,0,0,1,0,0,3,0,3,2,1,1,3,4,8,0,"https://fbref.com/en/players/175ece4c/Iker-Munoz"
2023,"Osasuna","La Liga","Aimar Oroz","ESP","MF,FW","20",2001,22.4,26,14,8,10,8,8,30,26.7,22,24,1,23,24,50,6,0,"https://fbref.com/en/players/7c363088/Aimar-Oroz"
2023,"Osasuna","La Liga","Rubén Peña","ESP","DF,MF","31",1991,14.2,32,18,10,18,4,20,41,48.8,21,23,8,15,17,49,31,0,"https://fbref.com/en/players/1f079188/Ruben-Pena"
2023,"Osasuna","La Liga","Manu Sánchez","ESP","DF","21",2000,23.6,51,35,35,9,7,33,63,52.4,30,33,5,28,14,65,51,0,"https://fbref.com/en/players/ffacd3d5/Manu-Sanchez"
2023,"Osasuna","La Liga","Roberto Torres","ESP","FW,MF","33",1989,0.1,0,0,0,0,0,0,0,NA,0,0,0,0,0,0,0,0,"https://fbref.com/en/players/d733aa38/Roberto-Torres"
2023,"Osasuna","La Liga","Lucas Torró","ESP","MF","28",1994,27.5,48,32,28,15,5,18,42,42.9,24,24,3,21,42,90,64,1,"https://fbref.com/en/players/0e4fef6e/Lucas-Torro"
2023,"Osasuna","La Liga","Nacho Vidal","ESP","DF","27",1995,13.9,27,14,16,6,5,17,32,53.1,15,17,4,13,19,46,33,1,"https://fbref.com/en/players/3a9c4b7b/Nacho-Vidal"
2023,"Paris S-G","Ligue 1","Juan Bernat","ESP","DF,MF","29",1993,18.3,32,16,18,9,5,21,39,53.8,18,11,2,9,9,41,22,1,"https://fbref.com/en/players/433dc9a2/Juan-Bernat"
2023,"Paris S-G","Ligue 1","El Chadaille Bitshiabu","FRA","DF","17",2005,6.5,10,7,7,2,1,3,12,25,9,9,7,2,9,19,13,3,"https://fbref.com/en/players/2180c761/El-Chadaille-Bitshiabu"
2023,"Paris S-G","Ligue 1","Gianluigi Donnarumma","ITA","GK","23",1999,37.9,1,0,1,0,0,1,2,50,1,0,0,0,0,1,12,4,"https://fbref.com/en/players/08f5afaa/Gianluigi-Donnarumma"
2023,"Paris S-G","Ligue 1","Hugo Ekitike","FRA","FW","20",2002,12.8,12,4,1,10,1,4,12,33.3,8,12,0,12,9,21,3,0,"https://fbref.com/en/players/5b92d896/Hugo-Ekitike"
2023,"Paris S-G","Ligue 1","Ismaël Gharbi","ESP","MF,FW","18",2004,0.6,0,0,0,0,0,0,2,0,2,2,0,2,3,3,0,0,"https://fbref.com/en/players/5b3cfa12/Ismael-Gharbi"
2023,"Paris S-G","Ligue 1","Achraf Hakimi","MAR","DF,MF","23",1998,22.8,54,34,19,20,15,31,59,52.5,28,34,2,32,16,70,19,0,"https://fbref.com/en/players/e42d61c7/Achraf-Hakimi"
2023,"Paris S-G","Ligue 1","Ilyes Housni","FRA","FW","17",2005,0.1,1,1,1,0,0,1,1,100,0,0,0,0,0,1,0,0,"https://fbref.com/en/players/910e3cad/Ilyes-Housni"
2023,"Paris S-G","Ligue 1","Presnel Kimpembe","FRA","DF","26",1995,8.1,17,8,9,6,2,9,13,69.2,4,12,7,5,13,30,9,1,"https://fbref.com/en/players/aef6e670/Presnel-Kimpembe"
2023,"Paris S-G","Ligue 1","Alexandre Letellier","FRA","GK","31",1990,0.1,0,0,0,0,0,0,0,NA,0,0,0,0,0,0,0,0,"https://fbref.com/en/players/96fcd380/Alexandre-Letellier"
2023,"Paris S-G","Ligue 1","Marquinhos","BRA","DF","28",1994,30.2,33,25,18,12,3,18,26,69.2,8,43,27,16,23,56,83,2,"https://fbref.com/en/players/d5f2f82b/Marquinhos"
2023,"Paris S-G","Ligue 1","Kylian Mbappé","FRA","FW","23",1998,31.3,10,4,0,5,5,5,16,31.3,11,5,0,5,5,15,6,0,"https://fbref.com/en/players/42fd9c7f/Kylian-Mbappe"
2023,"Paris S-G","Ligue 1","Nuno Mendes","POR","DF","20",2002,17.2,45,30,29,12,4,30,41,73.2,11,19,3,16,17,62,18,0,"https://fbref.com/en/players/f20e4cc9/Nuno-Mendes"
2023,"Paris S-G","Ligue 1","Lionel Messi","ARG","FW,MF","35",1987,31.5,26,18,1,13,12,11,27,40.7,16,11,0,11,2,28,0,0,"https://fbref.com/en/players/d70ce98e/Lionel-Messi"
2023,"Paris S-G","Ligue 1","Nordi Mukiele","FRA","DF","24",1997,12.6,31,23,16,6,9,19,29,65.5,10,22,9,13,14,45,16,0,"https://fbref.com/en/players/ac73ec79/Nordi-Mukiele"
2023,"Paris S-G","Ligue 1","Neymar","BRA","MF,FW","30",1992,17.2,22,14,6,9,7,9,19,47.4,10,7,1,6,4,26,1,1,"https://fbref.com/en/players/69384e5d/Neymar"
2023,"Paris S-G","Ligue 1","Leandro Paredes","ARG","MF","28",1994,0.6,1,1,1,0,0,1,1,100,0,2,1,1,1,2,0,0,"https://fbref.com/en/players/dff153a4/Leandro-Paredes"
2023,"Paris S-G","Ligue 1","Timothee Pembele","FRA","DF","19",2002,2.9,5,5,3,1,1,2,4,50,2,2,0,2,4,9,2,0,"https://fbref.com/en/players/f8ce97ca/Timothee-Pembele"
2023,"Paris S-G","Ligue 1","Danilo Pereira","POR","DF,MF","30",1991,26.8,32,17,15,14,3,19,26,73.1,7,26,19,7,36,68,59,1,"https://fbref.com/en/players/8fd9996f/Danilo-Pereira"
2023,"Paris S-G","Ligue 1","Sergio Ramos","ESP","DF","36",1986,30,34,26,14,18,2,23,44,52.3,21,29,13,16,34,68,93,3,"https://fbref.com/en/players/08511d65/Sergio-Ramos"
2023,"Paris S-G","Ligue 1","Fabián Ruiz Peña","ESP","MF","26",1996,21,62,28,25,30,7,43,79,54.4,36,24,1,23,18,80,23,1,"https://fbref.com/en/players/c0c7ff58/Fabian-Ruiz-Pena"
2023,"Paris S-G","Ligue 1","Renato Sanches","POR","MF","24",1997,8,8,1,1,3,4,5,14,35.7,9,13,3,10,9,17,4,0,"https://fbref.com/en/players/032f894e/Renato-Sanches"
2023,"Paris S-G","Ligue 1","Pablo Sarabia","ESP","FW,MF","30",1992,4.1,5,4,2,2,1,1,7,14.3,6,3,0,3,2,7,0,0,"https://fbref.com/en/players/9744ff80/Pablo-Sarabia"
2023,"Paris S-G","Ligue 1","Carlos Soler","ESP","MF","25",1997,13.2,20,12,6,10,4,10,19,52.6,9,12,4,8,4,24,6,0,"https://fbref.com/en/players/fed17f5a/Carlos-Soler"
2023,"Paris S-G","Ligue 1","Marco Verratti","ITA","MF","29",1992,24.4,76,49,34,36,6,38,89,42.7,51,42,6,36,27,103,11,3,"https://fbref.com/en/players/1467af0d/Marco-Verratti"
2023,"Paris S-G","Ligue 1","Vitinha","POR","MF","22",2000,27.2,58,25,21,27,10,27,83,32.5,56,27,4,23,25,83,15,0,"https://fbref.com/en/players/3b029691/Vitinha"
2023,"Paris S-G","Ligue 1","Warren Zaire-Emery","FRA","MF,DF","16",2006,10.3,17,10,5,10,2,8,29,27.6,21,11,0,11,12,29,17,0,"https://fbref.com/en/players/6b9960cf/Warren-Zaire-Emery"
2023,"RB Leipzig","Bundesliga","Sanoussy Ba","GER","DF","18",2004,0,0,0,0,0,0,0,0,NA,0,0,0,0,0,0,0,0,"https://fbref.com/en/players/f582d5c1/Sanoussy-Ba"
2023,"RB Leipzig","Bundesliga","Janis Blaswich","GER","GK","31",1991,26,0,0,0,0,0,0,0,NA,0,0,0,0,0,0,10,0,"https://fbref.com/en/players/663e080e/Janis-Blaswich"
2023,"RB Leipzig","Bundesliga","Abdou Diallo","SEN","DF,MF","26",1996,5.3,6,5,5,1,0,1,3,33.3,2,8,5,3,8,14,22,0,"https://fbref.com/en/players/fc62f087/Abdou-Diallo"
2023,"RB Leipzig","Bundesliga","Emil Forsberg","SWE","MF,FW","30",1991,16.5,16,11,1,8,7,6,20,30,14,25,2,23,3,19,7,0,"https://fbref.com/en/players/9a2e0ccc/Emil-Forsberg"
2023,"RB Leipzig","Bundesliga","Péter Gulácsi","HUN","GK","32",1990,6,0,0,0,0,0,0,0,NA,0,0,0,0,0,0,2,0,"https://fbref.com/en/players/bcb2ccd8/Peter-Gulacsi"
2023,"RB Leipzig","Bundesliga","Joško Gvardiol","CRO","DF","20",2002,24.1,23,17,15,8,0,9,22,40.9,13,34,17,17,34,57,76,1,"https://fbref.com/en/players/5ad50391/Josko-Gvardiol"
2023,"RB Leipzig","Bundesliga","Amadou Haidara","MLI","MF","24",1998,15.9,25,11,15,10,0,13,34,38.2,21,26,6,20,26,51,20,0,"https://fbref.com/en/players/92432bc6/Amadou-Haidara"
2023,"RB Leipzig","Bundesliga","Marcel Halstenberg","GER","DF","30",1991,17.3,40,21,20,15,5,23,41,56.1,18,22,1,21,21,61,29,0,"https://fbref.com/en/players/8ff2354e/Marcel-Halstenberg"
2023,"RB Leipzig","Bundesliga","Benjamin Henrichs","GER","DF,MF","25",1997,24.3,73,46,41,29,3,43,66,65.2,23,48,4,44,35,108,46,0,"https://fbref.com/en/players/0a89e877/Benjamin-Henrichs"
2023,"RB Leipzig","Bundesliga","Kevin Kampl","SVN","MF","31",1990,15.2,21,11,6,14,1,6,27,22.2,21,26,9,17,22,43,11,0,"https://fbref.com/en/players/b825a650/Kevin-Kampl"
2023,"RB Leipzig","Bundesliga","Lukas Klostermann","GER","DF","26",1996,10.1,16,8,7,9,0,8,15,53.3,7,6,3,3,13,29,31,0,"https://fbref.com/en/players/ca8033cb/Lukas-Klostermann"
2023,"RB Leipzig","Bundesliga","Konrad Laimer","AUT","MF","25",1997,16.3,60,31,23,30,7,30,54,55.6,24,31,4,27,18,78,8,0,"https://fbref.com/en/players/c1b7847c/Konrad-Laimer"
2023,"RB Leipzig","Bundesliga","Christopher Nkunku","FRA","FW,MF","24",1997,21.1,6,4,2,1,3,1,6,16.7,5,8,3,5,8,14,11,0,"https://fbref.com/en/players/7c56da38/Christopher-Nkunku"
2023,"RB Leipzig","Bundesliga","Hugo Novoa","ESP","DF,FW","19",2003,2,8,2,1,3,4,4,7,57.1,3,4,0,4,1,9,0,0,"https://fbref.com/en/players/5458f670/Hugo-Novoa"
2023,"RB Leipzig","Bundesliga","Ørjan Nyland","NOR","GK","31",1990,2,0,0,0,0,0,0,0,NA,0,0,0,0,0,0,0,0,"https://fbref.com/en/players/bdedffac/Orjan-Nyland"
2023,"RB Leipzig","Bundesliga","Dani Olmo","ESP","MF,FW","24",1998,14.2,15,9,1,10,4,6,14,42.9,8,15,0,15,6,21,6,0,"https://fbref.com/en/players/ae44e8e2/Dani-Olmo"
2023,"RB Leipzig","Bundesliga","Willi Orban","HUN","DF","29",1992,32.8,51,30,33,18,0,26,43,60.5,17,42,24,18,39,90,129,1,"https://fbref.com/en/players/20030c06/Willi-Orban"
2023,"RB Leipzig","Bundesliga","Yussuf Poulsen","DEN","FW","28",1994,4.6,6,4,1,4,1,2,5,40,3,3,1,2,0,6,5,0,"https://fbref.com/en/players/d2416c2e/Yussuf-Poulsen"
2023,"RB Leipzig","Bundesliga","David Raum","GER","DF,MF","24",1998,18.7,39,25,23,12,4,17,29,58.6,12,24,6,18,16,55,26,1,"https://fbref.com/en/players/7d450ed3/David-Raum"
2023,"RB Leipzig","Bundesliga","Xaver Schlager","AUT","MF","24",1997,16.7,41,24,13,26,2,20,43,46.5,23,19,2,17,17,58,23,0,"https://fbref.com/en/players/8f056768/Xaver-Schlager"
2023,"RB Leipzig","Bundesliga","André Silva","POR","FW","26",1995,19.3,12,6,2,5,5,3,8,37.5,5,11,1,10,3,15,3,0,"https://fbref.com/en/players/3effaa34/Andre-Silva"
2023,"RB Leipzig","Bundesliga","Mohamed Simakan","FRA","DF","22",2000,16.2,21,14,12,5,4,14,21,66.7,7,21,4,17,16,37,55,0,"https://fbref.com/en/players/fcb27134/Mohamed-Simakan"
2023,"RB Leipzig","Bundesliga","Dominik Szoboszlai","HUN","MF,FW","21",2000,27.2,45,28,12,20,13,17,42,40.5,25,43,2,41,17,62,27,0,"https://fbref.com/en/players/934e1968/Dominik-Szoboszlai"
2023,"RB Leipzig","Bundesliga","Alexander Sørloth","NOR","FW","26",1995,0.1,0,0,0,0,0,0,0,NA,0,0,0,0,0,0,0,0,"https://fbref.com/en/players/e92cd3f7/Alexander-Sorloth"
2023,"RB Leipzig","Bundesliga","Timo Werner","GER","FW,MF","26",1996,21.5,10,5,4,3,3,4,12,33.3,8,12,0,12,7,17,5,0,"https://fbref.com/en/players/49fe9070/Timo-Werner"
2023,"Rayo Vallecano","La Liga","Iván Balliu","ALB","DF","30",1992,35.9,52,29,26,20,6,18,30,60,12,26,3,23,25,77,72,1,"https://fbref.com/en/players/cee88597/Ivan-Balliu"
2023,"Rayo Vallecano","La Liga","Bebé","CPV","FW","32",1990,0.7,0,0,0,0,0,0,2,0,2,1,0,1,0,0,0,0,"https://fbref.com/en/players/d8712bf9/Bebe"
2023,"Rayo Vallecano","La Liga","Sergio Camello","ESP","FW","21",2001,26.7,16,10,3,9,4,5,17,29.4,12,9,1,8,2,18,26,0,"https://fbref.com/en/players/873619c6/Sergio-Camello"
2023,"Rayo Vallecano","La Liga","Catena","ESP","DF","27",1994,34.5,29,14,23,4,2,13,27,48.1,14,32,25,7,28,57,159,1,"https://fbref.com/en/players/274ab13c/Catena"
2023,"Rayo Vallecano","La Liga","Pep Chavarría","ESP","FW,MF","24",1998,4.1,6,4,2,1,3,1,5,20,4,8,0,8,2,8,8,0,"https://fbref.com/en/players/63c5e56b/Pep-Chavarria"
2023,"Rayo Vallecano","La Liga","Pathé Ciss","SEN","MF,DF","28",1994,14.2,39,29,11,23,5,15,34,44.1,19,23,10,13,22,61,34,0,"https://fbref.com/en/players/9a0408b6/Pathe-Ciss"
2023,"Rayo Vallecano","La Liga","Santi Comesaña","ESP","MF","25",1996,27.2,71,44,24,41,6,38,82,46.3,44,39,3,36,32,103,17,0,"https://fbref.com/en/players/5ae499d0/Santi-Comesana"
2023,"Rayo Vallecano","La Liga","Stole Dimitrievski","MKD","GK","28",1993,36.9,1,0,1,0,0,1,2,50,1,2,0,2,1,2,17,3,"https://fbref.com/en/players/fc70e345/Stole-Dimitrievski"
2023,"Rayo Vallecano","La Liga","Radamel Falcao","COL","FW,MF","36",1986,6.8,4,4,1,3,0,1,8,12.5,7,5,1,4,2,6,10,0,"https://fbref.com/en/players/66116290/Radamel-Falcao"
2023,"Rayo Vallecano","La Liga","Álvaro García","ESP","FW,MF","29",1992,31.9,49,28,21,13,15,11,33,33.3,22,41,4,37,34,83,24,1,"https://fbref.com/en/players/90bbd822/Alvaro-Garcia"
2023,"Rayo Vallecano","La Liga","Fran Garcia","ESP","DF","22",1999,37.9,84,54,53,23,8,55,96,57.3,41,49,8,41,44,128,66,0,"https://fbref.com/en/players/7226539b/Fran-Garcia"
2023,"Rayo Vallecano","La Liga","Mario Hernández","ESP","DF","23",1999,1.1,3,2,2,1,0,3,7,42.9,4,2,0,2,2,5,0,0,"https://fbref.com/en/players/90162357/Mario-Hernandez"
2023,"Rayo Vallecano","La Liga","Florian Lejeune","FRA","DF","31",1991,28.5,28,17,19,8,1,17,25,68,8,24,16,8,15,43,123,0,"https://fbref.com/en/players/6eaed4eb/Florian-Lejeune"
2023,"Rayo Vallecano","La Liga","Diego López","ESP","GK","40",1981,1.1,0,0,0,0,0,0,0,NA,0,0,0,0,0,0,0,1,"https://fbref.com/en/players/73683fa9/Diego-Lopez"
2023,"Rayo Vallecano","La Liga","Unai López","ESP","MF","26",1995,13.9,32,20,10,17,5,13,37,35.1,24,12,1,11,15,47,6,1,"https://fbref.com/en/players/88050721/Unai-Lopez"
2023,"Rayo Vallecano","La Liga","Andrés Martín","ESP","FW,MF","23",1999,2.3,4,2,2,1,1,3,5,60,2,2,0,2,1,5,2,0,"https://fbref.com/en/players/2ae30661/Andres-Martin"
2023,"Rayo Vallecano","La Liga","Diego Méndez","ESP","MF","18",2003,0,0,0,0,0,0,0,0,NA,0,0,0,0,1,1,0,0,"https://fbref.com/en/players/b151a3f2/Diego-Mendez"
2023,"Rayo Vallecano","La Liga","Abdul Mumin","GHA","DF","24",1998,10.2,11,9,5,6,0,3,7,42.9,4,13,5,8,9,20,36,2,"https://fbref.com/en/players/5487adcd/Abdul-Mumin"
2023,"Rayo Vallecano","La Liga","Pablo Muñoz","ESP","MF","18",2003,0.1,0,0,0,0,0,0,1,0,1,0,0,0,0,0,0,0,"https://fbref.com/en/players/44e8521b/Pablo-Munoz"
2023,"Rayo Vallecano","La Liga","Randy Ntekja","FRA","FW,MF","24",1997,1.3,4,2,2,2,0,1,1,100,0,2,0,2,2,6,3,0,"https://fbref.com/en/players/a6103274/Randy-Ntekja"
2023,"Rayo Vallecano","La Liga","Isaac Palazón Camacho","ESP","FW,MF","27",1994,32.9,45,30,11,23,11,24,66,36.4,42,42,3,39,17,62,30,0,"https://fbref.com/en/players/49dbab27/Isaac-Palazon-Camacho"
2023,"Rayo Vallecano","La Liga","José Pozo","ESP","MF,FW","26",1996,1,2,2,0,2,0,0,0,NA,0,0,0,0,1,3,1,0,"https://fbref.com/en/players/fc8b614b/Jose-Pozo"
2023,"Rayo Vallecano","La Liga","Salvi","ESP","FW,MF","31",1991,5.4,13,8,5,5,3,2,8,25,6,0,0,0,2,15,2,0,"https://fbref.com/en/players/405f267a/Salvi"
2023,"Rayo Vallecano","La Liga","Esteban Saveljich","MNE","FW","31",1991,0,0,0,0,0,0,0,0,NA,0,0,0,0,0,0,0,0,"https://fbref.com/en/players/79f2a5f5/Esteban-Saveljich"
2023,"Rayo Vallecano","La Liga","Mario Suárez","ESP","MF,DF","35",1987,0.1,0,0,0,0,0,0,0,NA,0,1,0,1,0,0,0,0,"https://fbref.com/en/players/7106f0a0/Mario-Suarez"
2023,"Rayo Vallecano","La Liga","Raúl de Tomás","ESP","FW","27",1994,8.9,3,2,0,1,2,2,6,33.3,4,4,0,4,0,3,6,0,"https://fbref.com/en/players/02ef8778/Raul-de-Tomas"
2023,"Rayo Vallecano","La Liga","Óscar Trejo","ARG","MF,FW","34",1988,23.8,48,32,12,23,13,9,44,20.5,35,31,3,28,8,56,8,1,"https://fbref.com/en/players/fc647b34/Oscar-Trejo"
2023,"Rayo Vallecano","La Liga","Óscar Valentín","ESP","MF","27",1994,28.4,92,51,29,50,13,46,121,38,75,60,9,51,44,136,30,0,"https://fbref.com/en/players/592f3158/Oscar-Valentin"
2023,"Real Madrid","La Liga","David Alaba","AUT","DF","30",1992,20.4,15,11,8,4,3,9,15,60,6,18,9,9,14,29,37,1,"https://fbref.com/en/players/05439de2/David-Alaba"
2023,"Real Madrid","La Liga","Sergio Arribas","ESP","MF,FW","20",2001,0.2,0,0,0,0,0,0,0,NA,0,1,0,1,0,0,0,0,"https://fbref.com/en/players/1e465e70/Sergio-Arribas"
2023,"Real Madrid","La Liga","Marco Asensio","ESP","FW,MF","26",1996,16,16,10,8,6,2,8,19,42.1,11,8,3,5,5,21,4,0,"https://fbref.com/en/players/45af8a54/Marco-Asensio"
2023,"Real Madrid","La Liga","Karim Benzema","FRA","FW","34",1987,22.6,9,5,2,4,3,2,11,18.2,9,11,0,11,2,11,5,0,"https://fbref.com/en/players/70d74ece/Karim-Benzema"
2023,"Real Madrid","La Liga","Eduardo Camavinga","FRA","MF,DF","19",2002,22.3,68,48,32,21,15,24,64,37.5,40,24,5,19,17,85,25,0,"https://fbref.com/en/players/7b9c2d84/Eduardo-Camavinga"
2023,"Real Madrid","La Liga","Dani Carvajal","ESP","DF","30",1992,19.8,32,18,15,12,5,18,35,51.4,17,24,6,18,15,47,49,0,"https://fbref.com/en/players/4958bfb2/Dani-Carvajal"
2023,"Real Madrid","La Liga","Casemiro","BRA","MF","30",1992,0.1,0,0,0,0,0,0,0,NA,0,0,0,0,0,0,1,0,"https://fbref.com/en/players/4d224fe8/Casemiro"
2023,"Real Madrid","La Liga","Dani Ceballos","ESP","MF","25",1996,17.4,43,29,13,15,15,25,64,39.1,39,23,2,21,25,68,6,1,"https://fbref.com/en/players/c0617e2b/Dani-Ceballos"
2023,"Real Madrid","La Liga","Thibaut Courtois","BEL","GK","30",1992,31,1,0,1,0,0,1,1,100,0,0,0,0,3,4,7,1,"https://fbref.com/en/players/1840e36d/Thibaut-Courtois"
2023,"Real Madrid","La Liga","Eden Hazard","BEL","FW","31",1991,2.2,0,0,0,0,0,0,2,0,2,1,0,1,1,1,0,0,"https://fbref.com/en/players/a39bb753/Eden-Hazard"
2023,"Real Madrid","La Liga","Vinicius Júnior","BRA","FW","22",2000,31.4,30,21,10,12,8,14,39,35.9,25,24,1,23,6,36,1,0,"https://fbref.com/en/players/7111d552/Vinicius-Junior"
2023,"Real Madrid","La Liga","Toni Kroos","GER","MF","32",1990,23.9,51,32,16,33,2,23,69,33.3,46,23,4,19,24,75,11,0,"https://fbref.com/en/players/6ce1f46f/Toni-Kroos"
2023,"Real Madrid","La Liga","Andriy Lunin","UKR","GK","23",1999,7,0,0,0,0,0,0,0,NA,0,0,0,0,0,0,1,0,"https://fbref.com/en/players/3061e1ec/Andriy-Lunin"
2023,"Real Madrid","La Liga","Mariano","DOM","FW","28",1993,1.7,1,0,0,1,0,0,0,NA,0,1,0,1,0,1,0,0,"https://fbref.com/en/players/5c4dc0ff/Mariano"
2023,"Real Madrid","La Liga","Ferland Mendy","FRA","DF","27",1995,15,21,12,14,6,1,12,20,60,8,7,2,5,14,35,16,0,"https://fbref.com/en/players/3cefcaef/Ferland-Mendy"
2023,"Real Madrid","La Liga","Éder Militão","BRA","DF","24",1998,30,46,32,25,18,3,26,33,78.8,7,67,39,28,42,88,104,2,"https://fbref.com/en/players/2784f898/Eder-Militao"
2023,"Real Madrid","La Liga","Luka Modrić","CRO","MF","36",1985,19.4,19,9,6,6,7,10,25,40,15,15,5,10,10,29,7,0,"https://fbref.com/en/players/6025fab1/Luka-Modric"
2023,"Real Madrid","La Liga","Álvaro Muñoz","URU","FW","18",2004,0.9,2,1,1,0,1,1,1,100,0,0,0,0,0,2,1,0,"https://fbref.com/en/players/49a6ecbb/Alvaro-Munoz"
2023,"Real Madrid","La Liga","Nacho","ESP","DF","32",1990,18.2,24,16,17,5,2,12,29,41.4,17,11,6,5,18,42,37,0,"https://fbref.com/en/players/2946f9a1/Nacho"
2023,"Real Madrid","La Liga","Álvaro Odriozola","ESP","DF","26",1995,0.4,0,0,0,0,0,0,0,NA,0,0,0,0,0,0,0,0,"https://fbref.com/en/players/1d1691ad/Alvaro-Odriozola"
2023,"Real Madrid","La Liga","Rodrygo","BRA","FW,MF","21",2001,26.4,17,10,3,7,7,4,23,17.4,19,23,0,23,8,25,5,0,"https://fbref.com/en/players/8f5e92a6/Rodrygo"
2023,"Real Madrid","La Liga","Antonio Rüdiger","GER","DF","29",1993,26.8,18,16,12,5,1,14,23,60.9,9,23,13,10,19,37,74,0,"https://fbref.com/en/players/18b896d6/Antonio-Rudiger"
2023,"Real Madrid","La Liga","Aurélien Tchouaméni","FRA","MF","22",2000,23.5,64,40,23,36,5,23,38,60.5,15,20,6,14,49,113,50,0,"https://fbref.com/en/players/4f255115/Aurelien-Tchouameni"
2023,"Real Madrid","La Liga","Jesús Vallejo","ESP","DF","25",1997,0.2,0,0,0,0,0,0,0,NA,0,0,0,0,0,0,0,0,"https://fbref.com/en/players/c2111b45/Jesus-Vallejo"
2023,"Real Madrid","La Liga","Federico Valverde","URU","MF,FW","24",1998,27.8,31,20,14,11,6,13,26,50,13,31,4,27,17,48,15,0,"https://fbref.com/en/players/0959c2a2/Federico-Valverde"
2023,"Real Madrid","La Liga","Lucas Vázquez","ESP","DF","31",1991,12.7,34,23,22,10,2,20,28,71.4,8,10,0,10,7,41,13,0,"https://fbref.com/en/players/fd51b456/Lucas-Vazquez"
2023,"Real Sociedad","La Liga","Mohamed Ali Cho","FRA","FW,MF","18",2004,6.5,13,10,6,5,2,4,10,40,6,9,0,9,2,15,2,0,"https://fbref.com/en/players/f8405304/Mohamed-Ali-Cho"
2023,"Real Sociedad","La Liga","Ander Barrenetxea","ESP","FW,DF","20",2001,9.8,21,15,15,6,0,12,28,42.9,16,15,1,14,5,26,7,0,"https://fbref.com/en/players/200e89e1/Ander-Barrenetxea"
2023,"Real Sociedad","La Liga","Aritz Elustondo","ESP","DF","28",1994,16.1,26,17,15,10,1,14,26,53.8,12,15,6,9,20,46,43,1,"https://fbref.com/en/players/f7dc2ae5/Aritz-Elustondo"
2023,"Real Sociedad","La Liga","Carlos Fernández","ESP","FW","26",1996,7,6,4,1,3,2,1,15,6.7,14,1,0,1,1,7,4,0,"https://fbref.com/en/players/e08647d6/Carlos-Fernandez"
2023,"Real Sociedad","La Liga","Andoni Gorosabel","ESP","DF","25",1996,19,41,25,23,9,9,26,43,60.5,17,21,2,19,17,58,23,0,"https://fbref.com/en/players/6f5f82c0/Andoni-Gorosabel"
2023,"Real Sociedad","La Liga","Ander Guevara","ESP","MF","25",1997,2.5,5,2,2,2,1,1,4,25,3,6,1,5,2,7,3,0,"https://fbref.com/en/players/8e48dc61/Ander-Guevara"
2023,"Real Sociedad","La Liga","Asier Illarramendi","ESP","MF","32",1990,12,36,18,10,22,4,16,44,36.4,28,27,8,19,18,54,20,0,"https://fbref.com/en/players/5ce0b5ba/Asier-Illarramendi"
2023,"Real Sociedad","La Liga","Alexander Isak","SWE","FW","22",1999,1.7,1,1,0,0,1,0,0,NA,0,0,0,0,0,1,2,0,"https://fbref.com/en/players/8e92be30/Alexander-Isak"
2023,"Real Sociedad","La Liga","Jon Karrikaburu","ESP","FW","19",2002,1,1,0,0,1,0,0,0,NA,0,2,0,2,0,1,0,0,"https://fbref.com/en/players/211589b8/Jon-Karrikaburu"
2023,"Real Sociedad","La Liga","Takefusa Kubo","JPN","FW,MF","21",2001,27.1,44,26,18,16,10,16,38,42.1,22,29,1,28,9,53,4,0,"https://fbref.com/en/players/16aa3654/Takefusa-Kubo"
2023,"Real Sociedad","La Liga","Robin Le Normand","ESP","DF","25",1996,31.1,36,23,25,9,2,14,27,51.9,13,22,14,8,33,69,93,0,"https://fbref.com/en/players/9a64e67e/Robin-Le-Normand"
2023,"Real Sociedad","La Liga","Jon Magunacelaya","ESP","MF,FW","22",2000,0.7,1,0,0,0,1,0,2,0,2,0,0,0,0,1,1,0,"https://fbref.com/en/players/d4808594/Jon-Magunacelaya"
2023,"Real Sociedad","La Liga","Pablo Marín","ESP","MF,FW","19",2003,4,10,5,5,4,1,2,7,28.6,5,1,0,1,4,14,2,0,"https://fbref.com/en/players/a83c19cf/Pablo-Marin"
2023,"Real Sociedad","La Liga","Ander Martin","ESP","MF,FW","21",2000,0.5,2,2,1,1,0,1,4,25,3,0,0,0,0,2,1,0,"https://fbref.com/en/players/e1e75690/Ander-Martin"
2023,"Real Sociedad","La Liga","Brais Méndez","ESP","MF","25",1997,26.7,58,34,18,30,10,24,64,37.5,40,27,3,24,12,70,14,1,"https://fbref.com/en/players/c9e39d91/Brais-Mendez"
2023,"Real Sociedad","La Liga","Mikel Merino","ESP","MF","26",1996,27.7,77,49,28,33,16,31,62,50,31,38,8,30,20,97,51,1,"https://fbref.com/en/players/d080ed5e/Mikel-Merino"
2023,"Real Sociedad","La Liga","Aihen Muñoz","ESP","DF","24",1997,19.5,38,23,17,17,4,22,47,46.8,25,26,5,21,9,47,38,0,"https://fbref.com/en/players/228b0d9d/Aihen-Munoz"
2023,"Real Sociedad","La Liga","Roberto Navarro","ESP","MF,FW","20",2002,3.9,5,4,4,0,1,1,2,50,1,7,0,7,2,7,2,0,"https://fbref.com/en/players/c997b942/Roberto-Navarro"
2023,"Real Sociedad","La Liga","Olasagasti","ESP","MF,DF","21",2000,0.7,4,4,1,2,1,1,2,50,1,2,0,2,0,4,1,0,"https://fbref.com/en/players/3d99999d/Olasagasti"
2023,"Real Sociedad","La Liga","Mikel Oyarzabal","ESP","FW,MF","25",1997,13.5,13,7,5,3,5,5,19,26.3,14,14,4,10,3,16,5,0,"https://fbref.com/en/players/8c3c640c/Mikel-Oyarzabal"
2023,"Real Sociedad","La Liga","Jon Pacheco","ESP","DF","21",2001,13.3,16,10,10,6,0,6,10,60,4,9,6,3,12,28,37,1,"https://fbref.com/en/players/44150beb/Jon-Pacheco"
2023,"Real Sociedad","La Liga","Álex Remiro","ESP","GK","27",1995,38,1,1,1,0,0,1,3,33.3,2,0,0,0,0,1,17,3,"https://fbref.com/en/players/374ee424/Alex-Remiro"
2023,"Real Sociedad","La Liga","Diego Rico","ESP","DF","29",1993,18.3,35,21,17,11,7,12,27,44.4,15,18,5,13,20,55,51,1,"https://fbref.com/en/players/d9ba39fc/Diego-Rico"
2023,"Real Sociedad","La Liga","Umar Sadiq","NGA","FW","25",1997,0.9,1,1,0,0,1,0,1,0,1,2,0,2,0,1,0,0,"https://fbref.com/en/players/686cbe7d/Umar-Sadiq"
2023,"Real Sociedad","La Liga","David Silva","ESP","MF","36",1986,21.5,36,21,11,18,7,11,19,57.9,8,17,2,15,15,51,16,0,"https://fbref.com/en/players/e2716bd0/David-Silva"
2023,"Real Sociedad","La Liga","Alex Sola","ESP","DF","23",1999,3.9,18,9,14,3,1,7,10,70,3,7,2,5,7,25,10,0,"https://fbref.com/en/players/5fa714d5/Alex-Sola"
2023,"Real Sociedad","La Liga","Alexander Sørloth","NOR","FW","26",1995,26.5,18,9,3,6,9,7,14,50,7,15,1,14,2,20,26,1,"https://fbref.com/en/players/e92cd3f7/Alexander-Sorloth"
2023,"Real Sociedad","La Liga","Beñat Turrientes","ESP","MF,FW","20",2002,1.2,3,3,3,0,0,1,5,20,4,2,0,2,0,3,3,0,"https://fbref.com/en/players/068f4dec/Benat-Turrientes"
2023,"Real Sociedad","La Liga","Igor Zubeldia","ESP","DF","25",1997,28.2,35,18,28,7,0,25,35,71.4,10,23,17,6,21,56,93,0,"https://fbref.com/en/players/5c7845f6/Igor-Zubeldia"
2023,"Real Sociedad","La Liga","Martín Zubimendi","ESP","MF","23",1999,34.5,59,33,23,30,6,24,45,53.3,21,44,17,27,37,96,55,4,"https://fbref.com/en/players/3ee0dd59/Martin-Zubimendi"
2023,"Reims","Ligue 1","Yunis Abdelhamid","MAR","DF","34",1987,37,82,50,47,33,2,39,52,75,13,65,27,38,64,146,116,1,"https://fbref.com/en/players/32c2d95f/Yunis-Abdelhamid"
2023,"Reims","Ligue 1","Martin Adeline","FRA","MF,FW","18",2003,1.2,3,3,2,1,0,3,4,75,1,3,1,2,3,6,3,0,"https://fbref.com/en/players/7587446d/Martin-Adeline"
2023,"Reims","Ligue 1","Emmanuel Agbadou","CIV","DF","25",1997,26.5,71,49,53,16,2,42,65,64.6,23,30,14,16,32,103,107,3,"https://fbref.com/en/players/75f1ed80/Emmanuel-Agbadou"
2023,"Reims","Ligue 1","Valentin Atangana Edoa","FRA","MF","16",2005,1.9,8,3,4,2,2,3,6,50,3,2,1,1,0,8,1,0,"https://fbref.com/en/players/6b5edd5d/Valentin-Atangana-Edoa"
2023,"Reims","Ligue 1","Folarin Balogun","USA","FW","21",2001,33.3,9,5,1,5,3,2,20,10,18,20,1,19,3,12,15,0,"https://fbref.com/en/players/31822f8c/Folarin-Balogun"
2023,"Reims","Ligue 1","Mitchell van Bergen","NED","FW,DF","22",1999,10.1,18,8,6,7,5,8,20,40,12,8,2,6,6,24,11,0,"https://fbref.com/en/players/0b2c9aec/Mitchell-van-Bergen"
2023,"Reims","Ligue 1","El Bilal Touré","MLI","FW","20",2001,1,0,0,0,0,0,0,0,NA,0,2,0,2,0,0,1,0,"https://fbref.com/en/players/47c609d5/El-Bilal-Toure"
2023,"Reims","Ligue 1","Maxime Busi","BEL","DF","22",1999,11.6,21,16,9,11,1,13,29,44.8,16,14,6,8,14,35,24,0,"https://fbref.com/en/players/7b082ec2/Maxime-Busi"
2023,"Reims","Ligue 1","Jens Cajuste","SWE","MF","22",1999,17,46,25,25,14,7,25,48,52.1,23,30,6,24,18,64,22,0,"https://fbref.com/en/players/928a4a61/Jens-Cajuste"
2023,"Reims","Ligue 1","Thibault De Smet","BEL","DF","24",1998,19.5,24,17,10,14,0,11,37,29.7,26,28,5,23,20,44,40,1,"https://fbref.com/en/players/5fdcb075/Thibault-De-Smet"
2023,"Reims","Ligue 1","Mamadou Diakhon","FRA","FW","16",2005,0.2,2,0,2,0,0,0,1,0,1,1,0,1,1,3,0,0,"https://fbref.com/en/players/331c5a98/Mamadou-Diakhon"
2023,"Reims","Ligue 1","Ibrahim Diakité","GUI","DF","18",2003,1.5,3,3,3,0,0,2,3,66.7,1,0,0,0,5,8,6,0,"https://fbref.com/en/players/d8c19a60/Ibrahim-Diakite"
2023,"Reims","Ligue 1","Yehvann Diouf","FRA","GK","22",1999,31,2,0,2,0,0,1,3,33.3,2,0,0,0,1,3,13,5,"https://fbref.com/en/players/eedea60b/Yehvann-Diouf"
2023,"Reims","Ligue 1","Kamory Doumbia","MLI","MF","19",2003,12.8,31,16,9,14,8,12,37,32.4,25,17,1,16,13,44,3,0,"https://fbref.com/en/players/9226aa22/Kamory-Doumbia"
2023,"Reims","Ligue 1","Wout Faes","BEL","DF","24",1998,3,1,1,1,0,0,1,2,50,1,6,3,3,7,8,19,0,"https://fbref.com/en/players/9c221d14/Wout-Faes"
2023,"Reims","Ligue 1","Fallou Fall","SEN","DF","18",2004,0.4,0,0,0,0,0,0,1,0,1,3,3,0,0,0,4,0,"https://fbref.com/en/players/2c8a91b9/Fallou-Fall"
2023,"Reims","Ligue 1","Alexis Flips","FRA","FW,MF","22",2000,22,51,30,18,17,16,27,64,42.2,37,35,5,30,24,75,12,0,"https://fbref.com/en/players/caef7840/Alexis-Flips"
2023,"Reims","Ligue 1","Thomas Foket","BEL","DF","27",1994,22,35,22,18,11,6,17,46,37,29,21,7,14,33,68,29,2,"https://fbref.com/en/players/90eb507d/Thomas-Foket"
2023,"Reims","Ligue 1","Andrew Gravillon","GLP","DF","24",1998,11.5,16,8,9,6,1,8,13,61.5,5,18,9,9,21,37,36,0,"https://fbref.com/en/players/49136c42/Andrew-Gravillon"
2023,"Reims","Ligue 1","Rafik Guitane","FRA","FW","23",1999,0,0,0,0,0,0,0,0,NA,0,0,0,0,0,0,1,0,"https://fbref.com/en/players/7091324a/Rafik-Guitane"
2023,"Reims","Ligue 1","Noah Holm","NOR","FW,MF","21",2001,2.2,6,4,2,2,2,2,5,40,3,0,0,0,0,6,5,0,"https://fbref.com/en/players/61b77d0a/Noah-Holm"
2023,"Reims","Ligue 1","Junya Ito","JPN","FW","29",1993,32.4,40,20,14,15,11,13,53,24.5,40,29,1,28,8,48,4,1,"https://fbref.com/en/players/dbd3a428/Junya-Ito"
2023,"Reims","Ligue 1","Check Keita","FRA","DF","19",2003,7.6,12,9,9,3,0,4,9,44.4,5,6,5,1,5,17,24,1,"https://fbref.com/en/players/c9f2f83a/Check-Keita"
2023,"Reims","Ligue 1","Samuel Koeberlé","FRA","MF","17",2004,0,0,0,0,0,0,0,0,NA,0,0,0,0,0,0,0,0,"https://fbref.com/en/players/6751b938/Samuel-Koeberle"
2023,"Reims","Ligue 1","Banzouzi Locko","FRA","DF","20",2002,11.8,31,16,21,4,6,15,27,55.6,12,17,4,13,20,51,21,0,"https://fbref.com/en/players/40221fa7/Banzouzi-Locko"
2023,"Reims","Ligue 1","Dion Lopy","SEN","MF","20",2002,15.3,45,24,22,16,7,23,62,37.1,39,27,3,24,22,67,18,0,"https://fbref.com/en/players/64c14d49/Dion-Lopy"
2023,"Reims","Ligue 1","Myziane Maolida","FRA","MF,FW","23",1999,2.6,8,3,2,5,1,5,12,41.7,7,1,0,1,2,10,0,0,"https://fbref.com/en/players/706a60e1/Myziane-Maolida"
2023,"Reims","Ligue 1","Azor Matusiwa","NED","MF","24",1998,27.6,66,41,30,29,7,36,61,59,25,37,11,26,46,112,52,0,"https://fbref.com/en/players/a17a94d6/Azor-Matusiwa"
2023,"Reims","Ligue 1","Nathanael Mbuku","FRA","FW,MF","20",2002,0.7,2,1,2,0,0,2,2,100,0,0,0,0,0,2,0,0,"https://fbref.com/en/players/46750e9c/Nathanael-Mbuku"
2023,"Reims","Ligue 1","Marshall Munetsi","ZIM","MF","26",1996,30,58,27,13,31,14,20,48,41.7,28,37,11,26,26,84,41,1,"https://fbref.com/en/players/2acf0cd7/Marshall-Munetsi"
2023,"Reims","Ligue 1","Patrick Pentz","AUT","GK","25",1997,7,0,0,0,0,0,0,0,NA,0,0,0,0,0,0,1,0,"https://fbref.com/en/players/0810b6df/Patrick-Pentz"
2023,"Reims","Ligue 1","Kaj Sierhuis","NED","FW,MF","24",1998,2.4,3,3,1,0,2,0,5,0,5,3,1,2,1,4,2,0,"https://fbref.com/en/players/9c2b1f11/Kaj-Sierhuis"
2023,"Reims","Ligue 1","Mohamed Toure","AUS","FW,MF","18",2004,0.3,0,0,0,0,0,0,0,NA,0,0,0,0,0,0,0,0,"https://fbref.com/en/players/8ac64b4e/Mohamed-Toure"
2023,"Reims","Ligue 1","Arber Zeneli","KVX","FW,MF","27",1995,11.1,9,3,3,3,3,5,12,41.7,7,8,0,8,2,11,2,0,"https://fbref.com/en/players/095e4199/Arber-Zeneli"
2023,"Rennes","Ligue 1","Matthis Abline","FRA","FW,MF","19",2003,1.2,1,1,0,0,1,1,1,100,0,1,0,1,2,3,1,0,"https://fbref.com/en/players/0e46fa2f/Matthis-Abline"
2023,"Rennes","Ligue 1","Doğan Alemdar","TUR","GK","19",2002,4.5,0,0,0,0,0,0,0,NA,0,0,0,0,0,0,1,1,"https://fbref.com/en/players/9e17ccff/Dogan-Alemdar"
2023,"Rennes","Ligue 1","Lorenz Assignon","TOG","DF","22",2000,2.9,6,2,4,2,0,2,4,50,2,6,0,6,2,8,9,0,"https://fbref.com/en/players/b026bbf6/Lorenz-Assignon"
2023,"Rennes","Ligue 1","Loïc Bade","FRA","DF","22",2000,1,1,1,1,0,0,0,0,NA,0,0,0,0,1,2,3,0,"https://fbref.com/en/players/114bbdee/Loic-Bade"
2023,"Rennes","Ligue 1","Jeanöel Belocian","FRA","DF","17",2005,5.6,10,7,3,5,2,5,9,55.6,4,6,3,3,6,16,11,0,"https://fbref.com/en/players/c678ddd7/Jeanoel-Belocian"
2023,"Rennes","Ligue 1","Benjamin Bourigeaud","FRA","MF,FW","28",1994,34.1,45,29,16,23,6,21,65,32.3,44,38,3,35,31,76,32,0,"https://fbref.com/en/players/20e73fac/Benjamin-Bourigeaud"
2023,"Rennes","Ligue 1","Alan Do Marcolino","GAB","FW","20",2002,0.2,0,0,0,0,0,0,0,NA,0,0,0,0,0,0,1,0,"https://fbref.com/en/players/1bd5bdc4/Alan-Do-Marcolino"
2023,"Rennes","Ligue 1","Jeremy Doku","BEL","MF,FW","20",2002,14.3,25,16,6,13,6,12,24,50,12,10,0,10,5,30,2,0,"https://fbref.com/en/players/fffea3e5/Jeremy-Doku"
2023,"Rennes","Ligue 1","Désiré Doué","FRA","MF,FW","17",2005,12.4,37,18,10,23,4,13,32,40.6,19,17,1,16,13,50,3,0,"https://fbref.com/en/players/9e7483ff/Desire-Doue"
2023,"Rennes","Ligue 1","Guela Doué","FRA","FW,MF","19",2002,0.1,0,0,0,0,0,0,0,NA,0,0,0,0,0,0,0,0,"https://fbref.com/en/players/b4ef3fb5/Guela-Doue"
2023,"Rennes","Ligue 1","Amine Gouiri","FRA","FW,MF","22",2000,28,42,25,14,16,12,14,33,42.4,19,21,0,21,12,54,10,0,"https://fbref.com/en/players/aad56ca3/Amine-Gouiri"
2023,"Rennes","Ligue 1","Sehrou Guirassy","GUI","MF","26",1996,0.3,0,0,0,0,0,0,0,NA,0,0,0,0,0,0,0,0,"https://fbref.com/en/players/923f4dda/Sehrou-Guirassy"
2023,"Rennes","Ligue 1","Arnaud Kalimuendo","FRA","FW","20",2002,20.5,15,8,3,6,6,5,20,25,15,15,2,13,2,17,9,0,"https://fbref.com/en/players/bf4c41f9/Arnaud-Kalimuendo"
2023,"Rennes","Ligue 1","Gaëtan Laborde","FRA","FW","28",1994,2.8,1,1,1,0,0,0,1,0,1,1,0,1,0,1,1,0,"https://fbref.com/en/players/7cdda3bf/Gaetan-Laborde"
2023,"Rennes","Ligue 1","Lovro Majer","CRO","MF,FW","24",1998,18.5,34,23,16,13,5,8,29,27.6,21,21,1,20,21,55,5,1,"https://fbref.com/en/players/fc46aab1/Lovro-Majer"
2023,"Rennes","Ligue 1","Steve Mandanda","FRA","GK","37",1985,33.5,0,0,0,0,0,0,2,0,2,0,0,0,0,0,9,3,"https://fbref.com/en/players/1d2d5cc8/Steve-Mandanda"
2023,"Rennes","Ligue 1","Birger Meling","NOR","DF","27",1994,13.4,24,15,9,12,3,12,25,48,13,18,2,16,23,47,26,0,"https://fbref.com/en/players/70c52749/Birger-Meling"
2023,"Rennes","Ligue 1","Warmed Omari","FRA","DF","22",2000,15.1,20,11,14,6,0,14,28,50,14,13,7,6,17,37,43,1,"https://fbref.com/en/players/4534a352/Warmed-Omari"
2023,"Rennes","Ligue 1","Joe Rodon","WAL","DF","24",1997,15.7,11,7,9,2,0,4,10,40,6,16,12,4,9,20,54,1,"https://fbref.com/en/players/8d62d31a/Joe-Rodon"
2023,"Rennes","Ligue 1","Ibrahim Salah","MAR","FW,MF","20",2001,2.5,8,1,5,3,0,2,15,13.3,13,3,0,3,2,10,0,0,"https://fbref.com/en/players/cad3fd4d/Ibrahim-Salah"
2023,"Rennes","Ligue 1","Baptiste Santamaria","FRA","MF","27",1995,20.1,41,22,13,23,5,21,41,51.2,20,21,5,16,21,62,23,0,"https://fbref.com/en/players/5e22e2a4/Baptiste-Santamaria"
2023,"Rennes","Ligue 1","Djed Spence","ENG","DF","21",2000,6.4,14,6,8,2,4,11,18,61.1,7,10,3,7,4,18,15,0,"https://fbref.com/en/players/9bc9a519/Djed-Spence"
2023,"Rennes","Ligue 1","Kamaldeen Sulemana","GHA","FW,MF","20",2002,3.6,6,3,1,4,1,1,5,20,4,2,0,2,4,10,2,0,"https://fbref.com/en/players/a62f8bf1/Kamaldeen-Sulemana"
2023,"Rennes","Ligue 1","Flavien Tait","FRA","MF","29",1993,18.7,30,15,8,17,5,19,42,45.2,23,16,4,12,20,50,12,0,"https://fbref.com/en/players/a0f9b535/Flavien-Tait"
2023,"Rennes","Ligue 1","Martin Terrier","FRA","FW,MF","25",1997,14.7,25,11,7,9,9,13,24,54.2,11,15,2,13,14,39,6,0,"https://fbref.com/en/players/5148dcc5/Martin-Terrier"
2023,"Rennes","Ligue 1","Arthur Theate","BEL","DF","22",2000,34.7,29,19,17,8,4,17,30,56.7,13,26,14,12,30,59,114,3,"https://fbref.com/en/players/df8d6029/Arthur-Theate"
2023,"Rennes","Ligue 1","Karl Toko Ekambi","CMR","FW,MF","29",1992,10.8,3,1,1,1,1,3,9,33.3,6,5,0,5,9,12,3,0,"https://fbref.com/en/players/5ceba7fc/Karl-Toko-Ekambi"
2023,"Rennes","Ligue 1","Hamari Traoré","MLI","DF","30",1992,28.1,48,32,26,15,7,28,52,53.8,24,33,7,26,38,86,64,0,"https://fbref.com/en/players/a4b1028a/Hamari-Traore"
2023,"Rennes","Ligue 1","Adrien Truffert","FRA","DF","20",2001,21.7,62,32,36,17,9,31,46,67.4,15,32,8,24,22,84,55,0,"https://fbref.com/en/players/5d0e0a1f/Adrien-Truffert"
2023,"Rennes","Ligue 1","Chimuanya Ugochukwu","FRA","MF","18",2004,14.8,36,19,13,20,3,16,24,66.7,8,24,10,14,21,57,16,0,"https://fbref.com/en/players/1df4a109/Chimuanya-Ugochukwu"
2023,"Rennes","Ligue 1","Christopher Wooh","CMR","DF","20",2001,11.2,16,7,8,8,0,9,11,81.8,2,11,5,6,6,22,49,0,"https://fbref.com/en/players/b003239d/Christopher-Wooh"
2023,"Rennes","Ligue 1","Xeka","POR","MF","27",1994,6.1,10,3,6,3,1,7,16,43.8,9,11,2,9,6,16,8,0,"https://fbref.com/en/players/f3600c02/Xeka"
2023,"Roma","Serie A","Tammy Abraham","ENG","FW","24",1997,24.3,17,10,4,8,5,3,16,18.8,13,10,4,6,3,20,14,0,"https://fbref.com/en/players/f586779e/Tammy-Abraham"
2023,"Roma","Serie A","Andrea Belotti","ITA","FW","28",1993,12.7,12,5,3,5,4,5,11,45.5,6,11,1,10,3,15,5,0,"https://fbref.com/en/players/d705ba44/Andrea-Belotti"
2023,"Roma","Serie A","Edoardo Bove","ITA","MF","20",2002,11,35,18,12,15,8,16,39,41,23,15,1,14,10,45,11,0,"https://fbref.com/en/players/ae94a6c5/Edoardo-Bove"
2023,"Roma","Serie A","Mohamed Camara","GUI","MF","25",1997,7.7,13,10,3,7,3,5,15,33.3,10,5,1,4,10,23,8,0,"https://fbref.com/en/players/13ea2544/Mohamed-Camara"
2023,"Roma","Serie A","Zeki Çelik","TUR","DF","25",1997,16.7,42,21,19,21,2,24,41,58.5,17,33,6,27,14,56,36,2,"https://fbref.com/en/players/31a62dc7/Zeki-Celik"
2023,"Roma","Serie A","Bryan Cristante","ITA","MF,DF","27",1995,32.6,113,62,55,49,9,55,90,61.1,35,39,10,29,18,131,53,0,"https://fbref.com/en/players/16657b95/Bryan-Cristante"
2023,"Roma","Serie A","Paulo Dybala","ARG","MF,FW","28",1993,19.3,14,4,1,8,5,8,26,30.8,18,12,1,11,8,22,4,0,"https://fbref.com/en/players/e0921a4f/Paulo-Dybala"
2023,"Roma","Serie A","Roger Ibanez","BRA","DF","23",1998,31.1,67,33,38,26,3,32,48,66.7,16,30,11,19,66,133,95,2,"https://fbref.com/en/players/82efe6fa/Roger-Ibanez"
2023,"Roma","Serie A","Rick Karsdorp","NED","DF","27",1995,7.9,21,13,11,7,3,13,22,59.1,9,0,0,0,7,28,15,1,"https://fbref.com/en/players/9f84febe/Rick-Karsdorp"
2023,"Roma","Serie A","Marash Kumbulla","ALB","DF","22",2000,2.9,4,4,2,2,0,2,3,66.7,1,2,1,1,4,8,6,0,"https://fbref.com/en/players/a40819d9/Marash-Kumbulla"
2023,"Roma","Serie A","Diego Llorente","ESP","DF","28",1993,6.4,10,5,6,4,0,5,12,41.7,7,4,2,2,11,21,20,0,"https://fbref.com/en/players/bba30585/Diego-Llorente"
2023,"Roma","Serie A","Jordan Majchrzak","POL","FW","17",2004,0.2,0,0,0,0,0,0,0,NA,0,0,0,0,0,0,0,0,"https://fbref.com/en/players/2e7dafe5/Jordan-Majchrzak"
2023,"Roma","Serie A","Gianluca Mancini","ITA","DF","26",1996,31.8,37,19,27,9,1,18,34,52.9,16,38,17,21,46,83,67,0,"https://fbref.com/en/players/5aa53281/Gianluca-Mancini"
2023,"Roma","Serie A","Nemanja Matić","SRB","MF","33",1988,20.6,47,27,24,19,4,19,33,57.6,14,27,7,20,25,72,21,1,"https://fbref.com/en/players/eb7822d7/Nemanja-Matic"
2023,"Roma","Serie A","Filippo Missori","ITA","DF","18",2004,2,4,3,3,0,1,3,6,50,3,0,0,0,3,7,5,0,"https://fbref.com/en/players/2d3d7c0d/Filippo-Missori"
2023,"Roma","Serie A","Rui Patrício","POR","GK","34",1988,35,1,1,1,0,0,1,1,100,0,0,0,0,2,3,6,3,"https://fbref.com/en/players/79b0d6a0/Rui-Patricio"
2023,"Roma","Serie A","Lorenzo Pellegrini","ITA","MF","26",1996,28.3,52,29,24,24,4,22,48,45.8,26,27,4,23,26,78,22,0,"https://fbref.com/en/players/4a5a45c7/Lorenzo-Pellegrini"
2023,"Roma","Serie A","Niccolò Pisilli","ITA","MF","17",2004,0,0,0,0,0,0,0,0,NA,0,0,0,0,0,0,0,0,"https://fbref.com/en/players/c84dcc88/Niccolo-Pisilli"
2023,"Roma","Serie A","Stephan El Shaarawy","ITA","DF,MF","29",1992,16.9,21,9,8,10,3,6,22,27.3,16,11,1,10,15,36,11,0,"https://fbref.com/en/players/d3aaad90/Stephan-El-Shaarawy"
2023,"Roma","Serie A","Eldor Shomurodov","UZB","FW","27",1995,1.3,1,0,1,0,0,0,2,0,2,1,0,1,1,2,0,0,"https://fbref.com/en/players/57469b2d/Eldor-Shomurodov"
2023,"Roma","Serie A","Chris Smalling","ENG","DF","32",1989,31.2,26,15,16,10,0,13,21,61.9,8,51,36,15,43,69,123,0,"https://fbref.com/en/players/b6964eb6/Chris-Smalling"
2023,"Roma","Serie A","Ola Solbakken","NOR","MF,FW","23",1998,5.6,2,2,1,1,0,2,7,28.6,5,2,0,2,2,4,8,0,"https://fbref.com/en/players/78f13530/Ola-Solbakken"
2023,"Roma","Serie A","Leonardo Spinazzola","ITA","DF","29",1993,18.4,15,8,7,6,2,8,23,34.8,15,13,3,10,9,24,25,0,"https://fbref.com/en/players/3626daea/Leonardo-Spinazzola"
2023,"Roma","Serie A","Mile Svilar","SRB","GK","22",1999,3,0,0,0,0,0,0,0,NA,0,0,0,0,0,0,1,0,"https://fbref.com/en/players/bcf5058a/Mile-Svilar"
2023,"Roma","Serie A","Benjamin Tahirovic","BIH","MF","19",2003,3.9,8,5,5,2,1,4,12,33.3,8,9,4,5,3,11,3,0,"https://fbref.com/en/players/eb3022c3/Benjamin-Tahirovic"
2023,"Roma","Serie A","Matías Viña","URU","DF","24",1997,0.6,3,1,1,1,1,1,3,33.3,2,5,1,4,2,5,5,0,"https://fbref.com/en/players/08eb3b58/Matias-Vina"
2023,"Roma","Serie A","Cristian Volpato","ITA","MF","18",2003,2.5,3,2,1,1,1,0,2,0,2,2,0,2,2,5,0,0,"https://fbref.com/en/players/72f87f25/Cristian-Volpato"
2023,"Roma","Serie A","Georginio Wijnaldum","NED","MF","31",1990,8.5,4,3,1,3,0,0,2,0,2,7,1,6,2,6,3,0,"https://fbref.com/en/players/eb58eef0/Georginio-Wijnaldum"
2023,"Roma","Serie A","Nicola Zalewski","POL","DF","20",2002,24.4,45,26,25,15,5,22,71,31,49,27,1,26,31,76,23,0,"https://fbref.com/en/players/45191c29/Nicola-Zalewski"
2023,"Roma","Serie A","Nicolò Zaniolo","ITA","MF,FW","23",1999,9.9,7,5,2,4,1,2,7,28.6,5,11,0,11,2,9,0,0,"https://fbref.com/en/players/9907b1c8/Nicolo-Zaniolo"
2023,"Salernitana","Serie A","Emil Bohinen","NOR","MF","23",1999,9.2,25,13,15,8,2,12,23,52.2,11,25,7,18,17,42,21,0,"https://fbref.com/en/players/c83c203f/Emil-Bohinen"
2023,"Salernitana","Serie A","Federico Bonazzoli","ITA","FW,MF","25",1997,12.4,5,3,0,3,2,0,9,0,9,9,1,8,3,8,0,0,"https://fbref.com/en/players/bf57eaab/Federico-Bonazzoli"
2023,"Salernitana","Serie A","Erik Botheim","NOR","MF,FW","22",2000,9.6,11,7,3,4,4,6,13,46.2,7,3,0,3,0,11,4,0,"https://fbref.com/en/players/3d13d9e4/Erik-Botheim"
2023,"Salernitana","Serie A","Domagoj Bradarić","CRO","DF","22",1999,25,26,19,14,8,4,7,16,43.8,9,20,5,15,21,47,44,0,"https://fbref.com/en/players/8bbe2df5/Domagoj-Bradaric"
2023,"Salernitana","Serie A","Dylan Bronn","TUN","DF","27",1995,18.7,34,18,17,16,1,20,30,66.7,10,32,20,12,20,54,58,1,"https://fbref.com/en/players/edd81e2a/Dylan-Bronn"
2023,"Salernitana","Serie A","Antonio Candreva","ITA","MF,DF","35",1987,30.3,17,7,13,2,2,11,38,28.9,27,7,3,4,17,34,32,0,"https://fbref.com/en/players/356c9002/Antonio-Candreva"
2023,"Salernitana","Serie A","Lassana Coulibaly","MLI","MF","26",1996,32.1,84,50,42,35,7,30,73,41.1,43,35,7,28,25,109,33,2,"https://fbref.com/en/players/85a44ecc/Lassana-Coulibaly"
2023,"Salernitana","Serie A","Domen Črnigoj","SVN","MF","26",1995,3.3,8,3,0,7,1,1,2,50,1,9,1,8,9,17,6,0,"https://fbref.com/en/players/22cd43d2/Domen-Crnigoj"
2023,"Salernitana","Serie A","Flavius Daniliuc","AUT","DF","21",2001,24.4,57,29,37,17,3,26,47,55.3,21,30,13,17,29,86,76,0,"https://fbref.com/en/players/7ef972c3/Flavius-Daniliuc"
2023,"Salernitana","Serie A","Boulaye Dia","SEN","FW,MF","25",1996,28,12,5,3,6,3,2,7,28.6,5,10,0,10,7,19,27,1,"https://fbref.com/en/players/244bc2c8/Boulaye-Dia"
2023,"Salernitana","Serie A","Federico Fazio","ARG","DF","35",1987,11.9,15,12,8,7,0,4,11,36.4,7,9,4,5,28,43,61,0,"https://fbref.com/en/players/4e358a2d/Federico-Fazio"
2023,"Salernitana","Serie A","Vincenzo Fiorillo","ITA","GK","32",1990,1,0,0,0,0,0,0,0,NA,0,0,0,0,0,0,0,0,"https://fbref.com/en/players/a2565f79/Vincenzo-Fiorillo"
2023,"Salernitana","Serie A","Norbert Gyömbér","SVK","DF","30",1992,19.3,32,23,25,6,1,16,24,66.7,8,33,22,11,35,67,92,0,"https://fbref.com/en/players/0be276c6/Norbert-Gyomber"
2023,"Salernitana","Serie A","Antonio Iervolino","ITA","MF","19",2003,0.1,0,0,0,0,0,0,1,0,1,0,0,0,0,0,0,0,"https://fbref.com/en/players/daa4c94c/Antonio-Iervolino"
2023,"Salernitana","Serie A","Grigoris Kastanos","CYP","MF,DF","24",1998,14.3,39,23,18,19,2,16,40,40,24,20,6,14,8,47,8,0,"https://fbref.com/en/players/2a82aa85/Grigoris-Kastanos"
2023,"Salernitana","Serie A","Julian Kristoffersen","NOR","FW","25",1997,0.2,0,0,0,0,0,0,0,NA,0,1,0,1,0,0,0,0,"https://fbref.com/en/players/b804c280/Julian-Kristoffersen"
2023,"Salernitana","Serie A","Matteo Lovato","ITA","DF","22",2000,9,17,14,14,3,0,10,25,40,15,8,5,3,13,30,33,2,"https://fbref.com/en/players/5fa57166/Matteo-Lovato"
2023,"Salernitana","Serie A","Giulio Maggiore","ITA","MF","24",1998,9.9,20,8,11,6,3,10,21,47.6,11,19,4,15,8,28,10,0,"https://fbref.com/en/players/957e4c87/Giulio-Maggiore"
2023,"Salernitana","Serie A","Pasquale Mazzocchi","ITA","DF","27",1995,21.8,32,18,21,5,6,17,37,45.9,20,10,2,8,10,42,37,2,"https://fbref.com/en/players/eb0ec070/Pasquale-Mazzocchi"
2023,"Salernitana","Serie A","Hans Nicolussi Caviglia","ITA","MF","22",2000,6.5,15,6,5,8,2,9,15,60,6,9,0,9,7,22,7,1,"https://fbref.com/en/players/b136c945/Hans-Nicolussi-Caviglia"
2023,"Salernitana","Serie A","Guillermo Ochoa","MEX","GK","37",1985,20,0,0,0,0,0,0,2,0,2,0,0,0,0,0,9,1,"https://fbref.com/en/players/1e9bde92/Guillermo-Ochoa"
2023,"Salernitana","Serie A","Krzysztof Piątek","POL","FW","27",1995,23.8,18,11,3,9,6,5,21,23.8,16,17,4,13,2,20,39,0,"https://fbref.com/en/players/17f3620a/Krzysztof-Piatek"
2023,"Salernitana","Serie A","Lorenzo Pirola","ITA","DF","20",2002,21.6,33,29,18,14,1,19,27,70.4,8,50,35,15,30,63,85,1,"https://fbref.com/en/players/caec77da/Lorenzo-Pirola"
2023,"Salernitana","Serie A","Ivan Radovanović","SRB","MF,DF","33",1988,7.5,12,4,8,4,0,4,10,40,6,9,3,6,7,19,9,1,"https://fbref.com/en/players/023937a9/Ivan-Radovanovic"
2023,"Salernitana","Serie A","Franck Ribéry","FRA","MF","39",1983,0.4,0,0,0,0,0,0,0,NA,0,1,0,1,0,0,0,0,"https://fbref.com/en/players/f61c7c4e/Franck-Ribery"
2023,"Salernitana","Serie A","Junior Sambia","FRA","DF","25",1996,7.7,12,5,7,4,1,6,10,60,4,9,3,6,8,20,16,1,"https://fbref.com/en/players/24eb7ed6/Junior-Sambia"
2023,"Salernitana","Serie A","Luigi Sepe","ITA","GK","31",1991,17,0,0,0,0,0,0,1,0,1,0,0,0,0,0,0,0,"https://fbref.com/en/players/343f753a/Luigi-Sepe"
2023,"Salernitana","Serie A","William Troost-Ekong","NGA","DF","28",1993,4.9,11,3,7,4,0,6,7,85.7,1,7,4,3,6,17,10,0,"https://fbref.com/en/players/7ed4921e/William-Troost-Ekong"
2023,"Salernitana","Serie A","Diego Valencia","CHI","MF,FW","22",2000,2.6,8,5,4,2,2,2,9,22.2,7,10,1,9,1,9,2,0,"https://fbref.com/en/players/71005acd/Diego-Valencia"
2023,"Salernitana","Serie A","Tonny Vilhena","NED","MF","27",1995,25.2,44,22,16,23,5,20,50,40,30,17,7,10,18,62,21,0,"https://fbref.com/en/players/c7069d87/Tonny-Vilhena"
2023,"Sampdoria","Serie A","Bruno Amione","ARG","DF","20",2002,23.2,50,33,36,14,0,19,43,44.2,24,26,11,15,25,75,62,1,"https://fbref.com/en/players/2df7cc43/Bruno-Amione"
2023,"Sampdoria","Serie A","Emil Audero","ITA","GK","25",1997,25,0,0,0,0,0,0,2,0,2,0,0,0,0,0,7,1,"https://fbref.com/en/players/649b01d8/Emil-Audero"
2023,"Sampdoria","Serie A","Tommaso Augello","ITA","DF","27",1994,34,17,14,13,2,2,9,20,45,11,23,7,16,17,34,61,1,"https://fbref.com/en/players/3cd3b384/Tommaso-Augello"
2023,"Sampdoria","Serie A","Bartosz Bereszyński","POL","DF","30",1992,13.3,28,18,15,11,2,17,26,65.4,9,18,4,14,21,49,25,0,"https://fbref.com/en/players/61b3978f/Bartosz-Bereszynski"
2023,"Sampdoria","Serie A","Francesco Caputo","ITA","FW","34",1987,12.2,3,1,0,0,3,0,3,0,3,0,0,0,1,4,3,0,"https://fbref.com/en/players/5bd72174/Francesco-Caputo"
2023,"Sampdoria","Serie A","Omar Colley","GAM","DF","29",1992,15.4,17,10,10,7,0,9,12,75,3,9,5,4,22,39,69,1,"https://fbref.com/en/players/8b95acda/Omar-Colley"
2023,"Sampdoria","Serie A","Andrea Conti","ITA","DF","28",1994,0.3,0,0,0,0,0,0,0,NA,0,0,0,0,0,0,0,0,"https://fbref.com/en/players/8fef5412/Andrea-Conti"
2023,"Sampdoria","Serie A","Mickaël Cuisance","FRA","MF","22",1999,6.9,13,10,7,5,1,5,23,21.7,18,10,0,10,5,18,4,0,"https://fbref.com/en/players/5722eced/Mickael-Cuisance"
2023,"Sampdoria","Serie A","Manuel De Luca","ITA","FW,MF","24",1998,0.5,0,0,0,0,0,0,0,NA,0,0,0,0,0,0,0,0,"https://fbref.com/en/players/60e3603d/Manuel-De-Luca"
2023,"Sampdoria","Serie A","Fabio Depaoli","ITA","DF,MF","25",1997,1.5,5,3,2,3,0,3,4,75,1,1,0,1,1,6,4,0,"https://fbref.com/en/players/d97f2e8d/Fabio-Depaoli"
2023,"Sampdoria","Serie A","Alex Ferrari","ITA","DF","28",1994,9.6,9,5,7,2,0,4,8,50,4,21,10,11,19,28,25,0,"https://fbref.com/en/players/d0dbca9f/Alex-Ferrari"
2023,"Sampdoria","Serie A","Manolo Gabbiadini","ITA","FW,MF","30",1991,26.2,23,15,8,9,6,9,23,39.1,14,16,2,14,6,29,25,0,"https://fbref.com/en/players/8f866fe8/Manolo-Gabbiadini"
2023,"Sampdoria","Serie A","Koray Günter","GER","DF","27",1994,8.6,10,8,6,4,0,6,9,66.7,3,10,5,5,11,21,46,0,"https://fbref.com/en/players/f1f1f238/Koray-Gunter"
2023,"Sampdoria","Serie A","Emirhan İlkhan","TUR","MF","18",2004,1.3,6,3,2,2,2,2,3,66.7,1,5,1,4,0,6,3,0,"https://fbref.com/en/players/a47c6309/Emirhan-Ilkhan"
2023,"Sampdoria","Serie A","Mihailo Ivanović","SRB","FW","17",2004,0,0,0,0,0,0,0,0,NA,0,0,0,0,0,0,0,0,"https://fbref.com/en/players/71c620d7/Mihailo-Ivanovic"
2023,"Sampdoria","Serie A","Jesé","ESP","FW","29",1993,2.3,2,0,0,2,0,0,1,0,1,3,1,2,1,3,2,0,"https://fbref.com/en/players/4a537185/Jese"
2023,"Sampdoria","Serie A","Sam Lammers","NED","FW","25",1997,12.2,12,5,2,7,3,6,15,40,9,10,3,7,6,18,11,0,"https://fbref.com/en/players/c283ddef/Sam-Lammers"
2023,"Sampdoria","Serie A","Mehdi Léris","ALG","MF,DF","24",1998,27.3,63,46,30,24,9,23,55,41.8,32,38,6,32,27,90,34,0,"https://fbref.com/en/players/7d3cbc67/Mehdi-Leris"
2023,"Sampdoria","Serie A","Lorenzo Malagrida","ITA","MF,DF","18",2003,1.2,1,0,0,0,1,1,3,33.3,2,1,0,1,0,1,1,0,"https://fbref.com/en/players/2bffcbf2/Lorenzo-Malagrida"
2023,"Sampdoria","Serie A","Daniele Montevago","ITA","FW","19",2003,2.6,1,0,0,0,1,0,1,0,1,2,1,1,0,1,1,0,"https://fbref.com/en/players/ca73910d/Daniele-Montevago"
2023,"Sampdoria","Serie A","Jeison Murillo","COL","DF","30",1992,11.7,22,11,16,6,0,17,26,65.4,9,22,14,8,8,30,39,0,"https://fbref.com/en/players/b233e8e4/Jeison-Murillo"
2023,"Sampdoria","Serie A","Nicola Murru","ITA","DF","27",1994,8.7,24,14,15,8,1,7,13,53.8,6,17,7,10,10,34,21,0,"https://fbref.com/en/players/d183e9d6/Nicola-Murru"
2023,"Sampdoria","Serie A","Samuel Ntanda","BEL","MF","17",2005,0,0,0,0,0,0,0,0,NA,0,0,0,0,0,0,0,0,"https://fbref.com/en/players/48329ff8/Samuel-Ntanda"
2023,"Sampdoria","Serie A","Bram Nuytinck","NED","DF","32",1990,16.6,54,38,33,21,0,23,34,67.6,11,36,21,15,23,77,84,0,"https://fbref.com/en/players/e33f36d5/Bram-Nuytinck"
2023,"Sampdoria","Serie A","Marios Oikonomou","GRE","DF","29",1992,2.4,3,2,3,0,0,1,3,33.3,2,5,4,1,4,7,13,0,"https://fbref.com/en/players/3b9858f5/Marios-Oikonomou"
2023,"Sampdoria","Serie A","Flavio Paoletti","ITA","MF","19",2003,3.2,2,2,0,2,0,1,5,20,4,1,0,1,5,7,9,0,"https://fbref.com/en/players/3d6cee81/Flavio-Paoletti"
2023,"Sampdoria","Serie A","Ignacio Pussetto","ARG","MF,DF","26",1995,1.7,6,3,2,3,1,3,4,75,1,4,0,4,0,6,3,0,"https://fbref.com/en/players/62437b4f/Ignacio-Pussetto"
2023,"Sampdoria","Serie A","Fabio Quagliarella","ITA","FW","39",1983,8.9,2,1,1,1,0,1,7,14.3,6,5,1,4,0,2,9,0,"https://fbref.com/en/players/ee4f2f3b/Fabio-Quagliarella"
2023,"Sampdoria","Serie A","Nicola Ravaglia","ITA","GK","33",1988,9,0,0,0,0,0,0,1,0,1,0,0,0,0,0,7,0,"https://fbref.com/en/players/d7a35008/Nicola-Ravaglia"
2023,"Sampdoria","Serie A","Tomás Rincón","VEN","MF","34",1988,28.4,56,27,22,26,8,29,61,47.5,32,37,7,30,30,86,18,0,"https://fbref.com/en/players/f1cfc209/Tomas-Rincon"
2023,"Sampdoria","Serie A","Abdelhamid Sabiri","MAR","MF,FW","25",1996,11.9,18,7,5,9,4,4,13,30.8,9,18,4,14,2,20,5,0,"https://fbref.com/en/players/4830e0af/Abdelhamid-Sabiri"
2023,"Sampdoria","Serie A","Telasco Segovia","VEN","MF","19",2003,0,0,0,0,0,0,0,0,NA,0,0,0,0,0,0,0,0,"https://fbref.com/en/players/9142b22f/Telasco-Segovia"
2023,"Sampdoria","Serie A","Martin Turk","SVN","GK","18",2003,4,0,0,0,0,0,0,0,NA,0,0,0,0,0,0,1,0,"https://fbref.com/en/players/14ae023f/Martin-Turk"
2023,"Sampdoria","Serie A","Valerio Verre","ITA","MF","28",1994,7.5,14,7,6,5,3,8,17,47.1,9,9,1,8,9,23,3,0,"https://fbref.com/en/players/33ecf462/Valerio-Verre"
2023,"Sampdoria","Serie A","Ronaldo Vieira","GNB","MF","24",1998,9.1,NA,10,NA,NA,NA,NA,NA,NA,NA,NA,NA,NA,13,NA,NA,NA,"https://fbref.com/en/players/75e60d75/Ronaldo-Vieira"
2023,"Sampdoria","Serie A","Gonzalo Villar","ESP","MF","24",1998,7.7,13,7,4,8,1,7,15,46.7,8,11,3,8,4,17,9,1,"https://fbref.com/en/players/bdc74a8f/Gonzalo-Villar"
2023,"Sampdoria","Serie A","Harry Winks","ENG","MF","26",1996,19.1,27,12,7,18,2,14,43,32.6,29,14,8,6,24,51,24,0,"https://fbref.com/en/players/2f7acede/Harry-Winks"
2023,"Sampdoria","Serie A","Gerard Yepes","ESP","MF","19",2002,2.2,5,3,2,3,0,1,3,33.3,2,3,0,3,4,9,3,0,"https://fbref.com/en/players/ee9040b4/Gerard-Yepes"
2023,"Sampdoria","Serie A","Alessandro Zanoli","ITA","DF","21",2000,17.1,22,14,14,6,2,8,17,47.1,9,19,15,4,12,34,39,0,"https://fbref.com/en/players/3b12b11f/Alessandro-Zanoli"
2023,"Sampdoria","Serie A","Filip Đuričić","SRB","MF,FW","30",1992,24.1,43,22,18,20,5,14,32,43.8,18,19,6,13,7,50,8,0,"https://fbref.com/en/players/eccbe56a/Filip-Djuricic"
2023,"Sassuolo","Serie A","Agustín Álvarez Martínez","URU","FW,MF","21",2001,4.1,6,3,0,5,1,1,4,25,3,5,1,4,3,9,3,0,"https://fbref.com/en/players/ab472696/Agustin-Alvarez-Martinez"
2023,"Sassuolo","Serie A","Janis Antiste","FRA","FW","19",2002,0.6,1,0,1,0,0,1,1,100,0,0,0,0,0,1,0,0,"https://fbref.com/en/players/38d9ce53/Janis-Antiste"
2023,"Sassuolo","Serie A","Kaan Ayhan","TUR","DF","27",1994,6.1,10,4,6,4,0,7,7,100,0,5,4,1,5,15,26,1,"https://fbref.com/en/players/2200181e/Kaan-Ayhan"
2023,"Sassuolo","Serie A","Nedim Bajrami","ALB","FW,MF","23",1999,9.1,12,7,6,2,4,5,11,45.5,6,9,1,8,7,19,6,0,"https://fbref.com/en/players/f42d6c13/Nedim-Bajrami"
2023,"Sassuolo","Serie A","Domenico Berardi","ITA","FW","27",1994,20.7,23,14,8,10,5,9,40,22.5,31,13,0,13,19,42,18,0,"https://fbref.com/en/players/53a0e358/Domenico-Berardi"
2023,"Sassuolo","Serie A","Emil Ceide","NOR","FW","20",2001,5.7,5,2,5,0,0,3,5,60,2,3,1,2,1,6,0,0,"https://fbref.com/en/players/98a84572/Emil-Ceide"
2023,"Sassuolo","Serie A","Andrea Consigli","ITA","GK","35",1987,35,1,0,1,0,0,0,1,0,1,0,0,0,0,1,13,3,"https://fbref.com/en/players/8cabdc1e/Andrea-Consigli"
2023,"Sassuolo","Serie A","Luca D'Andrea","ITA","FW","17",2004,3.5,4,0,2,1,1,1,4,25,3,2,0,2,1,5,1,0,"https://fbref.com/en/players/f778fe3f/Luca-DAndrea"
2023,"Sassuolo","Serie A","Grégoire Defrel","MTQ","FW","31",1991,13,9,7,5,2,2,4,13,30.8,9,11,0,11,2,11,5,0,"https://fbref.com/en/players/854ee61a/Gregoire-Defrel"
2023,"Sassuolo","Serie A","Martin Erlic","CRO","DF","24",1998,25.9,27,16,18,8,1,10,23,43.5,13,36,23,13,31,58,120,1,"https://fbref.com/en/players/0fee6bda/Martin-Erlic"
2023,"Sassuolo","Serie A","Davide Frattesi","ITA","MF","22",1999,31.9,63,36,24,29,10,25,44,56.8,19,27,6,21,16,79,42,0,"https://fbref.com/en/players/2a7d27c1/Davide-Frattesi"
2023,"Sassuolo","Serie A","Abdou Harroui","NED","MF","24",1998,7.2,17,6,6,7,4,2,7,28.6,5,6,1,5,2,19,10,0,"https://fbref.com/en/players/65fd099c/Abdou-Harroui"
2023,"Sassuolo","Serie A","Matheus Henrique","BRA","MF","24",1997,21.6,26,12,9,11,6,12,24,50,12,15,4,11,12,38,10,0,"https://fbref.com/en/players/a2d9f138/Matheus-Henrique"
2023,"Sassuolo","Serie A","Hamed Junior Traorè","CIV","MF,FW","22",2000,6.6,11,6,4,6,1,4,11,36.4,7,4,0,4,2,13,0,1,"https://fbref.com/en/players/570bb4b9/Hamed-Junior-Traore"
2023,"Sassuolo","Serie A","Giorgos Kyriakopoulos","GRE","FW,DF","26",1996,8.5,21,8,7,9,5,10,14,71.4,4,7,1,6,11,32,12,1,"https://fbref.com/en/players/0a483542/Giorgos-Kyriakopoulos"
2023,"Sassuolo","Serie A","Armand Lauriente","FRA","FW","23",1998,24.2,21,15,5,7,9,8,21,38.1,13,20,0,20,12,33,8,0,"https://fbref.com/en/players/2d22cea7/Armand-Lauriente"
2023,"Sassuolo","Serie A","Maxime Lopez","FRA","MF","24",1997,25.5,42,18,26,12,4,16,56,28.6,40,24,6,18,22,64,21,0,"https://fbref.com/en/players/20094685/Maxime-Lopez"
2023,"Sassuolo","Serie A","Riccardo Marchizza","ITA","DF","24",1998,3.1,2,2,1,1,0,2,4,50,2,2,0,2,2,4,8,0,"https://fbref.com/en/players/91d0fabf/Riccardo-Marchizza"
2023,"Sassuolo","Serie A","Gian Marco Ferrari","ITA","DF","30",1992,24.7,23,16,11,10,2,10,17,58.8,7,29,20,9,23,46,81,4,"https://fbref.com/en/players/8650af85/Gian-Marco-Ferrari"
2023,"Sassuolo","Serie A","Mert Müldür","TUR","FW,DF","23",1999,0.1,0,0,0,0,0,0,0,NA,0,0,0,0,0,0,0,0,"https://fbref.com/en/players/1295552e/Mert-Muldur"
2023,"Sassuolo","Serie A","Pedro Obiang","EQG","MF","30",1992,9.7,26,17,12,12,2,10,18,55.6,8,12,2,10,8,34,15,0,"https://fbref.com/en/players/ba1e04b3/Pedro-Obiang"
2023,"Sassuolo","Serie A","Gianluca Pegolo","ITA","GK","41",1981,2,0,0,0,0,0,0,1,0,1,0,0,0,0,0,1,0,"https://fbref.com/en/players/f058ed1f/Gianluca-Pegolo"
2023,"Sassuolo","Serie A","Andrea Pinamonti","ITA","FW","23",1999,24,10,7,0,5,5,3,7,42.9,4,19,2,17,2,12,11,0,"https://fbref.com/en/players/08aa9cd1/Andrea-Pinamonti"
2023,"Sassuolo","Serie A","Giacomo Raspadori","ITA","FW","22",2000,0.5,0,0,0,0,0,0,0,NA,0,0,0,0,0,0,0,0,"https://fbref.com/en/players/6e058f06/Giacomo-Raspadori"
2023,"Sassuolo","Serie A","Rogério","BRA","DF","24",1998,33.3,37,21,22,8,7,17,35,48.6,18,32,9,23,37,74,70,0,"https://fbref.com/en/players/10e7f486/Rogerio"
2023,"Sassuolo","Serie A","Filippo Romagna","ITA","DF","25",1997,0.5,0,0,0,0,0,0,0,NA,0,1,1,0,0,0,2,0,"https://fbref.com/en/players/84594618/Filippo-Romagna"
2023,"Sassuolo","Serie A","Ruan","BRA","DF","23",1999,19,38,26,25,12,1,19,29,65.5,10,29,17,12,24,62,80,3,"https://fbref.com/en/players/a378a02a/Ruan"
2023,"Sassuolo","Serie A","Alessandro Russo","ITA","GK","21",2001,1,0,0,0,0,0,0,0,NA,0,0,0,0,0,0,1,1,"https://fbref.com/en/players/3945ac70/Alessandro-Russo"
2023,"Sassuolo","Serie A","Kristian Thorstvedt","NOR","MF","23",1999,12.6,16,7,4,9,3,6,17,35.3,11,19,5,14,14,30,13,0,"https://fbref.com/en/players/76ff8d0d/Kristian-Thorstvedt"
2023,"Sassuolo","Serie A","Jeremy Toljan","GER","DF","27",1994,29.7,36,23,17,14,5,22,33,66.7,11,31,14,17,18,54,60,1,"https://fbref.com/en/players/a96e5dc0/Jeremy-Toljan"
2023,"Sassuolo","Serie A","Nadir Zortea","ITA","DF","23",1999,7.3,15,8,12,2,1,9,14,64.3,5,10,4,6,4,19,21,0,"https://fbref.com/en/players/82598b71/Nadir-Zortea"
2023,"Schalke 04","Bundesliga","Éder Álvarez Balanta","COL","MF,FW","29",1993,2.6,5,4,2,3,0,2,6,33.3,4,0,0,0,3,8,4,0,"https://fbref.com/en/players/8ce30c57/Eder-Alvarez-Balanta"
2023,"Schalke 04","Bundesliga","Mehmet Aydin","GER","DF,FW","20",2002,6.3,25,18,14,9,2,11,24,45.8,13,11,0,11,10,35,15,0,"https://fbref.com/en/players/fe46e261/Mehmet-Aydin"
2023,"Schalke 04","Bundesliga","Cédric Brunner","SUI","DF","28",1994,25.7,39,27,26,11,2,30,45,66.7,15,24,7,17,43,82,79,0,"https://fbref.com/en/players/f0a37d36/Cedric-Brunner"
2023,"Schalke 04","Bundesliga","Marius Bülter","GER","FW,MF","29",1993,28.9,22,11,8,7,7,12,32,37.5,20,34,1,33,10,32,20,0,"https://fbref.com/en/players/ab5b7dc1/Marius-Bulter"
2023,"Schalke 04","Bundesliga","Kerim Calhanoglu","GER","DF","19",2002,0.7,2,1,2,0,0,2,2,100,0,1,0,1,0,2,3,0,"https://fbref.com/en/players/d1db4b83/Kerim-Calhanoglu"
2023,"Schalke 04","Bundesliga","Sepp van den Berg","NED","DF","20",2001,7.7,5,4,2,2,1,1,4,25,3,8,5,3,13,18,33,2,"https://fbref.com/en/players/7bf9400b/Sepp-van-den-Berg"
2023,"Schalke 04","Bundesliga","Dominick Drexler","GER","MF,FW","32",1990,15.2,25,17,12,10,3,9,22,40.9,13,18,2,16,8,33,12,0,"https://fbref.com/en/players/809940aa/Dominick-Drexler"
2023,"Schalke 04","Bundesliga","Ralf Fährmann","GER","GK","33",1988,11.4,1,0,1,0,0,1,1,100,0,0,0,0,0,1,10,2,"https://fbref.com/en/players/1e43fad8/Ralf-Fahrmann"
2023,"Schalke 04","Bundesliga","Florian Flick","GER","MF","22",2000,5.7,12,3,7,5,0,4,14,28.6,10,9,3,6,4,16,18,0,"https://fbref.com/en/players/9642c929/Florian-Flick"
2023,"Schalke 04","Bundesliga","Michael Frey","SUI","FW","28",1994,9.6,13,5,2,8,3,4,13,30.8,9,6,0,6,2,15,1,0,"https://fbref.com/en/players/33182cb8/Michael-Frey"
2023,"Schalke 04","Bundesliga","Leo Greiml","AUT","DF","21",2001,4,10,5,4,5,1,5,12,41.7,7,7,3,4,3,13,16,0,"https://fbref.com/en/players/f9dfb7ae/Leo-Greiml"
2023,"Schalke 04","Bundesliga","Andreas Ivan","ROU","MF","27",1995,0.5,0,0,0,0,0,0,1,0,1,0,0,0,0,0,1,0,"https://fbref.com/en/players/8bf58a80/Andreas-Ivan"
2023,"Schalke 04","Bundesliga","Moritz Jenz","GER","DF","23",1999,10.5,14,11,8,5,1,5,8,62.5,3,16,10,6,8,22,53,1,"https://fbref.com/en/players/ee644761/Moritz-Jenz"
2023,"Schalke 04","Bundesliga","Marcin Kamiński","POL","DF","30",1992,7,6,4,4,0,2,2,4,50,2,8,7,1,9,15,28,0,"https://fbref.com/en/players/463503e2/Marcin-Kaminski"
2023,"Schalke 04","Bundesliga","Kenan Karaman","TUR","FW","28",1994,10.8,11,8,3,5,3,3,12,25,9,9,1,8,3,14,9,0,"https://fbref.com/en/players/8f0f2230/Kenan-Karaman"
2023,"Schalke 04","Bundesliga","Timothée Kolodziejczak","FRA","DF","30",1991,0.3,0,0,0,0,0,0,1,0,1,0,0,0,1,1,1,0,"https://fbref.com/en/players/ab096c6f/Timothee-Kolodziejczak"
2023,"Schalke 04","Bundesliga","Soichiro Kozuki","JPN","FW,MF","21",2000,4.2,6,4,3,3,0,4,6,66.7,2,5,0,5,3,9,3,0,"https://fbref.com/en/players/f1e855eb/Soichiro-Kozuki"
2023,"Schalke 04","Bundesliga","Alex Král","CZE","MF","24",1998,26.2,34,24,10,22,2,17,37,45.9,20,31,6,25,17,51,53,0,"https://fbref.com/en/players/e717705a/Alex-Kral"
2023,"Schalke 04","Bundesliga","Tom Krauß","GER","MF","21",2001,27.9,112,68,39,62,11,51,100,51,49,39,6,33,36,148,35,0,"https://fbref.com/en/players/9f77012e/Tom-Krauss"
2023,"Schalke 04","Bundesliga","Jordan Larsson","SWE","FW,MF","25",1997,5.1,8,5,1,7,0,2,9,22.2,7,9,0,9,4,12,3,0,"https://fbref.com/en/players/72984eee/Jordan-Larsson"
2023,"Schalke 04","Bundesliga","Danny Latza","GER","MF","32",1989,9.5,17,13,8,8,1,5,17,29.4,12,16,1,15,5,22,15,0,"https://fbref.com/en/players/33b554b7/Danny-Latza"
2023,"Schalke 04","Bundesliga","Henning Matriciani","GER","DF","22",2000,20.7,43,23,28,12,3,26,60,43.3,34,28,11,17,23,66,57,1,"https://fbref.com/en/players/ab3f1bdf/Henning-Matriciani"
2023,"Schalke 04","Bundesliga","Keke Maximilian Topp","GER","FW","18",2004,0.2,0,0,0,0,0,0,0,NA,0,0,0,0,1,1,0,0,"https://fbref.com/en/players/ebb32f3a/Keke-Maximilian-Topp"
2023,"Schalke 04","Bundesliga","Tobias Mohr","GER","DF,MF","26",1995,9.3,8,5,3,5,0,2,7,28.6,5,14,5,9,8,16,19,0,"https://fbref.com/en/players/9ec9c8b6/Tobias-Mohr"
2023,"Schalke 04","Bundesliga","Florent Mollet","FRA","MF","30",1991,4.6,4,1,0,4,0,2,7,28.6,5,7,1,6,1,5,1,0,"https://fbref.com/en/players/7e82a78f/Florent-Mollet"
2023,"Schalke 04","Bundesliga","Thomas Ouwejan","NED","DF","25",1996,10,20,8,13,5,2,6,10,60,4,17,4,13,13,33,27,0,"https://fbref.com/en/players/36d9dabe/Thomas-Ouwejan"
2023,"Schalke 04","Bundesliga","Sebastian Polter","GER","FW","31",1991,7,4,3,0,4,0,1,4,25,3,4,0,4,1,5,6,0,"https://fbref.com/en/players/3745e8bd/Sebastian-Polter"
2023,"Schalke 04","Bundesliga","Sidi Sané","GER","FW","19",2003,0.3,1,1,1,0,0,1,1,100,0,0,0,0,0,1,0,0,"https://fbref.com/en/players/6a52a6c6/Sidi-Sane"
2023,"Schalke 04","Bundesliga","Alexander Schwolow","GER","GK","30",1992,22.6,0,0,0,0,0,0,2,0,2,0,0,0,1,1,6,3,"https://fbref.com/en/players/0d55d942/Alexander-Schwolow"
2023,"Schalke 04","Bundesliga","Tim Skarke","GER","FW,MF","25",1996,4.9,13,7,3,8,2,8,11,72.7,3,5,0,5,0,13,4,0,"https://fbref.com/en/players/65857fdf/Tim-Skarke"
2023,"Schalke 04","Bundesliga","Simon Terodde","GER","FW","34",1988,20.3,15,8,4,7,4,3,14,21.4,11,6,2,4,6,21,9,0,"https://fbref.com/en/players/863ff1ee/Simon-Terodde"
2023,"Schalke 04","Bundesliga","Malick Thiaw","GER","DF","20",2001,3,3,1,2,1,0,1,2,50,1,4,3,1,9,12,24,1,"https://fbref.com/en/players/ff5ea0bf/Malick-Thiaw"
2023,"Schalke 04","Bundesliga","Jere Uronen","FIN","DF","28",1994,7.5,14,10,6,6,2,6,10,60,4,5,2,3,8,22,13,0,"https://fbref.com/en/players/d75f3980/Jere-Uronen"
2023,"Schalke 04","Bundesliga","Maya Yoshida","JPN","DF","33",1988,28.4,34,22,19,13,2,18,29,62.1,11,40,29,11,46,80,132,2,"https://fbref.com/en/players/caffaf5a/Maya-Yoshida"
2023,"Schalke 04","Bundesliga","Rodrigo Zalazar","URU","MF,FW","22",1999,14.7,16,8,5,9,2,9,24,37.5,15,16,1,15,7,23,13,0,"https://fbref.com/en/players/fc3697dd/Rodrigo-Zalazar"
2023,"Sevilla","La Liga","Marcos Acuña","ARG","DF","30",1991,21.2,57,36,34,17,6,30,42,71.4,12,16,5,11,23,80,36,0,"https://fbref.com/en/players/81442ecb/Marcos-Acuna"
2023,"Sevilla","La Liga","Carlos Álvarez","ESP","FW","18",2003,0.1,NA,1,NA,NA,NA,NA,NA,NA,NA,NA,NA,NA,0,NA,NA,NA,"https://fbref.com/en/players/629081bd/Carlos-Alvarez"
2023,"Sevilla","La Liga","Loïc Bade","FRA","DF","22",2000,16.1,27,20,23,3,1,17,30,56.7,13,21,13,8,23,50,77,0,"https://fbref.com/en/players/114bbdee/Loic-Bade"
2023,"Sevilla","La Liga","Yassine Bounou","MAR","GK","31",1991,23.9,2,1,2,0,0,1,4,25,3,0,0,0,2,4,11,1,"https://fbref.com/en/players/f6798fc3/Yassine-Bounou"
2023,"Sevilla","La Liga","Carmona","ESP","DF","20",2002,5.9,13,11,5,3,5,9,16,56.3,7,10,6,4,7,20,17,1,"https://fbref.com/en/players/2dce876a/Carmona"
2023,"Sevilla","La Liga","Jesús Corona","MEX","FW","29",1993,1.2,1,0,1,0,0,0,1,0,1,0,0,0,1,2,1,0,"https://fbref.com/en/players/fb938d24/Jesus-Corona"
2023,"Sevilla","La Liga","Thomas Delaney","DEN","MF","30",1991,3.4,4,2,0,4,0,3,5,60,2,3,2,1,4,8,3,0,"https://fbref.com/en/players/fe641c1a/Thomas-Delaney"
2023,"Sevilla","La Liga","Marko Dmitrović","SRB","GK","30",1992,14.1,0,0,0,0,0,0,0,NA,0,0,0,0,0,0,6,0,"https://fbref.com/en/players/ac295d9e/Marko-Dmitrovic"
2023,"Sevilla","La Liga","Kasper Dolberg","DEN","FW","24",1997,2.2,1,0,0,1,0,1,3,33.3,2,0,0,0,0,1,5,0,"https://fbref.com/en/players/cc83b74d/Kasper-Dolberg"
2023,"Sevilla","La Liga","Youssef En-Nesyri","MAR","FW","25",1997,18.5,16,8,3,7,6,4,14,28.6,10,6,2,4,4,20,16,0,"https://fbref.com/en/players/04e17fd5/Youssef-En-Nesyri"
2023,"Sevilla","La Liga","Fernando","BRA","MF,DF","35",1987,17.5,34,23,14,17,3,18,30,60,12,21,10,11,24,58,29,0,"https://fbref.com/en/players/41f32541/Fernando"
2023,"Sevilla","La Liga","Bryan Gil","ESP","FW,DF","21",2001,10.2,22,11,11,7,4,10,23,43.5,13,10,0,10,8,30,10,0,"https://fbref.com/en/players/7b5ab7f2/Bryan-Gil"
2023,"Sevilla","La Liga","Papu Gómez","ARG","FW,MF","34",1988,11.8,6,4,3,3,0,2,10,20,8,8,1,7,4,10,5,0,"https://fbref.com/en/players/6e4df551/Papu-Gomez"
2023,"Sevilla","La Liga","Nemanja Gudelj","SRB","DF,MF","30",1991,30.9,43,33,22,18,3,20,33,60.6,13,39,29,10,34,77,102,1,"https://fbref.com/en/players/0076ab7f/Nemanja-Gudelj"
2023,"Sevilla","La Liga","Pape Gueye","SEN","MF","23",1999,13,37,22,13,21,3,16,33,48.5,17,21,5,16,22,59,10,0,"https://fbref.com/en/players/7155e3e1/Pape-Gueye"
2023,"Sevilla","La Liga","Isco","ESP","MF,FW","30",1992,8.9,15,9,6,5,4,8,14,57.1,6,3,0,3,10,25,3,0,"https://fbref.com/en/players/a0b4bb3e/Isco"
2023,"Sevilla","La Liga","Diego Iturralde","ESP","DF","19",2003,0.5,1,0,1,0,0,0,2,0,2,0,0,0,0,1,1,0,"https://fbref.com/en/players/9d33c71a/Diego-Iturralde"
2023,"Sevilla","La Liga","Adnan Januzaj","BEL","FW","27",1995,0.5,0,0,0,0,0,0,1,0,1,0,0,0,1,1,0,0,"https://fbref.com/en/players/4737cebe/Adnan-Januzaj"
2023,"Sevilla","La Liga","Joan Jordán","ESP","MF","28",1994,17.7,32,17,13,17,2,16,38,42.1,22,14,7,7,16,48,14,2,"https://fbref.com/en/players/2a0c8ba4/Joan-Jordan"
2023,"Sevilla","La Liga","Érik Lamela","ARG","FW,MF","30",1992,20.5,46,27,14,16,16,12,34,35.3,22,26,2,24,7,53,3,0,"https://fbref.com/en/players/abe66106/Erik-Lamela"
2023,"Sevilla","La Liga","Marcão","BRA","DF","26",1996,4.2,2,2,1,1,0,1,1,100,0,3,3,0,6,8,14,0,"https://fbref.com/en/players/133faa84/Marcao"
2023,"Sevilla","La Liga","Rafa Mir","ESP","FW","25",1997,14.4,8,2,2,4,2,2,5,40,3,5,1,4,4,12,11,0,"https://fbref.com/en/players/bbf5c11b/Rafa-Mir"
2023,"Sevilla","La Liga","Gonzalo Montiel","ARG","DF","25",1997,16.9,26,15,12,14,0,15,29,51.7,14,25,7,18,19,45,38,0,"https://fbref.com/en/players/374d5158/Gonzalo-Montiel"
2023,"Sevilla","La Liga","Jesús Navas","ESP","DF,FW","36",1985,22,19,12,8,3,8,11,22,50,11,18,7,11,22,41,52,1,"https://fbref.com/en/players/3f10bd22/Jesus-Navas"
2023,"Sevilla","La Liga","Tanguy Nianzou","FRA","DF","20",2002,15.2,20,15,10,9,1,8,11,72.7,3,8,5,3,16,36,44,3,"https://fbref.com/en/players/5853ac44/Tanguy-Nianzou"
2023,"Sevilla","La Liga","Lucas Ocampos","ARG","FW,MF","28",1994,12.9,22,14,9,9,4,8,31,25.8,23,17,2,15,8,30,5,0,"https://fbref.com/en/players/a08b974a/Lucas-Ocampos"
2023,"Sevilla","La Liga","Pedro Ortiz","ESP","MF","21",2000,0,0,0,0,0,0,0,0,NA,0,0,0,0,0,0,0,0,"https://fbref.com/en/players/f9358b61/Pedro-Ortiz"
2023,"Sevilla","La Liga","Ivan Rakitić","CRO","MF","34",1988,19.9,37,26,10,18,9,19,40,47.5,21,21,1,20,27,64,20,0,"https://fbref.com/en/players/89f951b5/Ivan-Rakitic"
2023,"Sevilla","La Liga","Karim Rekik","NED","DF","27",1994,13.1,11,5,8,3,0,4,5,80,1,12,5,7,10,21,24,0,"https://fbref.com/en/players/3376a776/Karim-Rekik"
2023,"Sevilla","La Liga","Iván Romero","ESP","MF","21",2001,0.1,0,0,0,0,0,0,0,NA,0,0,0,0,0,0,0,0,"https://fbref.com/en/players/2fbe6af0/Ivan-Romero"
2023,"Sevilla","La Liga","Kike Salas","ESP","DF","20",2002,4.1,1,1,1,0,0,0,0,NA,0,4,3,1,5,6,23,0,"https://fbref.com/en/players/0a69de7b/Kike-Salas"
2023,"Sevilla","La Liga","Manuel Sebastián","ESP","MF","18",2004,1.7,7,4,3,3,1,5,8,62.5,3,0,0,0,0,7,2,0,"https://fbref.com/en/players/c5642098/Manuel-Sebastian"
2023,"Sevilla","La Liga","Suso","ESP","MF,FW","28",1993,11.8,16,10,5,7,4,10,22,45.5,12,7,1,6,2,18,3,0,"https://fbref.com/en/players/4e219ad2/Suso"
2023,"Sevilla","La Liga","Alex Telles","BRA","DF","29",1992,15.9,21,13,15,6,0,13,25,52,12,17,5,12,20,41,38,0,"https://fbref.com/en/players/e73c9bb2/Alex-Telles"
2023,"Sevilla","La Liga","Óliver Torres","ESP","MF,FW","27",1994,23.7,39,23,12,13,14,18,59,30.5,41,26,5,21,10,49,10,0,"https://fbref.com/en/players/58a9a4d9/Oliver-Torres"
2023,"Southampton","Premier League","Che Adams","SCO","FW","26",1996,22.1,17,13,7,8,2,7,12,58.3,5,13,4,9,4,21,22,0,"https://fbref.com/en/players/f2bf1b0f/Che-Adams"
2023,"Southampton","Premier League","Carlos Alcaraz","ARG","MF,FW","19",2002,11.4,10,5,2,7,1,6,22,27.3,16,14,5,9,1,11,11,0,"https://fbref.com/en/players/4abac767/Carlos-Alcaraz"
2023,"Southampton","Premier League","Samuel Amo-Ameyaw","ENG","MF","16",2006,0,0,0,0,0,0,0,1,0,1,0,0,0,0,0,0,0,"https://fbref.com/en/players/9eedf0e0/Samuel-Amo-Ameyaw"
2023,"Southampton","Premier League","Joe Aribo","NGA","MF,FW","26",1996,13.6,31,20,15,12,4,11,20,55,9,14,1,13,10,41,11,0,"https://fbref.com/en/players/328f7d51/Joe-Aribo"
2023,"Southampton","Premier League","Adam Armstrong","ENG","FW,MF","25",1997,14.8,14,9,6,5,3,3,10,30,7,15,3,12,5,19,6,0,"https://fbref.com/en/players/68c720b5/Adam-Armstrong"
2023,"Southampton","Premier League","Stuart Armstrong","SCO","MF,FW","30",1992,15.6,32,21,15,13,4,14,39,35.9,25,18,0,18,10,42,9,1,"https://fbref.com/en/players/97333cf5/Stuart-Armstrong"
2023,"Southampton","Premier League","Dominic Ballard","ENG","FW,MF","17",2005,0.3,0,0,0,0,0,0,0,NA,0,0,0,0,1,1,0,0,"https://fbref.com/en/players/ed8d597c/Dominic-Ballard"
2023,"Southampton","Premier League","Gavin Bazunu","IRL","GK","20",2002,32,1,0,1,0,0,1,1,100,0,0,0,0,1,2,24,2,"https://fbref.com/en/players/c91441dc/Gavin-Bazunu"
2023,"Southampton","Premier League","Jan Bednarek","POL","DF","26",1996,18.6,27,21,20,7,0,12,16,75,4,38,27,11,49,76,87,0,"https://fbref.com/en/players/4115ce4e/Jan-Bednarek"
2023,"Southampton","Premier League","Armel Bella Kotchap","GER","DF","20",2001,20.9,37,17,28,9,0,15,20,75,5,29,12,17,44,81,110,0,"https://fbref.com/en/players/a39d11bc/Armel-Bella-Kotchap"
2023,"Southampton","Premier League","James Bree","ENG","DF","24",1997,4.1,5,3,4,1,0,3,4,75,1,3,1,2,6,11,11,0,"https://fbref.com/en/players/c07b7c5c/James-Bree"
2023,"Southampton","Premier League","Duje Ćaleta-Car","CRO","DF","25",1996,10.5,14,10,9,4,1,6,9,66.7,3,15,11,4,15,29,65,1,"https://fbref.com/en/players/94f8d10c/Duje-Caleta-Car"
2023,"Southampton","Premier League","Ibrahima Diallo","FRA","MF","23",1999,9.1,25,15,14,10,1,8,14,57.1,6,11,1,10,6,31,11,0,"https://fbref.com/en/players/11ff3d56/Ibrahima-Diallo"
2023,"Southampton","Premier League","Moussa Djenepo","MLI","DF,FW","24",1998,7.9,19,11,13,5,1,11,26,42.3,15,19,2,17,11,30,7,0,"https://fbref.com/en/players/254147d4/Moussa-Djenepo"
2023,"Southampton","Premier League","Kami Doyle","ENG","MF","16",2005,0.1,0,0,0,0,0,0,0,NA,0,0,0,0,0,0,0,0,"https://fbref.com/en/players/65983e4d/Kami-Doyle"
2023,"Southampton","Premier League","Samuel Edozie","ENG","FW,MF","19",2003,6.3,17,10,6,10,1,3,8,37.5,5,7,0,7,6,23,6,0,"https://fbref.com/en/players/007414dd/Samuel-Edozie"
2023,"Southampton","Premier League","Mohamed Elyounoussi","NOR","MF,FW","27",1994,24.1,46,28,22,20,4,19,43,44.2,24,40,3,37,27,73,37,0,"https://fbref.com/en/players/68dc0dac/Mohamed-Elyounoussi"
2023,"Southampton","Premier League","Juan Larios","ESP","DF","18",2004,1.7,7,6,6,1,0,5,5,100,0,2,0,2,3,10,4,0,"https://fbref.com/en/players/cf7fb13a/Juan-Larios"
2023,"Southampton","Premier League","Roméo Lavia","BEL","MF","18",2004,24.7,60,35,27,29,4,21,53,39.6,32,47,11,36,33,93,23,1,"https://fbref.com/en/players/ecad9aa5/Romeo-Lavia"
2023,"Southampton","Premier League","Valentino Livramento","ENG","DF,FW","19",2002,0.3,2,1,2,0,0,0,0,NA,0,0,0,0,2,4,3,0,"https://fbref.com/en/players/afed6722/Valentino-Livramento"
2023,"Southampton","Premier League","Lyanco","BRA","DF","25",1997,13.1,24,16,15,9,0,12,18,66.7,6,30,25,5,20,44,65,2,"https://fbref.com/en/players/b5bf1770/Lyanco"
2023,"Southampton","Premier League","Ainsley Maitland-Niles","ENG","DF,MF","24",1997,15.6,45,24,23,18,4,28,44,63.6,16,28,7,21,22,67,45,1,"https://fbref.com/en/players/e3a5814e/Ainsley-Maitland-Niles"
2023,"Southampton","Premier League","Sekou Mara","FRA","FW,MF","20",2002,6.2,14,10,5,8,1,3,9,33.3,6,11,0,11,1,15,5,0,"https://fbref.com/en/players/3544641e/Sekou-Mara"
2023,"Southampton","Premier League","Alex McCarthy","ENG","GK","32",1989,6,0,0,0,0,0,0,1,0,1,0,0,0,1,1,3,1,"https://fbref.com/en/players/36c2ca73/Alex-McCarthy"
2023,"Southampton","Premier League","Paul Onuachu","NGA","FW","28",1994,4.5,3,2,1,1,1,1,3,33.3,2,4,1,3,0,3,4,0,"https://fbref.com/en/players/c06d1086/Paul-Onuachu"
2023,"Southampton","Premier League","Mislav Oršić","CRO","MF","29",1992,0.1,1,1,1,0,0,0,0,NA,0,0,0,0,0,1,0,0,"https://fbref.com/en/players/ee950928/Mislav-Orsic"
2023,"Southampton","Premier League","Romain Perraud","FRA","DF","24",1997,20.4,54,33,23,23,8,28,52,53.8,24,24,6,18,20,74,42,0,"https://fbref.com/en/players/6dfd8f05/Romain-Perraud"
2023,"Southampton","Premier League","Nathan Redmond","ENG","DF","28",1994,0,0,0,0,0,0,0,0,NA,0,0,0,0,0,0,0,0,"https://fbref.com/en/players/ab651565/Nathan-Redmond"
2023,"Southampton","Premier League","Oriol Romeu","ESP","MF","30",1991,0.8,1,0,0,1,0,0,0,NA,0,1,0,1,1,2,1,0,"https://fbref.com/en/players/4b511457/Oriol-Romeu"
2023,"Southampton","Premier League","Mohammed Salisu","GHA","DF","23",1999,21.9,51,29,33,16,2,24,34,70.6,10,56,25,31,31,82,122,1,"https://fbref.com/en/players/0b33f6ad/Mohammed-Salisu"
2023,"Southampton","Premier League","Jack Stephens","ENG","DF","28",1994,0.5,2,2,2,0,0,1,1,100,0,1,1,0,1,3,2,0,"https://fbref.com/en/players/6adbc307/Jack-Stephens"
2023,"Southampton","Premier League","Kamaldeen Sulemana","GHA","FW,MF","20",2002,10.7,15,9,4,7,4,4,14,28.6,10,16,0,16,6,21,6,0,"https://fbref.com/en/players/a62f8bf1/Kamaldeen-Sulemana"
2023,"Southampton","Premier League","Yan Valery","TUN","DF","23",1999,0.5,0,0,0,0,0,0,0,NA,0,1,0,1,0,0,3,0,"https://fbref.com/en/players/531a4aa8/Yan-Valery"
2023,"Southampton","Premier League","Theo Walcott","ENG","FW,MF","33",1989,12.5,13,6,8,4,1,8,27,29.6,19,8,1,7,9,22,7,0,"https://fbref.com/en/players/1ecb65be/Theo-Walcott"
2023,"Southampton","Premier League","Kyle Walker-Peters","ENG","DF","25",1997,29.4,61,32,34,24,3,22,42,52.4,20,47,8,39,27,88,52,0,"https://fbref.com/en/players/984a5a64/Kyle-Walker-Peters"
2023,"Southampton","Premier League","James Ward-Prowse","ENG","MF","27",1994,37.5,65,37,31,27,7,21,61,34.4,40,30,10,20,55,120,48,0,"https://fbref.com/en/players/3515d404/James-Ward-Prowse"
2023,"Spezia","Serie A","Kevin Agudelo","COL","MF,FW","23",1998,23.7,71,38,22,30,19,25,59,42.4,34,39,5,34,10,81,6,0,"https://fbref.com/en/players/46fa7204/Kevin-Agudelo"
2023,"Spezia","Serie A","Kelvin Amian","FRA","DF","24",1998,26.4,54,32,33,12,9,24,31,77.4,7,34,12,22,22,76,87,1,"https://fbref.com/en/players/bcc81786/Kelvin-Amian"
2023,"Spezia","Serie A","Ethan Ampadu","WAL","DF,MF","21",2000,29.3,66,37,33,28,5,17,41,41.5,24,48,23,25,36,102,98,0,"https://fbref.com/en/players/10b9fa99/Ethan-Ampadu"
2023,"Spezia","Serie A","Simone Bastoni","ITA","MF,DF","25",1996,13.2,47,24,23,19,5,15,33,45.5,18,20,5,15,8,55,14,0,"https://fbref.com/en/players/1ac232b8/Simone-Bastoni"
2023,"Spezia","Serie A","Julius Beck","DEN","MF","17",2005,0.1,2,1,1,1,0,0,0,NA,0,0,0,0,0,2,0,0,"https://fbref.com/en/players/e892c325/Julius-Beck"
2023,"Spezia","Serie A","Mehdi Bourabia","MAR","MF","30",1991,30.8,41,20,13,22,6,19,41,46.3,22,39,12,27,32,73,57,0,"https://fbref.com/en/players/0d077b88/Mehdi-Bourabia"
2023,"Spezia","Serie A","Mattia Caldara","ITA","DF","28",1994,13.9,23,14,10,11,2,9,20,45,11,23,16,7,17,40,88,2,"https://fbref.com/en/players/ac7e640b/Mattia-Caldara"
2023,"Spezia","Serie A","Tio Cipot","SVN","FW,MF","19",2003,1.5,12,7,6,3,3,6,8,75,2,0,0,0,0,12,2,0,"https://fbref.com/en/players/039a4fb6/Tio-Cipot"
2023,"Spezia","Serie A","Bartłomiej Drągowski","POL","GK","24",1997,32.7,1,0,1,0,0,1,5,20,4,0,0,0,1,2,15,3,"https://fbref.com/en/players/085e71a7/Bartlomiej-Dragowski"
2023,"Spezia","Serie A","Albin Ekdal","SWE","MF","33",1989,19.3,37,20,14,20,3,19,45,42.2,26,24,2,22,26,63,36,0,"https://fbref.com/en/players/f503ea63/Albin-Ekdal"
2023,"Spezia","Serie A","Mikael Ellertsson","ISL","MF,DF","20",2002,1.9,4,2,1,3,0,0,3,0,3,2,1,1,2,6,0,0,"https://fbref.com/en/players/c55967eb/Mikael-Ellertsson"
2023,"Spezia","Serie A","Salvatore Esposito","ITA","MF","21",2000,10.8,15,12,8,5,2,5,21,23.8,16,9,1,8,11,26,18,0,"https://fbref.com/en/players/5cf5c9ad/Salvatore-Esposito"
2023,"Spezia","Serie A","Salvador Ferrer","ESP","DF","24",1998,1.5,4,2,2,2,0,1,3,33.3,2,3,1,2,1,5,4,0,"https://fbref.com/en/players/eb76987d/Salvador-Ferrer"
2023,"Spezia","Serie A","Emmanuel Gyasi","GHA","FW,DF","28",1994,31.2,24,15,11,10,3,9,36,25,27,24,6,18,8,32,26,0,"https://fbref.com/en/players/f9758dae/Emmanuel-Gyasi"
2023,"Spezia","Serie A","Emil Holm","SWE","DF","22",2000,15.5,26,15,13,8,5,16,31,51.6,15,21,6,15,9,35,41,0,"https://fbref.com/en/players/c2357b65/Emil-Holm"
2023,"Spezia","Serie A","Petko Hristov","BUL","DF","23",1999,4.1,6,4,2,4,0,5,8,62.5,3,4,2,2,4,10,12,0,"https://fbref.com/en/players/d8800a46/Petko-Hristov"
2023,"Spezia","Serie A","Jakub Kiwior","POL","DF","22",2000,16,22,17,15,7,0,6,24,25,18,26,18,8,24,46,71,1,"https://fbref.com/en/players/dc3e663e/Jakub-Kiwior"
2023,"Spezia","Serie A","Viktor Kovalenko","UKR","MF","26",1996,6.1,9,5,1,6,2,5,8,62.5,3,11,2,9,4,13,7,0,"https://fbref.com/en/players/9d60028d/Viktor-Kovalenko"
2023,"Spezia","Serie A","Raimonds Krollis","LVA","FW,DF","20",2001,0.4,1,1,0,0,1,0,1,0,1,0,0,0,0,1,0,0,"https://fbref.com/en/players/b4101c2e/Raimonds-Krollis"
2023,"Spezia","Serie A","Daniel Maldini","ITA","FW,MF","20",2001,7,12,5,3,4,5,4,11,36.4,7,9,0,9,1,13,8,0,"https://fbref.com/en/players/801831fe/Daniel-Maldini"
2023,"Spezia","Serie A","Federico Marchetti","ITA","GK","39",1983,0.7,0,0,0,0,0,0,0,NA,0,0,0,0,0,0,0,0,"https://fbref.com/en/players/f794b426/Federico-Marchetti"
2023,"Spezia","Serie A","João Moutinho","POR","DF,FW","24",1998,0.6,7,1,5,1,1,3,4,75,1,1,1,0,0,7,0,0,"https://fbref.com/en/players/a0aee24e/Joao-Moutinho"
2023,"Spezia","Serie A","Dimitris Nikolaou","GRE","DF","23",1998,32.9,45,32,31,10,4,25,37,67.6,12,41,26,15,27,72,82,0,"https://fbref.com/en/players/cf961d8d/Dimitris-Nikolaou"
2023,"Spezia","Serie A","M'Bala Nzola","ANG","FW","25",1996,29.5,12,5,0,6,6,3,9,33.3,6,20,6,14,7,19,21,0,"https://fbref.com/en/players/a4948e67/MBala-Nzola"
2023,"Spezia","Serie A","Arkadiusz Reca","POL","DF","27",1995,24.1,44,28,22,12,10,19,32,59.4,13,21,5,16,24,68,54,0,"https://fbref.com/en/players/6213fd82/Arkadiusz-Reca"
2023,"Spezia","Serie A","Jacopo Sala","ITA","MF","30",1991,1.2,1,0,1,0,0,0,2,0,2,2,0,2,1,2,2,0,"https://fbref.com/en/players/da5a981b/Jacopo-Sala"
2023,"Spezia","Serie A","Leandro Sanca","GNB","FW,MF","22",2000,0.4,1,1,0,0,1,1,1,100,0,0,0,0,0,1,0,0,"https://fbref.com/en/players/4295f19c/Leandro-Sanca"
2023,"Spezia","Serie A","Eldor Shomurodov","UZB","FW","27",1995,9,5,5,3,1,1,2,11,18.2,9,5,1,4,3,8,4,0,"https://fbref.com/en/players/57469b2d/Eldor-Shomurodov"
2023,"Spezia","Serie A","Dávid Strelec","SVK","FW","21",2001,1.9,2,2,0,1,1,2,2,100,0,0,0,0,0,2,0,0,"https://fbref.com/en/players/2cb9486d/David-Strelec"
2023,"Spezia","Serie A","Daniele Verde","ITA","FW,MF","26",1996,11.1,4,4,3,0,1,3,7,42.9,4,6,0,6,8,12,4,0,"https://fbref.com/en/players/d3298c99/Daniele-Verde"
2023,"Spezia","Serie A","Przemysław Wiśniewski","POL","DF","24",1998,11.1,13,6,7,6,0,6,18,33.3,12,16,8,8,11,24,66,0,"https://fbref.com/en/players/1bfe5ac9/Przemyslaw-Wisniewski"
2023,"Spezia","Serie A","Jeroen Zoet","NED","GK","31",1991,3.7,1,1,1,0,0,1,1,100,0,0,0,0,0,1,1,0,"https://fbref.com/en/players/cc1a0c57/Jeroen-Zoet"
2023,"Spezia","Serie A","Petar Zovko","BIH","GK","20",2002,0.8,1,0,1,0,0,1,1,100,0,0,0,0,0,1,0,0,"https://fbref.com/en/players/54f6afe3/Petar-Zovko"
2023,"Spezia","Serie A","Szymon Żurkowski","POL","MF","24",1997,4.7,9,3,4,4,1,2,15,13.3,13,9,2,7,4,13,6,0,"https://fbref.com/en/players/4e1d5e59/Szymon-Zurkowski"
2023,"Strasbourg","Ligue 1","Jean-Eudes Aholou","CIV","MF","28",1994,14.4,34,20,10,20,4,12,31,38.7,19,25,0,25,24,58,15,0,"https://fbref.com/en/players/48b28bfd/Jean-Eudes-Aholou"
2023,"Strasbourg","Ligue 1","Ludovic Ajorque","FRA","FW","28",1994,8.6,5,4,1,4,0,3,9,33.3,6,3,1,2,2,7,7,0,"https://fbref.com/en/players/462475ed/Ludovic-Ajorque"
2023,"Strasbourg","Ligue 1","Jean-Ricner Bellegarde","FRA","MF,FW","24",1998,26.9,47,25,15,21,11,11,25,44,14,26,3,23,26,73,22,0,"https://fbref.com/en/players/10f0fdd3/Jean-Ricner-Bellegarde"
2023,"Strasbourg","Ligue 1","Franci Bouebari","FRA","DF","18",2003,0.8,3,0,1,2,0,3,5,60,2,0,0,0,2,5,2,0,"https://fbref.com/en/players/4fb18ca4/Franci-Bouebari"
2023,"Strasbourg","Ligue 1","Colin Dagba","FRA","DF,MF","23",1998,10.6,32,20,17,10,5,19,26,73.1,7,18,2,16,17,49,19,0,"https://fbref.com/en/players/29c02c9f/Colin-Dagba"
2023,"Strasbourg","Ligue 1","Thomas Delaine","FRA","DF,MF","30",1992,11.9,28,14,16,6,6,13,26,50,13,8,3,5,16,44,9,0,"https://fbref.com/en/players/8332db56/Thomas-Delaine"
2023,"Strasbourg","Ligue 1","Habib Diallo","SEN","FW","27",1995,32,18,10,8,7,3,6,16,37.5,10,19,4,15,12,30,26,0,"https://fbref.com/en/players/6605d143/Habib-Diallo"
2023,"Strasbourg","Ligue 1","Mouhamadou Diarra","SEN","MF,FW","18",2004,18.1,24,16,10,11,3,15,29,51.7,14,17,1,16,11,35,13,0,"https://fbref.com/en/players/6d0fe035/Mouhamadou-Diarra"
2023,"Strasbourg","Ligue 1","Alexander Djiku","GHA","DF","27",1994,29.7,53,36,37,16,0,26,46,56.5,20,45,19,26,66,119,151,3,"https://fbref.com/en/players/43e7a164/Alexander-Djiku"
2023,"Strasbourg","Ligue 1","Ismaël Doukouré","FRA","DF,MF","19",2003,25.5,48,24,23,21,4,20,34,58.8,14,26,8,18,27,75,54,0,"https://fbref.com/en/players/0512a60a/Ismael-Doukoure"
2023,"Strasbourg","Ligue 1","Karol Fila","POL","DF","24",1998,0.5,0,0,0,0,0,0,0,NA,0,0,0,0,1,1,1,0,"https://fbref.com/en/players/50ac8941/Karol-Fila"
2023,"Strasbourg","Ligue 1","Kévin Gameiro","FRA","FW","35",1987,23.3,20,10,6,10,4,8,28,28.6,20,10,1,9,9,29,0,0,"https://fbref.com/en/players/42276181/Kevin-Gameiro"
2023,"Strasbourg","Ligue 1","Frederic Guilbert","FRA","DF","27",1994,16.2,47,29,18,23,6,25,43,58.1,18,24,3,21,43,90,33,1,"https://fbref.com/en/players/5d8d7454/Frederic-Guilbert"
2023,"Strasbourg","Ligue 1","Dany Jean","HAI","DF,MF","19",2002,0.1,0,0,0,0,0,0,1,0,1,1,0,1,0,0,0,0,"https://fbref.com/en/players/300ec91c/Dany-Jean"
2023,"Strasbourg","Ligue 1","Nordine Kandil","FRA","MF,FW","20",2001,1.1,3,2,1,2,0,0,3,0,3,2,0,2,1,4,1,0,"https://fbref.com/en/players/c5908bc4/Nordine-Kandil"
2023,"Strasbourg","Ligue 1","Maxime Le Marchand","FRA","DF","32",1989,22.4,39,24,23,14,2,19,31,61.3,12,22,14,8,37,76,74,0,"https://fbref.com/en/players/321a71a7/Maxime-Le-Marchand"
2023,"Strasbourg","Ligue 1","Dimitri Liénard","FRA","DF,MF","34",1988,17.1,46,29,20,18,8,34,57,59.6,23,28,4,24,16,62,24,0,"https://fbref.com/en/players/f7691f63/Dimitri-Lienard"
2023,"Strasbourg","Ligue 1","Lebo Mothiba","RSA","FW,MF","26",1996,4.8,1,0,1,0,0,0,1,0,1,6,1,5,0,1,4,0,"https://fbref.com/en/players/3eaf8817/Lebo-Mothiba"
2023,"Strasbourg","Ligue 1","Gerzino Nyamsi","FRA","DF","25",1997,17.5,28,20,14,12,2,10,12,83.3,2,19,11,8,10,38,63,1,"https://fbref.com/en/players/6043997c/Gerzino-Nyamsi"
2023,"Strasbourg","Ligue 1","Lucas Perrin","FRA","DF","23",1998,19.6,44,27,28,14,2,25,49,51,24,13,5,8,36,80,53,0,"https://fbref.com/en/players/49070d66/Lucas-Perrin"
2023,"Strasbourg","Ligue 1","Ronaël Pierre-Gabriel","FRA","DF","24",1998,7.3,25,18,11,12,2,15,17,88.2,2,16,3,13,9,34,22,0,"https://fbref.com/en/players/64ba07c0/Ronael-Pierre-Gabriel"
2023,"Strasbourg","Ligue 1","Sanjin Prcić","BIH","MF","28",1993,18.1,27,12,6,16,5,19,31,61.3,12,22,7,15,25,52,22,0,"https://fbref.com/en/players/51c30111/Sanjin-Prcic"
2023,"Strasbourg","Ligue 1","Morgan Sanson","FRA","MF","27",1994,15.8,36,25,10,16,10,17,56,30.4,39,21,1,20,22,58,9,0,"https://fbref.com/en/players/6e7f1353/Morgan-Sanson"
2023,"Strasbourg","Ligue 1","Matz Sels","BEL","GK","30",1992,38,4,3,4,0,0,4,4,100,0,0,0,0,4,8,23,0,"https://fbref.com/en/players/834b5c4c/Matz-Sels"
2023,"Strasbourg","Ligue 1","Marvin Senaya","TOG","DF","21",2001,0.1,0,0,0,0,0,0,1,0,1,1,0,1,0,0,1,0,"https://fbref.com/en/players/1d383c10/Marvin-Senaya"
2023,"Strasbourg","Ligue 1","Ibrahima Sissoko","FRA","MF","24",1997,14.6,40,22,18,17,5,22,42,52.4,20,20,6,14,10,50,19,0,"https://fbref.com/en/players/0f8418aa/Ibrahima-Sissoko"
2023,"Strasbourg","Ligue 1","Eduard Sobol","UKR","DF","27",1995,9.7,19,10,10,6,3,9,13,69.2,4,10,1,9,8,27,19,0,"https://fbref.com/en/players/2ccd89a3/Eduard-Sobol"
2023,"Strasbourg","Ligue 1","Yuito Suzuki","JPN","FW,MF","20",2001,0.4,0,0,0,0,0,0,0,NA,0,3,0,3,0,0,0,0,"https://fbref.com/en/players/c25a7a2a/Yuito-Suzuki"
2023,"Strasbourg","Ligue 1","Adrien Thomasson","FRA","MF","28",1993,10.4,19,9,8,6,5,9,30,30,21,18,0,18,3,22,2,0,"https://fbref.com/en/players/c76b7567/Adrien-Thomasson"
2023,"Stuttgart","Bundesliga","Naouirou Ahamada","FRA","MF","20",2002,15.5,17,11,7,7,3,8,20,40,12,16,5,11,8,25,7,0,"https://fbref.com/en/players/a6c58494/Naouirou-Ahamada"
2023,"Stuttgart","Bundesliga","Waldemar Anton","GER","DF","26",1996,32.6,49,27,27,19,3,27,51,52.9,24,44,16,28,38,87,123,2,"https://fbref.com/en/players/5e66fa06/Waldemar-Anton"
2023,"Stuttgart","Bundesliga","Gil Bastião Dias","POR","FW","25",1996,4.4,8,6,3,4,1,3,12,25,9,7,0,7,2,10,3,0,"https://fbref.com/en/players/e61bdd69/Gil-Bastiao-Dias"
2023,"Stuttgart","Bundesliga","Fabian Bredlow","GER","GK","27",1995,15,1,1,1,0,0,1,1,100,0,0,0,0,0,1,4,2,"https://fbref.com/en/players/d28339cb/Fabian-Bredlow"
2023,"Stuttgart","Bundesliga","Darko Churlinov","MKD","FW","22",2000,0.3,3,2,2,1,0,2,3,66.7,1,1,0,1,0,3,0,0,"https://fbref.com/en/players/c6608135/Darko-Churlinov"
2023,"Stuttgart","Bundesliga","Tanguy Coulibaly","FRA","FW,DF","21",2001,3.6,12,9,9,1,2,5,12,41.7,7,10,0,10,3,15,0,0,"https://fbref.com/en/players/05ba9d7c/Tanguy-Coulibaly"
2023,"Stuttgart","Bundesliga","Lilian Egloff","GER","MF,FW","19",2002,2.7,12,10,4,5,3,4,6,66.7,2,2,0,2,1,13,1,0,"https://fbref.com/en/players/2f7fec15/Lilian-Egloff"
2023,"Stuttgart","Bundesliga","Wataru Endo","JPN","MF","29",1993,32.5,70,37,30,31,9,38,85,44.7,47,44,6,38,26,96,63,0,"https://fbref.com/en/players/c149016b/Wataru-Endo"
2023,"Stuttgart","Bundesliga","Chris Führich","GER","FW,MF","24",1998,20.9,36,14,15,14,7,24,44,54.5,20,29,2,27,7,43,13,0,"https://fbref.com/en/players/0cf778df/Chris-Fuhrich"
2023,"Stuttgart","Bundesliga","Sehrou Guirassy","GUI","FW","26",1996,18.3,4,1,2,2,0,1,2,50,1,7,2,5,0,4,14,0,"https://fbref.com/en/players/923f4dda/Sehrou-Guirassy"
2023,"Stuttgart","Bundesliga","Genki Haraguchi","JPN","MF","31",1991,8.3,16,7,7,7,2,4,16,25,12,13,2,11,8,24,6,0,"https://fbref.com/en/players/f24ea523/Genki-Haraguchi"
2023,"Stuttgart","Bundesliga","Hiroki Ito","JPN","DF","23",1999,28.5,40,29,24,14,2,18,35,51.4,17,38,17,21,40,80,94,0,"https://fbref.com/en/players/204dded0/Hiroki-Ito"
2023,"Stuttgart","Bundesliga","Sasa Kalajdzic","AUT","FW","25",1997,2.6,3,2,0,1,2,1,3,33.3,2,1,0,1,0,3,0,0,"https://fbref.com/en/players/15f24fe7/Sasa-Kalajdzic"
2023,"Stuttgart","Bundesliga","Atakan Karazor","GER","MF","25",1996,21.8,49,30,18,25,6,24,47,51.1,23,39,11,28,31,80,44,0,"https://fbref.com/en/players/5762be5c/Atakan-Karazor"
2023,"Stuttgart","Bundesliga","Thomas Kastanaras","GRE","FW,DF","19",2003,0.8,0,0,0,0,0,0,0,NA,0,1,0,1,0,0,0,0,"https://fbref.com/en/players/778ccc44/Thomas-Kastanaras"
2023,"Stuttgart","Bundesliga","Silas Katompa","COD","FW,MF","23",1998,22.1,25,17,5,14,6,6,20,30,14,17,2,15,8,33,1,0,"https://fbref.com/en/players/de4cac2d/Silas-Katompa"
2023,"Stuttgart","Bundesliga","Alou Kuol","AUS","FW","21",2000,0.1,0,0,0,0,0,0,0,NA,0,0,0,0,0,0,0,0,"https://fbref.com/en/players/f1bc3876/Alou-Kuol"
2023,"Stuttgart","Bundesliga","Konstantinos Mavropanos","GRE","DF","24",1997,25.4,50,27,32,15,3,28,38,73.7,10,39,18,21,63,113,99,0,"https://fbref.com/en/players/00963611/Konstantinos-Mavropanos"
2023,"Stuttgart","Bundesliga","Enzo Millot","FRA","MF","20",2002,9.9,23,16,9,10,4,12,19,63.2,7,20,3,17,12,35,7,0,"https://fbref.com/en/players/f76022e7/Enzo-Millot"
2023,"Stuttgart","Bundesliga","Clinton Mola","ENG","DF","21",2001,0.2,3,1,2,1,0,1,1,100,0,1,1,0,1,4,2,0,"https://fbref.com/en/players/29ddfb9c/Clinton-Mola"
2023,"Stuttgart","Bundesliga","Florian Müller","GER","GK","24",1997,19,0,0,0,0,0,0,0,NA,0,0,0,0,0,0,7,4,"https://fbref.com/en/players/cbac6ec9/Florian-Muller"
2023,"Stuttgart","Bundesliga","Nikolas Nartey","DEN","DF,MF","22",2000,5.3,11,6,7,3,1,5,9,55.6,4,9,0,9,4,15,12,0,"https://fbref.com/en/players/30261ba1/Nikolas-Nartey"
2023,"Stuttgart","Bundesliga","Juan Perea","COL","FW","22",2000,4.6,5,4,0,2,3,2,4,50,2,2,1,1,1,6,3,0,"https://fbref.com/en/players/ff3d391c/Juan-Perea"
2023,"Stuttgart","Bundesliga","Luca Pfeiffer","GER","FW","25",1996,7.8,1,1,1,0,0,0,1,0,1,4,0,4,1,2,5,0,"https://fbref.com/en/players/83e1f40e/Luca-Pfeiffer"
2023,"Stuttgart","Bundesliga","Borna Sosa","CRO","DF","24",1998,21.7,27,21,18,8,1,21,32,65.6,11,20,5,15,19,46,37,0,"https://fbref.com/en/players/af0d79a9/Borna-Sosa"
2023,"Stuttgart","Bundesliga","Pascal Stenzel","GER","DF","26",1996,3.7,12,8,8,4,0,5,9,55.6,4,9,2,7,5,17,6,0,"https://fbref.com/en/players/99f7e9aa/Pascal-Stenzel"
2023,"Stuttgart","Bundesliga","Tiago Tomás","POR","FW,MF","20",2002,14.3,10,4,2,4,4,8,13,61.5,5,9,2,7,1,11,5,0,"https://fbref.com/en/players/b492126a/Tiago-Tomas"
2023,"Stuttgart","Bundesliga","Lauren Ulrich","GER","MF","17",2005,0.1,1,1,0,0,1,0,0,NA,0,0,0,0,0,1,0,0,"https://fbref.com/en/players/cd61c7af/Lauren-Ulrich"
2023,"Stuttgart","Bundesliga","Josha Vagnoman","GER","DF","21",2000,16.4,26,15,12,11,3,15,27,55.6,12,20,2,18,8,34,29,1,"https://fbref.com/en/players/fb377d11/Josha-Vagnoman"
2023,"Stuttgart","Bundesliga","Dan-Axel Zagadou","FRA","DF","23",1999,14.1,14,9,10,4,0,5,14,35.7,9,19,16,3,21,35,81,1,"https://fbref.com/en/players/a4effc55/Dan-Axel-Zagadou"
2023,"Torino","Serie A","Ola Aina","NGA","DF","25",1996,9.7,17,13,5,8,4,9,15,60,6,12,2,10,11,28,26,0,"https://fbref.com/en/players/246d153b/Ola-Aina"
2023,"Torino","Serie A","Brian Bayeye","FRA","DF","22",2000,0.7,3,0,3,0,0,1,1,100,0,1,1,0,1,4,2,0,"https://fbref.com/en/players/78e6bf2c/Brian-Bayeye"
2023,"Torino","Serie A","Alessandro Buongiorno","ITA","DF","23",1999,30.2,38,25,22,16,0,16,31,51.6,15,38,19,19,60,98,105,2,"https://fbref.com/en/players/4ae67f27/Alessandro-Buongiorno"
2023,"Torino","Serie A","Koffi Djidji","CIV","DF","29",1992,26.9,50,25,32,17,1,18,32,56.3,14,29,14,15,34,84,72,0,"https://fbref.com/en/players/933d3b51/Koffi-Djidji"
2023,"Torino","Serie A","Gvidas Gineitis","LTU","MF","18",2004,1.5,3,1,0,2,1,1,2,50,1,0,0,0,0,3,1,0,"https://fbref.com/en/players/548bd0de/Gvidas-Gineitis"
2023,"Torino","Serie A","Andrew Gravillon","GLP","DF","24",1998,3.5,3,3,0,3,0,0,0,NA,0,4,2,2,9,12,16,0,"https://fbref.com/en/players/49136c42/Andrew-Gravillon"
2023,"Torino","Serie A","Ivan Ilić","SRB","MF","21",2001,13.1,18,7,6,11,1,10,20,50,10,12,3,9,5,23,10,0,"https://fbref.com/en/players/bb376bed/Ivan-Ilic"
2023,"Torino","Serie A","Emirhan İlkhan","TUR","MF","18",2004,1,1,1,0,1,0,1,1,100,0,3,1,2,2,3,2,0,"https://fbref.com/en/players/a47c6309/Emirhan-Ilkhan"
2023,"Torino","Serie A","Yann Karamoh","FRA","MF,FW","24",1998,8,5,2,3,2,0,1,5,20,4,5,0,5,0,5,2,1,"https://fbref.com/en/players/8b66d9cc/Yann-Karamoh"
2023,"Torino","Serie A","Valentino Lazaro","AUT","DF","26",1996,15.3,10,5,6,0,4,6,14,42.9,8,16,3,13,3,13,29,0,"https://fbref.com/en/players/016ff750/Valentino-Lazaro"
2023,"Torino","Serie A","Karol Linetty","POL","MF","27",1995,21,32,17,7,22,3,13,25,52,12,28,8,20,19,51,25,0,"https://fbref.com/en/players/d023d70f/Karol-Linetty"
2023,"Torino","Serie A","Saša Lukić","SRB","MF","25",1996,13.3,21,14,10,10,1,9,15,60,6,17,7,10,13,34,10,0,"https://fbref.com/en/players/c6e8cf1f/Sasa-Lukic"
2023,"Torino","Serie A","Vanja Milinković-Savić","SRB","GK","25",1997,38,2,1,2,0,0,2,2,100,0,0,0,0,1,3,19,1,"https://fbref.com/en/players/9fa26bc2/Vanja-Milinkovic-Savic"
2023,"Torino","Serie A","Aleksei Miranchuk","RUS","MF","26",1995,23.2,11,5,3,4,4,3,11,27.3,8,11,0,11,2,13,5,0,"https://fbref.com/en/players/a9aa0d1d/Aleksei-Miranchuk"
2023,"Torino","Serie A","Michel Ndary Adopo","FRA","MF,DF","22",2000,2.9,7,2,4,2,1,1,3,33.3,2,2,2,0,1,8,4,0,"https://fbref.com/en/players/599d91d0/Michel-Ndary-Adopo"
2023,"Torino","Serie A","Pietro Pellegri","ITA","FW","21",2001,5.2,6,2,1,3,2,2,3,66.7,1,5,1,4,0,6,4,0,"https://fbref.com/en/players/a44d3a3c/Pietro-Pellegri"
2023,"Torino","Serie A","Nemanja Radonjić","SRB","MF,FW","26",1996,16.2,2,1,2,0,0,0,4,0,4,3,0,3,2,4,4,0,"https://fbref.com/en/players/0630eb63/Nemanja-Radonjic"
2023,"Torino","Serie A","Samuele Ricci","ITA","MF","20",2001,23,32,21,17,10,5,18,23,78.3,5,20,5,15,17,49,29,1,"https://fbref.com/en/players/9823be92/Samuele-Ricci"
2023,"Torino","Serie A","Ricardo Rodríguez","SUI","DF","29",1992,29.7,54,33,30,17,7,28,42,66.7,14,30,15,15,38,92,61,0,"https://fbref.com/en/players/7f78ad23/Ricardo-Rodriguez"
2023,"Torino","Serie A","Antonio Sanabria","PAR","FW","26",1996,27,11,5,3,3,5,1,7,14.3,6,9,2,7,4,15,7,0,"https://fbref.com/en/players/0a447501/Antonio-Sanabria"
2023,"Torino","Serie A","Perr Schuurs","NED","DF","22",1999,25.8,51,25,29,17,5,14,26,53.8,12,28,16,12,28,79,102,0,"https://fbref.com/en/players/e613313c/Perr-Schuurs"
2023,"Torino","Serie A","Demba Seck","SEN","MF,FW","21",2001,5.8,5,2,3,2,0,2,3,66.7,1,3,1,2,1,6,1,0,"https://fbref.com/en/players/16463a79/Demba-Seck"
2023,"Torino","Serie A","Jacopo Segre","ITA","DF","25",1997,0.2,0,0,0,0,0,0,0,NA,0,0,0,0,0,0,0,0,"https://fbref.com/en/players/3cb132e6/Jacopo-Segre"
2023,"Torino","Serie A","Wilfried Singo","CIV","DF","21",2000,22.7,27,17,14,10,3,12,19,63.2,7,15,2,13,12,39,33,1,"https://fbref.com/en/players/8b609c34/Wilfried-Singo"
2023,"Torino","Serie A","Ronaldo Vieira","GNB","MF","24",1998,0.2,NA,0,NA,NA,NA,NA,NA,NA,NA,NA,NA,NA,0,NA,NA,NA,"https://fbref.com/en/players/75e60d75/Ronaldo-Vieira"
2023,"Torino","Serie A","Nikola Vlašić","CRO","MF,FW","24",1997,30.3,32,21,9,16,7,15,34,44.1,19,25,2,23,10,42,14,0,"https://fbref.com/en/players/aa8e289e/Nikola-Vlasic"
2023,"Torino","Serie A","Mërgim Vojvoda","KVX","DF","27",1995,19.1,22,12,15,6,1,12,24,50,12,14,2,12,10,32,31,1,"https://fbref.com/en/players/be2706c0/Mergim-Vojvoda"
2023,"Torino","Serie A","David Zima","CZE","DF","21",2000,4.5,9,5,5,4,0,3,4,75,1,7,2,5,9,18,11,2,"https://fbref.com/en/players/acf7e795/David-Zima"
2023,"Tottenham","Premier League","George Abbott","ENG","MF","16",2005,0,0,0,0,0,0,0,0,NA,0,0,0,0,1,1,0,0,"https://fbref.com/en/players/56628958/George-Abbott"
2023,"Tottenham","Premier League","Rodrigo Bentancur","URU","MF","25",1997,16.7,45,28,15,21,9,16,28,57.1,12,28,15,13,20,65,22,0,"https://fbref.com/en/players/3b8674e6/Rodrigo-Bentancur"
2023,"Tottenham","Premier League","Yves Bissouma","MLI","MF","25",1996,11.2,16,13,6,6,4,2,7,28.6,5,15,6,9,12,28,10,0,"https://fbref.com/en/players/6c203af0/Yves-Bissouma"
2023,"Tottenham","Premier League","Matthew Craig","SCO","MF","19",2003,0.2,4,1,2,2,0,0,0,NA,0,0,0,0,0,4,0,0,"https://fbref.com/en/players/bc914523/Matthew-Craig"
2023,"Tottenham","Premier League","Arnaut Danjuma","NED","FW,MF","25",1997,1.9,2,0,1,1,0,0,0,NA,0,1,0,1,0,2,0,0,"https://fbref.com/en/players/f08490a6/Arnaut-Danjuma"
2023,"Tottenham","Premier League","Ben Davies","WAL","DF","29",1993,25.4,28,11,13,13,2,14,26,53.8,12,17,8,9,18,46,72,0,"https://fbref.com/en/players/44781702/Ben-Davies"
2023,"Tottenham","Premier League","Eric Dier","ENG","DF","28",1994,31.3,30,19,16,12,2,9,19,47.4,10,41,24,17,35,65,112,2,"https://fbref.com/en/players/ac861941/Eric-Dier"
2023,"Tottenham","Premier League","Matt Doherty","IRL","DF,MF","30",1992,7.4,16,10,12,3,1,8,10,80,2,11,6,5,8,24,14,1,"https://fbref.com/en/players/d557d734/Matt-Doherty"
2023,"Tottenham","Premier League","Emerson","BRA","DF","23",1999,19.3,54,33,38,12,4,27,40,67.5,13,17,3,14,18,72,75,0,"https://fbref.com/en/players/df8b52a5/Emerson"
2023,"Tottenham","Premier League","Fraser Forster","ENG","GK","34",1988,13.5,1,0,1,0,0,0,0,NA,0,1,0,1,0,1,3,1,"https://fbref.com/en/players/c3e39f12/Fraser-Forster"
2023,"Tottenham","Premier League","Bryan Gil","ESP","MF,FW","21",2001,1.6,3,1,3,0,0,0,3,0,3,3,0,3,1,4,1,0,"https://fbref.com/en/players/7b5ab7f2/Bryan-Gil"
2023,"Tottenham","Premier League","Son Heung-min","KOR","MF,FW","30",1992,32.1,24,12,7,8,9,9,30,30,21,23,2,21,13,37,6,0,"https://fbref.com/en/players/92e7e919/Son-Heung-min"
2023,"Tottenham","Premier League","Pierre Højbjerg","DEN","MF","26",1995,34.8,56,30,28,22,6,26,67,38.8,41,46,17,29,49,105,64,1,"https://fbref.com/en/players/8b04d6c1/Pierre-Hojbjerg"
2023,"Tottenham","Premier League","Harry Kane","ENG","FW","29",1993,37.8,15,12,1,6,8,7,21,33.3,14,27,7,20,2,17,18,0,"https://fbref.com/en/players/21a66f6a/Harry-Kane"
2023,"Tottenham","Premier League","Dejan Kulusevski","SWE","MF,FW","22",2000,23,38,15,23,7,8,16,44,36.4,28,19,0,19,13,51,7,0,"https://fbref.com/en/players/df3cda47/Dejan-Kulusevski"
2023,"Tottenham","Premier League","Clément Lenglet","FRA","DF","27",1995,22.4,38,23,18,15,5,16,34,47.1,18,26,11,15,18,56,68,2,"https://fbref.com/en/players/4f28a6ff/Clement-Lenglet"
2023,"Tottenham","Premier League","Hugo Lloris","FRA","GK","35",1986,24.5,1,1,1,0,0,1,3,33.3,2,0,0,0,1,2,13,4,"https://fbref.com/en/players/8f62b6ee/Hugo-Lloris"
2023,"Tottenham","Premier League","Pape Matar Sarr","SEN","MF,FW","19",2002,2.4,7,6,4,2,1,4,8,50,4,3,2,1,6,13,6,0,"https://fbref.com/en/players/feb5d972/Pape-Matar-Sarr"
2023,"Tottenham","Premier League","Lucas Moura","BRA","MF,DF","29",1992,1.7,8,5,1,3,4,1,4,25,3,0,0,0,2,10,1,1,"https://fbref.com/en/players/2b622f01/Lucas-Moura"
2023,"Tottenham","Premier League","Ivan Perišić","CRO","DF,MF","33",1989,23.4,42,24,25,10,7,27,47,57.4,20,29,7,22,22,64,49,1,"https://fbref.com/en/players/6fe90922/Ivan-Perisic"
2023,"Tottenham","Premier League","Pedro Porro","ESP","DF,MF","22",1999,12.6,25,16,8,15,2,14,39,35.9,25,25,2,23,15,40,24,1,"https://fbref.com/en/players/27d0a506/Pedro-Porro"
2023,"Tottenham","Premier League","Richarlison","BRA","MF,FW","25",1997,11.2,21,16,13,5,3,12,27,44.4,15,14,1,13,5,26,10,0,"https://fbref.com/en/players/fa031b34/Richarlison"
2023,"Tottenham","Premier League","Cristian Romero","ARG","DF","24",1998,26.3,68,36,42,24,2,29,46,63,17,40,18,22,44,112,102,3,"https://fbref.com/en/players/a3d94a58/Cristian-Romero"
2023,"Tottenham","Premier League","Davinson Sánchez","COL","DF","26",1996,9.5,24,11,17,6,1,14,20,70,6,16,10,6,12,36,41,0,"https://fbref.com/en/players/da7b447d/Davinson-Sanchez"
2023,"Tottenham","Premier League","Ryan Sessegnon","ENG","DF","22",2000,9,16,11,9,7,0,6,12,50,6,8,1,7,6,22,17,1,"https://fbref.com/en/players/6aa3e78b/Ryan-Sessegnon"
2023,"Tottenham","Premier League","Oliver Skipp","ENG","MF","21",2000,16.6,34,17,18,15,1,16,33,48.5,17,17,8,9,17,51,19,1,"https://fbref.com/en/players/6250083a/Oliver-Skipp"
2023,"Tottenham","Premier League","Djed Spence","ENG","FW,DF","21",2000,0.1,0,0,0,0,0,0,0,NA,0,0,0,0,0,0,0,0,"https://fbref.com/en/players/9bc9a519/Djed-Spence"
2023,"Tottenham","Premier League","Japhet Tanganga","ENG","DF","23",1999,1.6,3,2,3,0,0,1,5,20,4,1,0,1,2,5,8,0,"https://fbref.com/en/players/e9971f2d/Japhet-Tanganga"
2023,"Tottenham","Premier League","Harvey White","ENG","MF","20",2001,0.1,0,0,0,0,0,0,1,0,1,0,0,0,0,0,0,0,"https://fbref.com/en/players/4d90ce8c/Harvey-White"
2023,"Toulouse","Ligue 1","Zakaria Aboukhlal","MAR","FW,MF","22",2000,27.5,33,23,13,9,11,14,45,31.1,31,18,1,17,22,55,23,0,"https://fbref.com/en/players/c2a6033c/Zakaria-Aboukhlal"
2023,"Toulouse","Ligue 1","Yanis Begraoui","MAR","FW,MF","21",2001,0.7,2,0,1,0,1,1,2,50,1,0,0,0,1,3,0,0,"https://fbref.com/en/players/5e6355f8/Yanis-Begraoui"
2023,"Toulouse","Ligue 1","Veljko Birmančević","SRB","FW,MF","24",1998,4.9,13,7,5,4,4,7,21,33.3,14,12,2,10,7,20,1,0,"https://fbref.com/en/players/636247ca/Veljko-Birmancevic"
2023,"Toulouse","Ligue 1","Fares Chaïbi","ALG","FW,MF","19",2002,26,31,18,8,15,8,17,50,34,33,38,5,33,19,50,36,1,"https://fbref.com/en/players/357103bd/Fares-Chaibi"
2023,"Toulouse","Ligue 1","Logan Costa","CPV","DF","21",2001,4.6,9,4,7,1,1,6,9,66.7,3,6,3,3,4,13,12,0,"https://fbref.com/en/players/bfb2056e/Logan-Costa"
2023,"Toulouse","Ligue 1","Thijs Dallinga","NED","FW","21",2000,26.1,8,6,2,2,4,1,13,7.7,12,17,3,14,3,11,20,0,"https://fbref.com/en/players/b70afb45/Thijs-Dallinga"
2023,"Toulouse","Ligue 1","Brecht Dejaegere","BEL","MF","31",1991,20.1,40,23,10,20,10,15,51,29.4,36,25,5,20,14,54,11,0,"https://fbref.com/en/players/4ca4f601/Brecht-Dejaegere"
2023,"Toulouse","Ligue 1","Branco van den Boomen","NED","MF","27",1995,32.1,71,36,26,32,13,36,89,40.4,53,27,4,23,10,81,27,2,"https://fbref.com/en/players/99d660b2/Branco-van-den-Boomen"
2023,"Toulouse","Ligue 1","Mikkel Desler","DEN","DF","27",1995,25.1,71,38,36,27,8,43,67,64.2,24,35,6,29,36,107,48,2,"https://fbref.com/en/players/1d5c96f8/Mikkel-Desler"
2023,"Toulouse","Ligue 1","Moussa Diarra","MLI","DF","21",2000,13.6,20,9,9,9,2,9,15,60,6,25,10,15,19,39,27,1,"https://fbref.com/en/players/698f11e3/Moussa-Diarra"
2023,"Toulouse","Ligue 1","Maxime Dupé","FRA","GK","29",1993,38,0,0,0,0,0,0,0,NA,0,0,0,0,0,0,9,3,"https://fbref.com/en/players/0e12089d/Maxime-Dupe"
2023,"Toulouse","Ligue 1","Denis Genreau","AUS","MF","23",1999,7.3,35,13,16,12,7,13,31,41.9,18,16,1,15,8,43,9,0,"https://fbref.com/en/players/badcdcae/Denis-Genreau"
2023,"Toulouse","Ligue 1","Saïd Hamulic","BIH","FW","21",2000,1.2,0,0,0,0,0,0,0,NA,0,0,0,0,0,0,0,0,"https://fbref.com/en/players/52cd0e88/Said-Hamulic"
2023,"Toulouse","Ligue 1","Rhys Healey","WAL","FW","27",1994,0.7,0,0,0,0,0,0,0,NA,0,0,0,0,0,0,0,0,"https://fbref.com/en/players/07ace8c3/Rhys-Healey"
2023,"Toulouse","Ligue 1","Waren Kamanzi","NOR","DF","21",2000,7.4,16,9,9,5,2,13,19,68.4,6,8,2,6,8,24,9,0,"https://fbref.com/en/players/a426a912/Waren-Kamanzi"
2023,"Toulouse","Ligue 1","Kévin Keben Biakolo","CMR","DF","18",2004,4,3,2,2,0,1,0,4,0,4,1,0,1,5,8,9,0,"https://fbref.com/en/players/c43a8336/Kevin-Keben-Biakolo"
2023,"Toulouse","Ligue 1","Christian Mawissa","FRA","DF","17",2005,1.1,2,0,1,1,0,1,3,33.3,2,0,0,0,3,5,1,0,"https://fbref.com/en/players/2c70d915/Christian-Mawissa"
2023,"Toulouse","Ligue 1","Nathan N'Goumou","FRA","FW","22",2000,1,3,2,2,1,0,1,1,100,0,2,0,2,2,5,0,0,"https://fbref.com/en/players/e110ea4b/Nathan-NGoumou"
2023,"Toulouse","Ligue 1","Rasmus Nicolaisen","DEN","DF","25",1997,33.3,48,21,34,14,0,29,46,63,17,58,45,13,50,98,152,0,"https://fbref.com/en/players/3f319bb9/Rasmus-Nicolaisen"
2023,"Toulouse","Ligue 1","Ado Onaiwu","JPN","FW","26",1995,12,11,6,4,4,3,5,13,38.5,8,5,1,4,2,13,5,0,"https://fbref.com/en/players/ff4df82e/Ado-Onaiwu"
2023,"Toulouse","Ligue 1","Rafael Ratão","BRA","FW,MF","26",1995,20.6,52,36,29,16,7,27,73,37,46,34,0,34,21,73,7,0,"https://fbref.com/en/players/40ef7347/Rafael-Ratao"
2023,"Toulouse","Ligue 1","Anthony Rouault","FRA","DF","21",2001,36.8,66,37,54,10,2,30,58,51.7,28,52,26,26,56,122,126,4,"https://fbref.com/en/players/9b545925/Anthony-Rouault"
2023,"Toulouse","Ligue 1","Vincent Sierro","SUI","MF","26",1995,7.4,19,11,9,9,1,11,29,37.9,18,12,3,9,4,23,11,1,"https://fbref.com/en/players/92ffb8f9/Vincent-Sierro"
2023,"Toulouse","Ligue 1","Naatan Skyttä","FIN","MF","20",2002,0.3,0,0,0,0,0,0,0,NA,0,0,0,0,1,1,0,0,"https://fbref.com/en/players/d7547531/Naatan-Skytta"
2023,"Toulouse","Ligue 1","Stijn Spierings","NED","MF","26",1996,34.7,95,67,37,49,9,43,101,42.6,58,49,11,38,53,148,44,0,"https://fbref.com/en/players/a08985b8/Stijn-Spierings"
2023,"Toulouse","Ligue 1","Gabriel Suazo","CHI","DF","24",1997,14,38,22,20,15,3,29,63,46,34,21,5,16,22,60,24,1,"https://fbref.com/en/players/39b326ed/Gabriel-Suazo"
2023,"Toulouse","Ligue 1","Issiaga Sylla","GUI","DF","28",1994,15.2,28,15,14,9,5,15,34,44.1,19,15,5,10,38,66,38,0,"https://fbref.com/en/players/b99bec05/Issiaga-Sylla"
2023,"Toulouse","Ligue 1","Theocharis Tsingaras","GRE","MF","21",2000,0.1,0,0,0,0,0,0,0,NA,0,0,0,0,0,0,0,0,"https://fbref.com/en/players/906baf89/Theocharis-Tsingaras"
2023,"Toulouse","Ligue 1","Oliver Zandén","SWE","DF,MF","20",2001,1.6,2,1,1,0,1,2,5,40,3,0,0,0,1,3,7,0,"https://fbref.com/en/players/72d4922b/Oliver-Zanden"
2023,"Troyes","Ligue 1","Lucien Agoume","FRA","MF","20",2002,12.2,42,25,18,15,9,17,33,51.5,16,14,5,9,27,69,24,0,"https://fbref.com/en/players/8bc8829a/Lucien-Agoume"
2023,"Troyes","Ligue 1","Amar Ahmed","SWE","FW","18",2004,0.2,1,1,0,1,0,0,1,0,1,0,0,0,1,2,0,0,"https://fbref.com/en/players/22396615/Amar-Ahmed"
2023,"Troyes","Ligue 1","Thierno Balde","FRA","DF,MF","20",2002,23.9,27,14,19,4,4,18,30,60,12,15,3,12,23,50,39,0,"https://fbref.com/en/players/3975195f/Thierno-Balde"
2023,"Troyes","Ligue 1","Andreas Bruus","DEN","DF,FW","23",1999,18.1,12,6,9,3,0,8,20,40,12,13,2,11,17,29,24,0,"https://fbref.com/en/players/b088d5d3/Andreas-Bruus"
2023,"Troyes","Ligue 1","Xavier Chavalerin","FRA","MF","31",1991,27,82,50,39,30,13,27,71,38,44,31,8,23,41,123,24,0,"https://fbref.com/en/players/279ddf6a/Xavier-Chavalerin"
2023,"Troyes","Ligue 1","Abdu Conté","POR","DF","24",1998,14.6,25,17,14,8,3,12,22,54.5,10,13,6,7,6,31,25,0,"https://fbref.com/en/players/cfa49cc1/Abdu-Conte"
2023,"Troyes","Ligue 1","Tristan Dingomé","CMR","MF","31",1991,1.1,1,1,0,1,0,0,2,0,2,0,0,0,0,1,0,0,"https://fbref.com/en/players/92b56413/Tristan-Dingome"
2023,"Troyes","Ligue 1","Kyliane Dong","FRA","MF,FW","17",2004,2.4,3,1,0,2,1,1,2,50,1,1,0,1,1,4,0,0,"https://fbref.com/en/players/836dc4a8/Kyliane-Dong"
2023,"Troyes","Ligue 1","Jordan Dongmo","CMR","MF","21",2001,0.2,1,0,0,1,0,1,1,100,0,0,0,0,0,1,0,0,"https://fbref.com/en/players/1b5b32d2/Jordan-Dongmo"
2023,"Troyes","Ligue 1","Gauthier Gallon","FRA","GK","29",1993,29.6,2,2,2,0,0,2,4,50,2,0,0,0,2,4,17,0,"https://fbref.com/en/players/db3164e1/Gauthier-Gallon"
2023,"Troyes","Ligue 1","Mathis Hamdi","FRA","DF","18",2003,0.8,0,0,0,0,0,0,1,0,1,0,0,0,1,1,1,0,"https://fbref.com/en/players/a94571f6/Mathis-Hamdi"
2023,"Troyes","Ligue 1","Rudy Kohon","FRA","DF","18",2004,0.7,4,3,4,0,0,2,2,100,0,1,0,1,1,5,2,0,"https://fbref.com/en/players/9cd28348/Rudy-Kohon"
2023,"Troyes","Ligue 1","Rominigue Kouamé","MLI","MF","25",1996,29.6,44,27,28,14,2,17,41,41.5,24,32,11,21,49,93,46,1,"https://fbref.com/en/players/86a2ba20/Rominigue-Kouame"
2023,"Troyes","Ligue 1","Yasser Larouci","FRA","DF,MF","21",2001,20,23,13,13,8,2,15,24,62.5,9,15,1,14,26,49,46,0,"https://fbref.com/en/players/0ed063d6/Yasser-Larouci"
2023,"Troyes","Ligue 1","Mateusz Lis","POL","GK","25",1997,8.3,0,0,0,0,0,0,1,0,1,1,0,1,0,0,3,0,"https://fbref.com/en/players/fd78b105/Mateusz-Lis"
2023,"Troyes","Ligue 1","Rony Lopes","POR","MF,FW","26",1995,26.1,24,12,6,15,3,7,31,22.6,24,14,2,12,9,33,10,0,"https://fbref.com/en/players/7c2965bb/Rony-Lopes"
2023,"Troyes","Ligue 1","Derek Mazou-Sacko","FRA","MF","17",2004,0.2,0,0,0,0,0,0,1,0,1,1,0,1,1,1,1,0,"https://fbref.com/en/players/810edef9/Derek-Mazou-Sacko"
2023,"Troyes","Ligue 1","Marlos Moreno","COL","MF,DF","25",1996,0.1,2,2,2,0,0,2,3,66.7,1,1,1,0,0,2,0,0,"https://fbref.com/en/players/8499c713/Marlos-Moreno"
2023,"Troyes","Ligue 1","Papa Ndiaga Yade","SEN","DF,MF","22",2000,6.3,10,6,6,2,2,7,22,31.8,15,10,2,8,8,18,10,0,"https://fbref.com/en/players/87e9c7cd/Papa-Ndiaga-Yade"
2023,"Troyes","Ligue 1","Wilson Odobert","FRA","MF,FW","17",2004,19.6,20,14,10,7,3,9,25,36,16,11,0,11,15,35,5,0,"https://fbref.com/en/players/35516eac/Wilson-Odobert"
2023,"Troyes","Ligue 1","Ante Palaversa","CRO","MF","22",2000,0.3,1,1,1,0,0,0,0,NA,0,0,0,0,1,2,0,0,"https://fbref.com/en/players/cd9b37a3/Ante-Palaversa"
2023,"Troyes","Ligue 1","Erik Palmer-Brown","USA","DF","25",1997,35.5,42,27,31,10,1,18,33,54.5,15,56,29,27,26,68,166,1,"https://fbref.com/en/players/e5c1e0ca/Erik-Palmer-Brown"
2023,"Troyes","Ligue 1","Jackson Porozo","ECU","DF","21",2000,18,32,20,24,7,1,13,31,41.9,18,24,17,7,33,65,75,0,"https://fbref.com/en/players/7d704e92/Jackson-Porozo"
2023,"Troyes","Ligue 1","Adil Rami","FRA","DF","36",1985,17.7,19,14,13,5,1,17,32,53.1,15,23,16,7,25,44,75,3,"https://fbref.com/en/players/8dbff17c/Adil-Rami"
2023,"Troyes","Ligue 1","Jeff Reine-Adélaïde","FRA","MF","24",1998,2.6,3,2,2,1,0,1,2,50,1,2,0,2,2,5,1,0,"https://fbref.com/en/players/d504b3e1/Jeff-Reine-Adelaide"
2023,"Troyes","Ligue 1","Renaud Ripart","FRA","FW,MF","29",1993,14.7,40,23,14,20,6,19,52,36.5,33,29,2,27,7,47,5,0,"https://fbref.com/en/players/beae3a73/Renaud-Ripart"
2023,"Troyes","Ligue 1","Yoann Salmier","GUF","DF","29",1992,29.4,51,29,34,12,5,21,35,60,14,34,19,15,39,90,124,0,"https://fbref.com/en/players/c3725db2/Yoann-Salmier"
2023,"Troyes","Ligue 1","Mama Samba Baldé","GNB","FW","26",1995,29.6,46,21,14,21,11,13,28,46.4,15,30,3,27,10,56,13,0,"https://fbref.com/en/players/fb14aa28/Mama-Samba-Balde"
2023,"Troyes","Ligue 1","Florian Tardieu","FRA","MF","30",1992,11.2,31,20,19,12,0,12,31,38.7,19,19,4,15,23,54,15,0,"https://fbref.com/en/players/ed39121c/Florian-Tardieu"
2023,"Troyes","Ligue 1","Alexis Tibidi","FRA","FW,MF","18",2003,0.8,1,1,1,0,0,0,0,NA,0,0,0,0,0,1,0,0,"https://fbref.com/en/players/ca6f4846/Alexis-Tibidi"
2023,"Troyes","Ligue 1","Ike Ugbo","CAN","FW,MF","23",1998,9.9,5,2,2,2,1,3,11,27.3,8,8,2,6,2,7,4,0,"https://fbref.com/en/players/8a53d24b/Ike-Ugbo"
2023,"Troyes","Ligue 1","Tanguy Zoukrou","FRA","DF","19",2003,5.7,14,7,8,6,0,10,14,71.4,4,18,11,7,2,16,24,0,"https://fbref.com/en/players/aefa3050/Tanguy-Zoukrou"
2023,"Udinese","Serie A","James Abankwah","IRL","DF","18",2004,0.7,1,1,0,1,0,0,0,NA,0,4,2,2,0,1,5,0,"https://fbref.com/en/players/4b7a9fcc/James-Abankwah"
2023,"Udinese","Serie A","Tolgay Arslan","GER","MF","31",1990,13.5,29,18,13,15,1,14,39,35.9,25,19,0,19,12,41,9,1,"https://fbref.com/en/players/963a328b/Tolgay-Arslan"
2023,"Udinese","Serie A","Rodrigo Becão","BRA","DF","26",1996,27.6,70,36,50,17,3,40,53,75.5,13,44,24,20,26,96,68,2,"https://fbref.com/en/players/19e4eab9/Rodrigo-Becao"
2023,"Udinese","Serie A","Beto","GNB","FW","24",1998,23.7,16,9,0,9,7,4,17,23.5,13,18,3,15,6,22,30,0,"https://fbref.com/en/players/ed5c0319/Beto"
2023,"Udinese","Serie A","Jaka Bijol","SVN","DF","23",1999,30.3,39,23,32,7,0,16,27,59.3,11,41,25,16,29,68,165,0,"https://fbref.com/en/players/6fdac234/Jaka-Bijol"
2023,"Udinese","Serie A","Leonardo Buta","POR","DF","20",2002,0.2,1,1,0,1,0,0,0,NA,0,0,0,0,0,1,0,0,"https://fbref.com/en/players/dee3d535/Leonardo-Buta"
2023,"Udinese","Serie A","Nicolò Cocetta","ITA","DF","18",2003,0.4,0,0,0,0,0,0,1,0,1,1,1,0,1,1,1,0,"https://fbref.com/en/players/1faa06d5/Nicolo-Cocetta"
2023,"Udinese","Serie A","Gerard Deulofeu","ESP","FW","28",1994,13.5,8,5,5,1,2,5,15,33.3,10,8,1,7,2,10,1,0,"https://fbref.com/en/players/39583cfd/Gerard-Deulofeu"
2023,"Udinese","Serie A","Festy Ebosele","IRL","DF","19",2002,4.6,15,10,8,7,0,4,10,40,6,5,0,5,2,17,5,0,"https://fbref.com/en/players/dbfa4f16/Festy-Ebosele"
2023,"Udinese","Serie A","Enzo Ebosse","CMR","DF","23",1999,10.3,15,9,11,4,0,9,13,69.2,4,27,6,21,11,26,29,0,"https://fbref.com/en/players/9ba7b4fa/Enzo-Ebosse"
2023,"Udinese","Serie A","Kingsley Ehizibue","NED","DF","27",1995,17.1,47,31,28,13,6,29,45,64.4,16,21,3,18,10,57,42,1,"https://fbref.com/en/players/76b2817e/Kingsley-Ehizibue"
2023,"Udinese","Serie A","Axel Guessand","FRA","DF","17",2004,0.9,2,1,2,0,0,1,2,50,1,1,0,1,2,4,3,0,"https://fbref.com/en/players/e04dca4a/Axel-Guessand"
2023,"Udinese","Serie A","Mato Jajalo","BIH","MF","34",1988,0.7,0,0,0,0,0,0,1,0,1,0,0,0,0,0,2,0,"https://fbref.com/en/players/8c65eb5f/Mato-Jajalo"
2023,"Udinese","Serie A","Sandi Lovrić","SVN","MF","24",1998,25.9,40,18,16,16,8,25,43,58.1,18,25,2,23,26,66,21,0,"https://fbref.com/en/players/966eea58/Sandi-Lovric"
2023,"Udinese","Serie A","Jean-Victor Makengo","FRA","MF","24",1998,8.9,16,13,7,7,2,5,9,55.6,4,8,2,6,9,25,3,0,"https://fbref.com/en/players/22bfb57e/Jean-Victor-Makengo"
2023,"Udinese","Serie A","Adam Masina","MAR","DF","28",1994,8.8,10,7,7,3,0,6,15,40,9,11,4,7,10,20,28,1,"https://fbref.com/en/players/de0f152c/Adam-Masina"
2023,"Udinese","Serie A","Ilija Nestorovski","MKD","FW,MF","32",1990,7.1,7,3,2,1,4,5,11,45.5,6,6,1,5,2,9,10,0,"https://fbref.com/en/players/b1236c63/Ilija-Nestorovski"
2023,"Udinese","Serie A","Bram Nuytinck","NED","DF","32",1990,4.3,7,4,3,4,0,4,8,50,4,6,6,0,5,12,22,0,"https://fbref.com/en/players/e33f36d5/Bram-Nuytinck"
2023,"Udinese","Serie A","Simone Pafundi","ITA","MF,FW","16",2006,0.9,8,5,1,5,2,2,4,50,2,0,0,0,1,9,0,0,"https://fbref.com/en/players/8daee720/Simone-Pafundi"
2023,"Udinese","Serie A","Roberto Pereyra","ARG","DF,MF","31",1991,31.3,36,20,21,12,3,16,44,36.4,28,20,5,15,16,52,28,0,"https://fbref.com/en/players/75f2c59f/Roberto-Pereyra"
2023,"Udinese","Serie A","Nehuén Pérez","ARG","DF","22",2000,31.3,77,40,54,20,3,39,55,70.9,16,53,23,30,35,112,106,1,"https://fbref.com/en/players/f7c491f1/Nehuen-Perez"
2023,"Udinese","Serie A","Lazar Samardzic","SRB","MF","20",2002,20.5,33,16,9,20,4,17,43,39.5,26,13,0,13,11,44,16,0,"https://fbref.com/en/players/217c93a1/Lazar-Samardzic"
2023,"Udinese","Serie A","Vivaldo Semedo","POR","FW,MF","17",2005,0.4,0,0,0,0,0,0,0,NA,0,1,0,1,0,0,1,0,"https://fbref.com/en/players/b6baba31/Vivaldo-Semedo"
2023,"Udinese","Serie A","Marco Silvestri","ITA","GK","31",1991,38,2,1,2,0,0,2,3,66.7,1,0,0,0,1,3,15,1,"https://fbref.com/en/players/0d422df7/Marco-Silvestri"
2023,"Udinese","Serie A","Brandon Soppy","FRA","DF","20",2002,1,1,1,0,1,0,0,0,NA,0,4,0,4,1,2,1,0,"https://fbref.com/en/players/28f66c2e/Brandon-Soppy"
2023,"Udinese","Serie A","Isaac Success","NGA","FW","26",1996,20.2,8,4,2,5,1,3,8,37.5,5,13,2,11,4,12,18,0,"https://fbref.com/en/players/f573a8bf/Isaac-Success"
2023,"Udinese","Serie A","Florian Thauvin","FRA","FW,MF","29",1993,6.1,2,1,0,2,0,2,13,15.4,11,5,0,5,2,4,2,0,"https://fbref.com/en/players/2b9fdeea/Florian-Thauvin"
2023,"Udinese","Serie A","Iyenoma Udogie","ITA","DF","19",2002,30,71,45,42,24,5,34,59,57.6,25,34,6,28,36,107,25,0,"https://fbref.com/en/players/7cd520e8/Iyenoma-Udogie"
2023,"Udinese","Serie A","Walace","BRA","MF","27",1995,35.4,82,39,42,31,9,41,90,45.6,49,47,12,35,51,133,51,1,"https://fbref.com/en/players/26db8853/Walace"
2023,"Udinese","Serie A","Marvin Zeegelaar","NED","DF","31",1990,3.9,8,4,6,2,0,3,4,75,1,2,0,2,3,11,5,0,"https://fbref.com/en/players/8abd0c03/Marvin-Zeegelaar"
2023,"Union Berlin","Bundesliga","Timo Baumgartl","GER","DF","26",1996,6.2,11,6,5,4,2,5,18,27.8,13,12,4,8,2,13,14,0,"https://fbref.com/en/players/bd7d2e6d/Timo-Baumgartl"
2023,"Union Berlin","Bundesliga","Sheraldo Becker","SUR","FW","27",1995,28.4,15,5,1,7,7,2,11,18.2,9,13,1,12,3,18,7,1,"https://fbref.com/en/players/8eb55dbb/Sheraldo-Becker"
2023,"Union Berlin","Bundesliga","Kevin Behrens","GER","FW","31",1991,17.1,11,7,4,4,3,4,18,22.2,14,18,3,15,5,16,25,0,"https://fbref.com/en/players/30ae134d/Kevin-Behrens"
2023,"Union Berlin","Bundesliga","Danilho Doekhi","NED","DF","24",1998,24.6,38,23,21,17,0,14,26,53.8,12,27,12,15,29,67,93,0,"https://fbref.com/en/players/f67c9d29/Danilho-Doekhi"
2023,"Union Berlin","Bundesliga","Niko Gießelmann","GER","DF","30",1991,14.5,21,11,9,9,3,13,31,41.9,18,17,5,12,9,30,28,0,"https://fbref.com/en/players/7242b495/Niko-Giesselmann"
2023,"Union Berlin","Bundesliga","Lennart Grill","GER","GK","23",1999,5,0,0,0,0,0,0,1,0,1,0,0,0,0,0,1,1,"https://fbref.com/en/players/37998008/Lennart-Grill"
2023,"Union Berlin","Bundesliga","Janik Haberer","GER","MF","28",1994,24.3,29,17,8,18,3,17,48,35.4,31,35,2,33,14,43,25,0,"https://fbref.com/en/players/70dcf94d/Janik-Haberer"
2023,"Union Berlin","Bundesliga","Genki Haraguchi","JPN","MF","31",1991,5.5,12,8,1,10,1,3,9,33.3,6,7,1,6,3,15,9,0,"https://fbref.com/en/players/f24ea523/Genki-Haraguchi"
2023,"Union Berlin","Bundesliga","Paul Jaeckel","GER","DF","24",1998,13.3,24,18,11,11,2,17,35,48.6,18,11,5,6,19,43,44,1,"https://fbref.com/en/players/a93b6f4e/Paul-Jaeckel"
2023,"Union Berlin","Bundesliga","Josip Juranović","CRO","DF","26",1995,10.4,9,7,5,2,2,7,18,38.9,11,9,3,6,6,15,22,1,"https://fbref.com/en/players/0a084b35/Josip-Juranovic"
2023,"Union Berlin","Bundesliga","Rani Khedira","GER","MF","28",1994,32,60,33,21,32,7,25,50,50,25,33,10,23,40,100,33,0,"https://fbref.com/en/players/59e4b92e/Rani-Khedira"
2023,"Union Berlin","Bundesliga","Robin Knoche","GER","DF","30",1992,31.9,45,29,29,12,4,24,47,51.1,23,35,18,17,38,83,140,0,"https://fbref.com/en/players/6bd5cd5d/Robin-Knoche"
2023,"Union Berlin","Bundesliga","Aïssa Laïdouni","TUN","MF","25",1996,9.7,14,7,6,8,0,5,17,29.4,12,22,4,18,9,23,3,0,"https://fbref.com/en/players/22798128/Aissa-Laidouni"
2023,"Union Berlin","Bundesliga","Diogo Leite","POR","DF","23",1999,25,35,20,21,14,0,21,34,61.8,13,23,14,9,26,61,99,1,"https://fbref.com/en/players/c4987edc/Diogo-Leite"
2023,"Union Berlin","Bundesliga","Jamie Leweling","GER","FW,MF","21",2001,2.9,5,3,2,2,1,3,5,60,2,3,0,3,1,6,0,0,"https://fbref.com/en/players/13fe7b69/Jamie-Leweling"
2023,"Union Berlin","Bundesliga","Sven Michel","GER","FW,MF","32",1990,5.5,9,5,1,5,3,4,8,50,4,5,1,4,0,9,4,0,"https://fbref.com/en/players/1e274a0a/Sven-Michel"
2023,"Union Berlin","Bundesliga","Levin Öztunalı","GER","MF","26",1996,0.1,0,0,0,0,0,0,1,0,1,0,0,0,0,0,0,0,"https://fbref.com/en/players/66385c46/Levin-Oztunali"
2023,"Union Berlin","Bundesliga","Miloš Pantović","SRB","MF","26",1996,2.3,4,2,4,0,0,3,5,60,2,3,0,3,0,4,5,0,"https://fbref.com/en/players/5dc15574/Milos-Pantovic"
2023,"Union Berlin","Bundesliga","Jordan Pefok","USA","FW","26",1996,15.1,15,7,3,4,8,2,17,11.8,15,17,5,12,4,19,15,0,"https://fbref.com/en/players/b684a484/Jordan-Pefok"
2023,"Union Berlin","Bundesliga","Tymoteusz Puchacz","POL","DF","23",1999,0.6,1,0,1,0,0,0,0,NA,0,0,0,0,0,1,1,0,"https://fbref.com/en/players/c68b1b13/Tymoteusz-Puchacz"
2023,"Union Berlin","Bundesliga","Jérôme Roussillon","FRA","DF","29",1993,10.6,16,9,6,8,2,8,12,66.7,4,7,2,5,4,20,22,0,"https://fbref.com/en/players/13203c45/Jerome-Roussillon"
2023,"Union Berlin","Bundesliga","Julian Ryerson","NOR","DF","24",1997,11.5,28,17,17,10,1,15,25,60,10,15,3,12,12,40,19,0,"https://fbref.com/en/players/009a4f60/Julian-Ryerson"
2023,"Union Berlin","Bundesliga","Frederik Rønnow","DEN","GK","29",1992,29,0,0,0,0,0,0,5,0,5,0,0,0,0,0,9,1,"https://fbref.com/en/players/a70b8345/Frederik-Ronnow"
2023,"Union Berlin","Bundesliga","András Schäfer","HUN","MF","23",1999,9.6,21,9,7,12,2,6,14,42.9,8,12,2,10,4,25,11,0,"https://fbref.com/en/players/049751d7/Andras-Schafer"
2023,"Union Berlin","Bundesliga","Paul Seguin","GER","MF","27",1995,7.7,17,8,9,4,4,8,18,44.4,10,6,0,6,6,23,7,0,"https://fbref.com/en/players/8872ed17/Paul-Seguin"
2023,"Union Berlin","Bundesliga","Tim Skarke","GER","DF,MF","25",1996,0.6,1,1,0,0,1,0,0,NA,0,1,0,1,0,1,0,0,"https://fbref.com/en/players/65857fdf/Tim-Skarke"
2023,"Union Berlin","Bundesliga","Morten Thorsby","NOR","MF","26",1996,9.3,22,10,9,11,2,13,21,61.9,8,11,5,6,3,25,20,0,"https://fbref.com/en/players/d1b49282/Morten-Thorsby"
2023,"Union Berlin","Bundesliga","Christopher Trimmel","AUT","DF","35",1987,20.1,31,16,16,12,3,20,31,64.5,11,14,1,13,25,56,48,0,"https://fbref.com/en/players/056d2d95/Christopher-Trimmel"
2023,"Valencia","La Liga","Domingos André Ribeiro Almeida","POR","MF","22",2000,28.2,66,42,23,32,11,26,57,45.6,31,26,0,26,20,86,16,1,"https://fbref.com/en/players/e6697917/Domingos-Andre-Ribeiro-Almeida"
2023,"Valencia","La Liga","Samu Castillejo","ESP","FW,MF","27",1995,15.1,21,12,8,9,4,8,40,20,32,21,2,19,9,30,2,0,"https://fbref.com/en/players/130a7a3f/Samu-Castillejo"
2023,"Valencia","La Liga","Edinson Cavani","URU","FW","35",1987,16.1,7,4,3,3,1,3,15,20,12,10,3,7,2,9,11,0,"https://fbref.com/en/players/527f063d/Edinson-Cavani"
2023,"Valencia","La Liga","Eray Cömert","SUI","DF","24",1998,18.6,35,23,24,10,1,17,33,51.5,16,23,8,15,29,64,76,1,"https://fbref.com/en/players/15937e17/Eray-Comert"
2023,"Valencia","La Liga","Thierry Correia","POR","DF","23",1999,22.3,71,52,46,22,3,31,54,57.4,23,25,2,23,24,95,54,2,"https://fbref.com/en/players/c78b352d/Thierry-Correia"
2023,"Valencia","La Liga","Mouctar Diakhaby","GUI","DF","25",1996,27.2,30,16,19,11,0,13,20,65,7,30,17,13,20,50,111,2,"https://fbref.com/en/players/d2110326/Mouctar-Diakhaby"
2023,"Valencia","La Liga","Hugo Duro","ESP","FW","22",1999,15.4,15,12,2,6,7,7,17,41.2,10,11,1,10,2,17,7,1,"https://fbref.com/en/players/37e103f8/Hugo-Duro"
2023,"Valencia","La Liga","Dimitri Foulquier","FRA","DF","29",1993,19.3,31,19,17,8,6,20,28,71.4,8,19,3,16,14,45,40,0,"https://fbref.com/en/players/45e17712/Dimitri-Foulquier"
2023,"Valencia","La Liga","Maxi Gómez","URU","FW","25",1996,1.2,0,0,0,0,0,0,0,NA,0,0,0,0,0,0,2,0,"https://fbref.com/en/players/4c2e9442/Maxi-Gomez"
2023,"Valencia","La Liga","Nicolás González","ESP","MF","20",2002,15.6,27,15,11,13,3,9,25,36,16,21,7,14,19,46,16,0,"https://fbref.com/en/players/2c56a792/Nicolas-Gonzalez"
2023,"Valencia","La Liga","Javier Guerra","ESP","MF","19",2003,6.7,16,13,7,4,5,9,20,45,11,8,1,7,11,27,9,0,"https://fbref.com/en/players/3828f130/Javier-Guerra"
2023,"Valencia","La Liga","Hugo Guillamón","ESP","MF","22",2000,18.1,20,12,10,8,2,8,24,33.3,16,14,2,12,19,39,30,2,"https://fbref.com/en/players/f7c12fbf/Hugo-Guillamon"
2023,"Valencia","La Liga","Justin Kluivert","NED","FW,MF","23",1999,16.1,17,14,7,4,6,6,12,50,6,4,0,4,7,24,4,0,"https://fbref.com/en/players/4c3a6744/Justin-Kluivert"
2023,"Valencia","La Liga","Toni Lato","ESP","DF,MF","24",1997,10.2,23,11,9,12,2,9,21,42.9,12,10,1,9,6,29,14,0,"https://fbref.com/en/players/8e088e04/Toni-Lato"
2023,"Valencia","La Liga","José Luis Gayà","ESP","DF","27",1995,30.1,80,46,61,16,3,43,74,58.1,31,28,9,19,23,103,48,0,"https://fbref.com/en/players/b05e2dbd/Jose-Luis-Gaya"
2023,"Valencia","La Liga","Giorgi Mamardashvili","GEO","GK","21",2000,38,0,0,0,0,0,0,0,NA,0,0,0,0,1,1,11,4,"https://fbref.com/en/players/d4b73232/Giorgi-Mamardashvili"
2023,"Valencia","La Liga","Maranhão","BRA","FW,MF","25",1996,5,4,1,1,1,2,1,2,50,1,4,1,3,0,4,0,0,"https://fbref.com/en/players/ae86d473/Maranhao"
2023,"Valencia","La Liga","Alberto Marí","ESP","FW,MF","21",2001,1,0,0,0,0,0,0,2,0,2,0,0,0,0,0,1,0,"https://fbref.com/en/players/44330c36/Alberto-Mari"
2023,"Valencia","La Liga","Ilaix Moriba","GUI","MF","19",2003,11.2,35,16,14,17,4,14,24,58.3,10,11,1,10,4,39,12,0,"https://fbref.com/en/players/f4c69aa6/Ilaix-Moriba"
2023,"Valencia","La Liga","Cristhian Mosquera","COL","DF","18",2004,1.6,4,2,3,1,0,4,5,80,1,1,0,1,1,5,5,0,"https://fbref.com/en/players/dc1ce4f5/Cristhian-Mosquera"
2023,"Valencia","La Liga","Yunus Musah","USA","MF","19",2002,23.4,48,35,17,23,8,20,30,66.7,10,20,1,19,11,59,16,2,"https://fbref.com/en/players/b51b1b9c/Yunus-Musah"
2023,"Valencia","La Liga","Diego Noguerol","ESP","FW,MF","20",2002,5,2,2,1,1,0,2,15,13.3,13,9,0,9,3,5,5,0,"https://fbref.com/en/players/c487901c/Diego-Noguerol"
2023,"Valencia","La Liga","Cenk Özkacar","TUR","DF","21",2000,15.2,27,20,17,10,0,14,19,73.7,5,14,2,12,12,39,47,4,"https://fbref.com/en/players/9a93efc9/Cenk-Ozkacar"
2023,"Valencia","La Liga","Gabriel Paulista","BRA","DF","31",1990,16.7,17,9,13,4,0,13,19,68.4,6,22,14,8,32,49,79,2,"https://fbref.com/en/players/b7ca5c51/Gabriel-Paulista"
2023,"Valencia","La Liga","Francisco Perez","ESP","FW,MF","19",2002,1.6,1,1,1,0,0,0,3,0,3,0,0,0,0,1,1,0,"https://fbref.com/en/players/3d79a68c/Francisco-Perez"
2023,"Valencia","La Liga","Samuel","BRA","FW,MF","22",1999,32.1,66,43,17,37,12,26,72,36.1,46,34,0,34,18,84,16,0,"https://fbref.com/en/players/2a295d33/Samuel"
2023,"Valencia","La Liga","Carlos Soler","ESP","MF","25",1997,2.7,2,0,0,1,1,2,3,66.7,1,1,0,1,0,2,2,0,"https://fbref.com/en/players/fed17f5a/Carlos-Soler"
2023,"Valencia","La Liga","Jesus Vazquez","ESP","DF,MF","19",2003,3.4,13,8,9,1,3,6,11,54.5,5,4,0,4,1,14,8,0,"https://fbref.com/en/players/106c142c/Jesus-Vazquez"
2023,"Valladolid","La Liga","Álvaro Aceves","ESP","GK","19",2003,0.1,0,0,0,0,0,0,0,NA,0,0,0,0,0,0,0,0,"https://fbref.com/en/players/be6faae0/Alvaro-Aceves"
2023,"Valladolid","La Liga","Álvaro Aguado","ESP","MF","26",1996,21,27,15,13,11,3,15,25,60,10,16,4,12,13,40,15,0,"https://fbref.com/en/players/014aa7bd/Alvaro-Aguado"
2023,"Valladolid","La Liga","Babatunde Akinsola","NGA","FW","19",2003,0.1,1,1,0,0,1,0,0,NA,0,0,0,0,0,1,0,0,"https://fbref.com/en/players/733aab44/Babatunde-Akinsola"
2023,"Valladolid","La Liga","Selim Amallah","MAR","MF,FW","25",1996,3,15,9,7,8,0,5,8,62.5,3,2,0,2,5,20,2,0,"https://fbref.com/en/players/00eba9c9/Selim-Amallah"
2023,"Valladolid","La Liga","Anuar","MAR","MF,FW","27",1995,2.3,4,4,0,1,3,0,0,NA,0,5,2,3,3,7,3,0,"https://fbref.com/en/players/c93231dc/Anuar"
2023,"Valladolid","La Liga","Roberto Arroyo","ESP","MF","18",2003,0.2,1,1,0,1,0,1,1,100,0,0,0,0,0,1,0,0,"https://fbref.com/en/players/6091cf45/Roberto-Arroyo"
2023,"Valladolid","La Liga","Sergio Asenjo","ESP","GK","33",1989,10,0,0,0,0,0,0,0,NA,0,0,0,0,0,0,10,2,"https://fbref.com/en/players/9f0ea33f/Sergio-Asenjo"
2023,"Valladolid","La Liga","Sergio Escudero","ESP","DF","32",1989,16,33,19,21,8,4,15,35,42.9,20,26,6,20,26,59,46,0,"https://fbref.com/en/players/b0616e3d/Sergio-Escudero"
2023,"Valladolid","La Liga","Zouhair Feddal","MAR","DF","33",1989,4.2,4,2,1,3,0,3,4,75,1,9,9,0,5,9,27,0,"https://fbref.com/en/players/89151b16/Zouhair-Feddal"
2023,"Valladolid","La Liga","Joaquín Fernández","ESP","DF","26",1996,24,35,28,20,11,4,19,30,63.3,11,31,22,9,27,62,98,1,"https://fbref.com/en/players/b86a64b2/Joaquin-Fernandez"
2023,"Valladolid","La Liga","Iván Fresneda","ESP","DF","17",2004,19.4,48,34,31,13,4,29,47,61.7,18,32,8,24,15,63,60,0,"https://fbref.com/en/players/29d0f2ac/Ivan-Fresneda"
2023,"Valladolid","La Liga","Sékou Gassama","SEN","FW","27",1995,0.4,0,0,0,0,0,0,0,NA,0,0,0,0,0,0,0,0,"https://fbref.com/en/players/475a738b/Sekou-Gassama"
2023,"Valladolid","La Liga","Sergi Guardiola","ESP","FW","31",1991,5.6,12,7,6,5,1,2,4,50,2,6,0,6,2,14,7,0,"https://fbref.com/en/players/32974271/Sergi-Guardiola"
2023,"Valladolid","La Liga","Martin Hongla","CMR","DF,MF","24",1998,14.5,18,13,13,5,0,11,21,52.4,10,15,12,3,8,26,46,1,"https://fbref.com/en/players/b85bf253/Martin-Hongla"
2023,"Valladolid","La Liga","Kenedy","BRA","FW,DF","26",1996,3.1,6,2,3,3,0,2,4,50,2,2,0,2,1,7,0,0,"https://fbref.com/en/players/5eebbfdf/Kenedy"
2023,"Valladolid","La Liga","Cyle Larin","CAN","FW","27",1995,16.3,9,3,2,4,3,3,7,42.9,4,6,3,3,0,9,15,0,"https://fbref.com/en/players/e7af9060/Cyle-Larin"
2023,"Valladolid","La Liga","Sergio León","ESP","FW","33",1989,14.8,6,4,0,4,2,3,6,50,3,6,0,6,0,6,4,0,"https://fbref.com/en/players/0a0cc13c/Sergio-Leon"
2023,"Valladolid","La Liga","Darwin Machís","VEN","FW","29",1993,6.7,3,2,0,2,1,1,8,12.5,7,5,0,5,3,6,4,0,"https://fbref.com/en/players/ed6ea4d9/Darwin-Machis"
2023,"Valladolid","La Liga","Mickael Malsa","MTQ","MF","26",1995,0.8,2,2,1,1,0,1,4,25,3,1,1,0,2,4,3,0,"https://fbref.com/en/players/bbc19252/Mickael-Malsa"
2023,"Valladolid","La Liga","Jordi Masip","ESP","GK","33",1989,27.9,0,0,0,0,0,0,2,0,2,0,0,0,1,1,3,2,"https://fbref.com/en/players/8fae77ea/Jordi-Masip"
2023,"Valladolid","La Liga","Roque Mesa","ESP","MF","33",1989,18,27,15,16,10,1,12,38,31.6,26,16,4,12,13,40,18,0,"https://fbref.com/en/players/7c4243d4/Roque-Mesa"
2023,"Valladolid","La Liga","Monchu","ESP","MF","22",1999,22.6,50,29,20,21,9,19,46,41.3,27,28,11,17,18,68,22,1,"https://fbref.com/en/players/8ac501f5/Monchu"
2023,"Valladolid","La Liga","Juanjo Narváez","COL","MF,FW","27",1995,1.6,1,1,1,0,0,1,1,100,0,2,0,2,0,1,0,0,"https://fbref.com/en/players/485e4939/Juanjo-Narvaez"
2023,"Valladolid","La Liga","Lucas Olaza","URU","DF","28",1994,16.6,24,14,12,10,2,17,26,65.4,9,20,8,12,14,38,34,0,"https://fbref.com/en/players/4cee5954/Lucas-Olaza"
2023,"Valladolid","La Liga","Lucas Oliveira Rosa","BRA","DF","22",2000,10.3,39,18,23,10,6,12,20,60,8,12,2,10,15,54,24,0,"https://fbref.com/en/players/5132b92c/Lucas-Oliveira-Rosa"
2023,"Valladolid","La Liga","Kike Pérez","ESP","MF","25",1997,25.6,67,33,30,32,5,25,68,36.8,43,26,7,19,20,87,28,0,"https://fbref.com/en/players/237a3851/Kike-Perez"
2023,"Valladolid","La Liga","Luis Pérez","ESP","DF","27",1995,13.5,44,24,26,12,6,27,38,71.1,11,13,4,9,16,60,29,0,"https://fbref.com/en/players/b7c04927/Luis-Perez"
2023,"Valladolid","La Liga","Óscar Plano","ESP","FW,MF","31",1991,22.6,40,25,9,17,14,12,37,32.4,25,26,2,24,29,69,23,0,"https://fbref.com/en/players/7c388b20/Oscar-Plano"
2023,"Valladolid","La Liga","Gonzalo Plata","ECU","FW","21",2000,25.6,66,35,31,24,11,23,70,32.9,47,40,0,40,12,78,10,1,"https://fbref.com/en/players/54bcdeb0/Gonzalo-Plata"
2023,"Valladolid","La Liga","Manuel Pozo","ESP","FW","20",2001,0.2,0,0,0,0,0,0,0,NA,0,2,0,2,2,2,0,0,"https://fbref.com/en/players/35440884/Manuel-Pozo"
2023,"Valladolid","La Liga","Iván Sánchez","ESP","MF,FW","29",1992,12.8,20,14,8,8,4,10,27,37,17,14,1,13,8,28,4,0,"https://fbref.com/en/players/70107d4d/Ivan-Sanchez"
2023,"Valladolid","La Liga","Javi Sánchez","ESP","DF","25",1997,26.6,43,26,27,15,1,17,26,65.4,9,32,22,10,46,89,116,0,"https://fbref.com/en/players/60359288/Javi-Sanchez"
2023,"Valladolid","La Liga","David Torres","ESP","DF","19",2003,4.3,1,1,0,1,0,1,1,100,0,4,2,2,3,4,8,0,"https://fbref.com/en/players/381dbcfc/David-Torres"
2023,"Valladolid","La Liga","Toni Villa","ESP","MF","27",1995,1,6,3,2,3,1,4,9,44.4,5,0,0,0,0,6,0,0,"https://fbref.com/en/players/636eae97/Toni-Villa"
2023,"Valladolid","La Liga","Shon Weissman","ISR","FW","26",1996,8.3,2,1,1,1,0,0,4,0,4,8,0,8,1,3,7,0,"https://fbref.com/en/players/379dc075/Shon-Weissman"
2023,"Valladolid","La Liga","Jawad El Yamiq","MAR","DF","30",1992,17.9,17,11,10,7,0,6,11,54.5,5,27,19,8,37,54,101,0,"https://fbref.com/en/players/f6f6b6e8/Jawad-El-Yamiq"
2023,"Villarreal","La Liga","Raúl Albiol","ESP","DF","36",1985,23.5,25,17,17,6,2,14,18,77.8,4,17,13,4,14,39,111,0,"https://fbref.com/en/players/4bd414c1/Raul-Albiol"
2023,"Villarreal","La Liga","Alex Baena","ESP","MF,FW","21",2001,21.6,30,17,9,15,6,15,45,33.3,30,15,3,12,7,37,16,0,"https://fbref.com/en/players/518f2234/Alex-Baena"
2023,"Villarreal","La Liga","Étienne Capoue","FRA","MF","34",1988,21.7,21,12,6,13,2,10,18,55.6,8,12,5,7,19,40,20,1,"https://fbref.com/en/players/5acc4a10/Etienne-Capoue"
2023,"Villarreal","La Liga","Samuel Chukwueze","NGA","FW,MF","23",1999,26,14,7,7,2,5,7,23,30.4,16,13,0,13,12,26,16,0,"https://fbref.com/en/players/b8a642fc/Samuel-Chukwueze"
2023,"Villarreal","La Liga","Diego Collado","ESP","FW","21",2001,0.1,0,0,0,0,0,0,0,NA,0,0,0,0,0,0,0,0,"https://fbref.com/en/players/b3f62bfc/Diego-Collado"
2023,"Villarreal","La Liga","Francis Coquelin","FRA","MF","31",1991,8.3,18,13,7,9,2,7,7,100,0,8,2,6,9,27,7,0,"https://fbref.com/en/players/a6951bf8/Francis-Coquelin"
2023,"Villarreal","La Liga","Jorge Cuenca","ESP","DF","22",1999,5.6,9,7,7,2,0,4,7,57.1,3,10,8,2,6,15,44,0,"https://fbref.com/en/players/0abc51f2/Jorge-Cuenca"
2023,"Villarreal","La Liga","Arnaut Danjuma","NED","FW","25",1997,5.3,3,3,1,0,2,1,2,50,1,0,0,0,0,3,1,1,"https://fbref.com/en/players/f08490a6/Arnaut-Danjuma"
2023,"Villarreal","La Liga","Alberto Del Moral","ESP","MF","22",2000,0.1,0,0,0,0,0,0,0,NA,0,0,0,0,0,0,0,0,"https://fbref.com/en/players/84a85b48/Alberto-Del-Moral"
2023,"Villarreal","La Liga","Mamadou Fall","SEN","DF","19",2002,0.3,0,0,0,0,0,0,0,NA,0,1,0,1,0,0,1,0,"https://fbref.com/en/players/805a2a11/Mamadou-Fall"
2023,"Villarreal","La Liga","Kiko Femenía","ESP","DF","31",1991,12.6,18,9,14,3,1,13,18,72.2,5,15,6,9,20,38,22,0,"https://fbref.com/en/players/e5d01ecf/Kiko-Femenia"
2023,"Villarreal","La Liga","Juan Foyth","ARG","DF","24",1998,21.8,73,48,49,22,2,41,57,71.9,16,32,11,21,20,93,68,0,"https://fbref.com/en/players/6c7762c3/Juan-Foyth"
2023,"Villarreal","La Liga","Haissem Hassan","FRA","FW,MF","20",2002,0.6,0,0,0,0,0,0,2,0,2,0,0,0,1,1,0,0,"https://fbref.com/en/players/e0979e74/Haissem-Hassan"
2023,"Villarreal","La Liga","Nicolas Jackson","SEN","FW","21",2001,17.8,14,11,2,10,2,2,8,25,6,18,2,16,2,16,4,0,"https://fbref.com/en/players/9c36ed83/Nicolas-Jackson"
2023,"Villarreal","La Liga","Filip Jørgensen","DEN","GK","20",2002,2,0,0,0,0,0,0,1,0,1,0,0,0,0,0,0,0,"https://fbref.com/en/players/0107757e/Filip-Jorgensen"
2023,"Villarreal","La Liga","Giovani Lo Celso","ARG","MF,FW","26",1996,12.5,32,28,7,15,10,12,21,57.1,9,14,2,12,6,38,5,0,"https://fbref.com/en/players/d7553721/Giovani-Lo-Celso"
2023,"Villarreal","La Liga","José Luis Morales","ESP","FW,MF","35",1987,13.5,7,6,1,2,4,5,17,29.4,12,12,1,11,2,9,2,0,"https://fbref.com/en/players/4a478107/Jose-Luis-Morales"
2023,"Villarreal","La Liga","Aïssa Mandi","ALG","DF","30",1991,16.2,18,10,14,3,1,6,12,50,6,19,14,5,21,39,58,0,"https://fbref.com/en/players/fbd6378b/Aissa-Mandi"
2023,"Villarreal","La Liga","Johan Mojica","COL","DF","29",1992,7.1,13,9,9,3,1,5,9,55.6,4,8,3,5,4,17,14,1,"https://fbref.com/en/players/608f2092/Johan-Mojica"
2023,"Villarreal","La Liga","Alberto Moreno","ESP","DF","30",1992,14.4,23,12,10,10,3,11,24,45.8,13,12,1,11,23,46,26,0,"https://fbref.com/en/players/11b9265b/Alberto-Moreno"
2023,"Villarreal","La Liga","Gerard Moreno","ESP","FW","30",1992,13.7,11,6,0,6,5,3,6,50,3,6,2,4,5,16,10,0,"https://fbref.com/en/players/81f0781e/Gerard-Moreno"
2023,"Villarreal","La Liga","Manu Morlanes","ESP","MF","23",1999,1.8,3,2,2,1,0,3,3,100,0,3,2,1,1,4,2,0,"https://fbref.com/en/players/a0255c67/Manu-Morlanes"
2023,"Villarreal","La Liga","Fernando Niño","ESP","MF,FW","21",2000,0.2,0,0,0,0,0,0,0,NA,0,0,0,0,0,0,0,0,"https://fbref.com/en/players/81d5c497/Fernando-Nino"
2023,"Villarreal","La Liga","Daniel Parejo","ESP","MF","33",1989,36.5,71,40,32,23,16,30,75,40,45,40,12,28,29,100,31,2,"https://fbref.com/en/players/7460ca0d/Daniel-Parejo"
2023,"Villarreal","La Liga","Pascu","ESP","DF,FW","19",2003,0.1,0,0,0,0,0,0,0,NA,0,0,0,0,0,0,0,0,"https://fbref.com/en/players/a2d9cf74/Pascu"
2023,"Villarreal","La Liga","Alfonso Pedraza","ESP","DF","26",1996,18.1,35,26,20,10,5,19,29,65.5,10,19,1,18,18,53,31,0,"https://fbref.com/en/players/63f04c6c/Alfonso-Pedraza"
2023,"Villarreal","La Liga","Yeremi Pino","ESP","FW,MF","19",2002,27.2,62,38,25,20,17,21,56,37.5,35,41,4,37,15,77,36,0,"https://fbref.com/en/players/540ec57b/Yeremi-Pino"
2023,"Villarreal","La Liga","Pepe Reina","ESP","GK","39",1982,22,0,0,0,0,0,0,1,0,1,0,0,0,1,1,4,4,"https://fbref.com/en/players/e358587b/Pepe-Reina"
2023,"Villarreal","La Liga","Gerónimo Rulli","ARG","GK","30",1992,14,0,0,0,0,0,0,0,NA,0,1,0,1,1,1,6,2,"https://fbref.com/en/players/625c144a/Geronimo-Rulli"
2023,"Villarreal","La Liga","Ramón Terrats","ESP","MF","21",2000,9.1,15,10,3,8,4,9,17,52.9,8,11,4,7,8,23,6,2,"https://fbref.com/en/players/f36016a5/Ramon-Terrats"
2023,"Villarreal","La Liga","Pau Torres","ESP","DF","25",1997,33.9,43,25,25,13,5,23,36,63.9,13,36,27,9,13,56,146,3,"https://fbref.com/en/players/532e1e4f/Pau-Torres"
2023,"Villarreal","La Liga","Manu Trigueros","ESP","MF","30",1991,9.2,20,14,9,5,6,9,22,40.9,13,9,2,7,5,25,4,0,"https://fbref.com/en/players/963829d0/Manu-Trigueros"
2023,"Werder Bremen","Bundesliga","Felix Agu","GER","DF,FW","22",1999,0.5,1,0,0,1,0,0,0,NA,0,1,1,0,0,1,0,0,"https://fbref.com/en/players/cb6d81b3/Felix-Agu"
2023,"Werder Bremen","Bundesliga","Leonardo Bittencourt","GER","MF,DF","28",1993,18.1,53,28,20,25,8,25,62,40.3,37,13,0,13,10,63,15,0,"https://fbref.com/en/players/dc62fbee/Leonardo-Bittencourt"
2023,"Werder Bremen","Bundesliga","Lee Buchanan","ENG","DF,FW","21",2001,5.2,14,10,2,11,1,6,12,50,6,5,0,5,12,26,21,0,"https://fbref.com/en/players/45e95f21/Lee-Buchanan"
2023,"Werder Bremen","Bundesliga","Oliver Burke","SCO","FW,MF","25",1997,3,1,0,0,0,1,0,0,NA,0,2,0,2,0,1,0,0,"https://fbref.com/en/players/f631c17f/Oliver-Burke"
2023,"Werder Bremen","Bundesliga","Fabio Chiarodia","ITA","DF","17",2005,0.7,0,0,0,0,0,0,0,NA,0,1,0,1,2,2,4,0,"https://fbref.com/en/players/48780156/Fabio-Chiarodia"
2023,"Werder Bremen","Bundesliga","Eren Dinkçi","GER","FW,MF","20",2001,2.6,5,5,2,1,2,2,6,33.3,4,2,0,2,0,5,2,0,"https://fbref.com/en/players/4ccd8957/Eren-Dinkci"
2023,"Werder Bremen","Bundesliga","Marvin Ducksch","GER","FW","28",1994,31.7,8,3,2,4,2,3,16,18.8,13,13,2,11,9,17,41,1,"https://fbref.com/en/players/638a4d71/Marvin-Ducksch"
2023,"Werder Bremen","Bundesliga","Marco Friedl","AUT","DF","24",1998,28.8,62,46,40,22,0,41,68,60.3,27,46,17,29,58,120,127,1,"https://fbref.com/en/players/f86ad3f5/Marco-Friedl"
2023,"Werder Bremen","Bundesliga","Niclas Füllkrug","GER","FW","29",1993,27.5,9,4,0,6,3,3,13,23.1,10,13,4,9,1,10,24,0,"https://fbref.com/en/players/4f16405e/Niclas-Fullkrug"
2023,"Werder Bremen","Bundesliga","Christian Groß","GER","MF","33",1989,21,56,25,20,34,2,29,60,48.3,31,20,5,15,23,79,38,1,"https://fbref.com/en/players/14a7af33/Christian-Gross"
2023,"Werder Bremen","Bundesliga","Ilia Gruev","BUL","MF","22",2000,17.6,44,27,16,25,3,18,31,58.1,13,23,6,17,22,66,21,1,"https://fbref.com/en/players/1fc4f3d1/Ilia-Gruev"
2023,"Werder Bremen","Bundesliga","Anthony Jung","GER","DF,FW","30",1991,29.1,46,27,19,20,7,31,58,53.4,27,30,6,24,22,68,63,0,"https://fbref.com/en/players/de838f86/Anthony-Jung"
2023,"Werder Bremen","Bundesliga","Jean-Manuel Mbom","GER","MF","22",2000,0.1,0,0,0,0,0,0,1,0,1,0,0,0,0,0,0,0,"https://fbref.com/en/players/1a5d7cb9/Jean-Manuel-Mbom"
2023,"Werder Bremen","Bundesliga","Jiří Pavlenka","CZE","GK","30",1992,32.3,1,0,1,0,0,1,5,20,4,1,0,1,3,4,21,1,"https://fbref.com/en/players/0a1cb833/Jiri-Pavlenka"
2023,"Werder Bremen","Bundesliga","Maximilian Philipp","GER","FW,MF","28",1994,4.9,6,5,3,2,1,1,9,11.1,8,7,1,6,3,9,4,0,"https://fbref.com/en/players/061e8e23/Maximilian-Philipp"
2023,"Werder Bremen","Bundesliga","Amos Pieper","GER","DF","24",1998,21.7,46,28,25,19,2,24,40,60,16,23,11,12,30,76,94,1,"https://fbref.com/en/players/526ea7cc/Amos-Pieper"
2023,"Werder Bremen","Bundesliga","Nicolai Rapp","GER","MF,DF","25",1996,0.8,3,1,3,0,0,0,3,0,3,0,0,0,0,3,1,0,"https://fbref.com/en/players/c8b3a472/Nicolai-Rapp"
2023,"Werder Bremen","Bundesliga","Dikeni Salifou","TOG","MF","19",2003,0,0,0,0,0,0,0,0,NA,0,0,0,0,0,0,0,0,"https://fbref.com/en/players/e1830c52/Dikeni-Salifou"
2023,"Werder Bremen","Bundesliga","Romano Schmid","AUT","MF,FW","22",2000,16.9,24,15,5,13,6,10,22,45.5,12,21,3,18,7,31,12,0,"https://fbref.com/en/players/220ace7e/Romano-Schmid"
2023,"Werder Bremen","Bundesliga","Niklas Schmidt","GER","MF","24",1998,12.1,25,10,12,11,2,13,28,46.4,15,10,0,10,5,30,12,0,"https://fbref.com/en/players/b9ae8560/Niklas-Schmidt"
2023,"Werder Bremen","Bundesliga","Jens Stage","DEN","MF","25",1996,20.6,34,17,15,18,1,10,37,27,27,34,11,23,16,50,37,0,"https://fbref.com/en/players/1fffae99/Jens-Stage"
2023,"Werder Bremen","Bundesliga","Niklas Stark","GER","DF","27",1995,23.1,56,36,29,24,3,27,42,64.3,15,24,13,11,37,93,110,0,"https://fbref.com/en/players/aad48be9/Niklas-Stark"
2023,"Werder Bremen","Bundesliga","Miloš Veljković","SRB","DF","26",1995,25.2,30,19,17,13,0,18,29,62.1,11,32,16,16,33,63,103,0,"https://fbref.com/en/players/a5ae8f8e/Milos-Veljkovic"
2023,"Werder Bremen","Bundesliga","Mitchell Weiser","GER","DF,FW","28",1994,28,71,43,38,24,9,38,75,50.7,37,50,7,43,28,99,38,1,"https://fbref.com/en/players/30c220c3/Mitchell-Weiser"
2023,"Werder Bremen","Bundesliga","Michael Zetterer","GER","GK","27",1995,1.7,0,0,0,0,0,0,0,NA,0,0,0,0,0,0,1,0,"https://fbref.com/en/players/9b688ae1/Michael-Zetterer"
2023,"West Ham","Premier League","Nayef Aguerd","MAR","DF","26",1996,17.7,27,18,18,8,1,13,20,65,7,26,24,2,18,45,79,2,"https://fbref.com/en/players/288e1e13/Nayef-Aguerd"
2023,"West Ham","Premier League","Michail Antonio","JAM","FW","32",1990,20.3,14,7,1,8,5,3,12,25,9,13,5,8,5,19,9,0,"https://fbref.com/en/players/ac05f970/Michail-Antonio"
2023,"West Ham","Premier League","Alphonse Areola","FRA","GK","29",1993,3.4,0,0,0,0,0,0,0,NA,0,0,0,0,0,0,0,0,"https://fbref.com/en/players/2f965a72/Alphonse-Areola"
2023,"West Ham","Premier League","Saïd Benrahma","ALG","FW,MF","26",1995,23,25,15,11,7,7,11,27,40.7,16,23,1,22,9,34,13,0,"https://fbref.com/en/players/5a04fd92/Said-Benrahma"
2023,"West Ham","Premier League","Jarrod Bowen","ENG","FW,MF","25",1996,35.9,39,16,14,11,14,16,57,28.1,41,47,9,38,36,75,25,0,"https://fbref.com/en/players/79c84d1c/Jarrod-Bowen"
2023,"West Ham","Premier League","Maxwel Cornet","CIV","FW","25",1996,2.7,7,3,5,0,2,4,6,66.7,2,6,0,6,2,9,3,0,"https://fbref.com/en/players/beb391dd/Maxwel-Cornet"
2023,"West Ham","Premier League","Vladimír Coufal","CZE","DF","29",1992,23.7,58,31,37,15,6,36,51,70.6,15,24,6,18,38,96,70,0,"https://fbref.com/en/players/fdf3cb77/Vladimir-Coufal"
2023,"West Ham","Premier League","Conor Coventry","IRL","MF,FW","22",2000,0,0,0,0,0,0,0,0,NA,0,0,0,0,0,0,0,0,"https://fbref.com/en/players/a5ca9127/Conor-Coventry"
2023,"West Ham","Premier League","Aaron Cresswell","ENG","DF","32",1989,24.8,21,11,12,7,2,12,31,38.7,19,21,11,10,27,48,56,0,"https://fbref.com/en/players/4f974391/Aaron-Cresswell"
2023,"West Ham","Premier League","Craig Dawson","ENG","DF","32",1990,8,10,6,8,2,0,4,6,66.7,2,9,6,3,6,16,26,0,"https://fbref.com/en/players/3e9e06cb/Craig-Dawson"
2023,"West Ham","Premier League","Flynn Downes","ENG","MF","23",1999,8.5,16,9,4,10,2,6,12,50,6,15,2,13,7,23,6,0,"https://fbref.com/en/players/69fdb896/Flynn-Downes"
2023,"West Ham","Premier League","Łukasz Fabiański","POL","GK","37",1985,34.6,2,0,2,0,0,1,2,50,1,1,0,1,0,2,10,1,"https://fbref.com/en/players/9328b835/Lukasz-Fabianski"
2023,"West Ham","Premier League","Pablo Fornals","ESP","FW,MF","26",1996,16.7,30,15,9,12,9,13,34,38.2,21,16,2,14,14,44,9,0,"https://fbref.com/en/players/82927de4/Pablo-Fornals"
2023,"West Ham","Premier League","Danny Ings","ENG","FW","30",1992,8.6,9,8,0,4,5,5,14,35.7,9,8,2,6,3,12,5,0,"https://fbref.com/en/players/07802f7f/Danny-Ings"
2023,"West Ham","Premier League","Ben Johnson","ENG","DF","22",2000,9.6,20,14,12,4,4,12,18,66.7,6,12,4,8,9,29,28,1,"https://fbref.com/en/players/9319781b/Ben-Johnson"
2023,"West Ham","Premier League","Thilo Kehrer","GER","DF","25",1996,24.8,43,24,25,14,4,21,44,47.7,23,16,6,10,34,77,76,1,"https://fbref.com/en/players/51dbeea9/Thilo-Kehrer"
2023,"West Ham","Premier League","Manuel Lanzini","ARG","MF,FW","29",1993,2.8,2,2,1,1,0,2,6,33.3,4,2,0,2,2,4,0,0,"https://fbref.com/en/players/26f6dca8/Manuel-Lanzini"
2023,"West Ham","Premier League","Divin Mubama","ENG","FW","17",2004,0.4,1,1,1,0,0,0,0,NA,0,0,0,0,0,1,0,0,"https://fbref.com/en/players/92868cb5/Divin-Mubama"
2023,"West Ham","Premier League","Angelo Ogbonna","ITA","DF","34",1988,13.7,11,4,7,4,0,5,10,50,5,11,7,4,17,28,74,1,"https://fbref.com/en/players/74b2cd7e/Angelo-Ogbonna"
2023,"West Ham","Premier League","Emerson Palmieri","ITA","DF","27",1994,14.7,26,14,9,15,2,12,24,50,12,17,4,13,15,41,36,0,"https://fbref.com/en/players/e0bc6fdc/Emerson-Palmieri"
2023,"West Ham","Premier League","Lucas Paquetá","BRA","MF","24",1997,23.9,71,53,23,36,12,27,66,40.9,39,41,4,37,16,87,31,0,"https://fbref.com/en/players/9b6f7fd5/Lucas-Paqueta"
2023,"West Ham","Premier League","Declan Rice","ENG","MF","23",1999,36.4,79,38,44,31,4,31,50,62,19,45,15,30,63,142,58,0,"https://fbref.com/en/players/1c7012b8/Declan-Rice"
2023,"West Ham","Premier League","Gianluca Scamacca","ITA","FW","23",1999,10.3,10,5,1,3,6,2,2,100,0,3,0,3,4,14,5,0,"https://fbref.com/en/players/8790f988/Gianluca-Scamacca"
2023,"West Ham","Premier League","Tomáš Souček","CZE","MF","27",1995,31.3,77,37,41,29,7,28,58,48.3,30,42,17,25,53,130,71,3,"https://fbref.com/en/players/6613c819/Tomas-Soucek"
2023,"West Ham","Premier League","Kurt Zouma","FRA","DF","27",1994,22.1,9,4,4,5,0,5,8,62.5,3,17,14,3,30,39,120,1,"https://fbref.com/en/players/ce4246f5/Kurt-Zouma"
2023,"Wolfsburg","Bundesliga","Lukáš Ambros","CZE","MF","18",2004,0.2,1,0,1,0,0,1,4,25,3,1,0,1,0,1,2,1,"https://fbref.com/en/players/cd682b6b/Lukas-Ambros"
2023,"Wolfsburg","Bundesliga","Maximilian Arnold","GER","MF","28",1994,30.7,62,31,25,28,9,28,54,51.9,26,34,11,23,26,88,65,2,"https://fbref.com/en/players/86e119e0/Maximilian-Arnold"
2023,"Wolfsburg","Bundesliga","Ridle Baku","GER","DF,FW","24",1998,28.7,50,26,29,17,4,32,58,55.2,26,44,6,38,21,71,59,0,"https://fbref.com/en/players/442b56fa/Ridle-Baku"
2023,"Wolfsburg","Bundesliga","Sebastiaan Bornauw","BEL","DF","23",1999,21.4,29,17,17,10,2,16,22,72.7,6,27,12,15,31,60,83,1,"https://fbref.com/en/players/01834aa0/Sebastiaan-Bornauw"
2023,"Wolfsburg","Bundesliga","Josip Brekalo","CRO","MF,FW","24",1998,3,2,1,2,0,0,0,4,0,4,0,0,0,2,4,2,0,"https://fbref.com/en/players/d4a2533d/Josip-Brekalo"
2023,"Wolfsburg","Bundesliga","Koen Casteels","BEL","GK","30",1992,34,0,0,0,0,0,0,0,NA,0,0,0,0,1,1,10,1,"https://fbref.com/en/players/db401046/Koen-Casteels"
2023,"Wolfsburg","Bundesliga","Nicolas Cozza","FRA","DF","23",1999,1.1,3,3,1,2,0,2,3,66.7,1,3,1,2,0,3,0,0,"https://fbref.com/en/players/8f325097/Nicolas-Cozza"
2023,"Wolfsburg","Bundesliga","Kilian Fischer","GER","DF,FW","21",2000,5.6,9,6,3,4,2,6,11,54.5,5,6,0,6,5,14,18,0,"https://fbref.com/en/players/79f7302a/Kilian-Fischer"
2023,"Wolfsburg","Bundesliga","Bartol Franjić","CRO","MF","22",2000,2.5,4,2,2,2,0,0,2,0,2,4,1,3,5,9,4,0,"https://fbref.com/en/players/697dc00a/Bartol-Franjic"
2023,"Wolfsburg","Bundesliga","Yannick Gerhardt","GER","MF","28",1994,20.7,29,15,10,11,8,12,30,40,18,26,5,21,7,36,24,0,"https://fbref.com/en/players/62ab9184/Yannick-Gerhardt"
2023,"Wolfsburg","Bundesliga","Josuha Guilavogui","FRA","DF,MF","31",1990,13.1,18,11,7,10,1,6,17,35.3,11,19,13,6,23,41,52,0,"https://fbref.com/en/players/e6c43eec/Josuha-Guilavogui"
2023,"Wolfsburg","Bundesliga","Jakub Kamiński","POL","FW,DF","20",2002,22.9,36,25,15,13,8,20,40,50,20,37,2,35,8,44,15,0,"https://fbref.com/en/players/202b3b68/Jakub-Kaminski"
2023,"Wolfsburg","Bundesliga","Max Kruse","GER","MF,FW","34",1988,3,1,1,0,1,0,0,1,0,1,2,1,1,0,1,1,0,"https://fbref.com/en/players/f9446dcd/Max-Kruse"
2023,"Wolfsburg","Bundesliga","Maxence Lacroix","FRA","DF","22",2000,18.1,22,13,15,7,0,8,16,50,8,22,11,11,26,48,85,0,"https://fbref.com/en/players/277c49ed/Maxence-Lacroix"
2023,"Wolfsburg","Bundesliga","Omar Marmoush","EGY","FW","23",1999,16.4,16,10,8,2,6,4,16,25,12,21,1,20,7,23,4,0,"https://fbref.com/en/players/0e0102eb/Omar-Marmoush"
2023,"Wolfsburg","Bundesliga","Felix Nmecha","GER","MF","21",2000,20.4,41,24,11,23,7,16,34,47.1,18,26,10,16,25,66,31,0,"https://fbref.com/en/players/091c86e2/Felix-Nmecha"
2023,"Wolfsburg","Bundesliga","Lukas Nmecha","GER","FW","23",1998,10,5,3,0,2,3,3,3,100,0,5,1,4,3,8,4,0,"https://fbref.com/en/players/0cc5f4a5/Lukas-Nmecha"
2023,"Wolfsburg","Bundesliga","Paulo Otávio","BRA","DF","27",1994,22.7,72,46,46,17,9,44,66,66.7,22,42,6,36,30,102,70,1,"https://fbref.com/en/players/1cbe4984/Paulo-Otavio"
2023,"Wolfsburg","Bundesliga","Kevin Paredes","USA","FW,MF","19",2003,5.9,13,9,6,3,4,9,12,75,3,7,0,7,6,19,8,0,"https://fbref.com/en/players/5c50fdbc/Kevin-Paredes"
2023,"Wolfsburg","Bundesliga","Dženan Pejčinović","GER","FW","17",2005,0.1,0,0,0,0,0,0,0,NA,0,0,0,0,0,0,0,0,"https://fbref.com/en/players/80f252f6/Dzenan-Pejcinovic"
2023,"Wolfsburg","Bundesliga","Maximilian Philipp","GER","FW","28",1994,1.3,2,1,1,1,0,1,1,100,0,1,0,1,0,2,0,0,"https://fbref.com/en/players/061e8e23/Maximilian-Philipp"
2023,"Wolfsburg","Bundesliga","Jérôme Roussillon","FRA","MF,DF","29",1993,0.2,0,0,0,0,0,0,0,NA,0,0,0,0,0,0,0,0,"https://fbref.com/en/players/13203c45/Jerome-Roussillon"
2023,"Wolfsburg","Bundesliga","Mattias Svanberg","SWE","MF,FW","23",1999,20.4,25,16,8,16,1,10,30,33.3,20,27,5,22,21,46,25,1,"https://fbref.com/en/players/92d83c27/Mattias-Svanberg"
2023,"Wolfsburg","Bundesliga","Micky van de Ven","NED","DF","21",2001,33,45,30,26,18,1,28,39,71.8,11,42,24,18,26,71,108,2,"https://fbref.com/en/players/8fe2a392/Micky-van-de-Ven"
2023,"Wolfsburg","Bundesliga","Aster Vranckx","BEL","MF","19",2002,0.1,0,0,0,0,0,0,0,NA,0,0,0,0,0,0,1,0,"https://fbref.com/en/players/f86cd5df/Aster-Vranckx"
2023,"Wolfsburg","Bundesliga","Luca Waldschmidt","GER","FW,MF","26",1996,5.8,5,2,2,1,2,2,10,20,8,6,0,6,3,8,5,0,"https://fbref.com/en/players/e5a35ae9/Luca-Waldschmidt"
2023,"Wolfsburg","Bundesliga","Patrick Wimmer","AUT","FW,MF","21",2001,18.3,39,26,18,11,10,12,38,31.6,26,27,2,25,15,54,15,0,"https://fbref.com/en/players/cb11b429/Patrick-Wimmer"
2023,"Wolfsburg","Bundesliga","Jonas Wind","DEN","FW","23",1999,14.3,14,6,2,7,5,5,10,50,5,14,4,10,1,15,10,0,"https://fbref.com/en/players/2077ae86/Jonas-Wind"
2023,"Wolves","Premier League","Rayan Aït Nouri","ALG","DF","21",2001,12,33,20,25,7,1,9,15,60,6,3,0,3,9,42,28,0,"https://fbref.com/en/players/9b398aea/Rayan-Ait-Nouri"
2023,"Wolves","Premier League","Daniel Bentley","ENG","GK","29",1993,2,1,1,1,0,0,1,1,100,0,0,0,0,0,1,0,0,"https://fbref.com/en/players/68db6358/Daniel-Bentley"
2023,"Wolves","Premier League","Hugo Bueno","ESP","DF","19",2002,14.6,33,16,23,6,4,17,33,51.5,16,14,1,13,10,43,36,0,"https://fbref.com/en/players/bfc3b3a0/Hugo-Bueno"
2023,"Wolves","Premier League","Chem Campbell","WAL","FW,MF","19",2002,0.8,2,1,1,1,0,0,1,0,1,2,0,2,1,3,0,0,"https://fbref.com/en/players/6f711f67/Chem-Campbell"
2023,"Wolves","Premier League","Jonny Castro","ESP","DF","28",1994,14,34,15,23,10,1,18,37,48.6,19,26,5,21,14,48,28,2,"https://fbref.com/en/players/e28868f3/Jonny-Castro"
2023,"Wolves","Premier League","Nathan Collins","IRL","DF","21",2001,20.2,27,15,19,8,0,15,24,62.5,9,35,28,7,21,48,84,0,"https://fbref.com/en/players/a8c19eb8/Nathan-Collins"
2023,"Wolves","Premier League","Diego Costa","ESP","FW","33",1988,13.8,3,1,3,0,0,2,9,22.2,7,6,1,5,2,5,17,0,"https://fbref.com/en/players/a190d597/Diego-Costa"
2023,"Wolves","Premier League","Matheus Cunha","BRA","FW","23",1999,10.7,7,4,0,5,2,2,10,20,8,15,3,12,9,16,11,0,"https://fbref.com/en/players/dc62b55d/Matheus-Cunha"
2023,"Wolves","Premier League","Craig Dawson","ENG","DF","32",1990,15.7,9,6,6,3,0,4,7,57.1,3,31,23,8,12,21,74,2,"https://fbref.com/en/players/3e9e06cb/Craig-Dawson"
2023,"Wolves","Premier League","Leander Dendoncker","BEL","MF","27",1995,2.4,4,2,0,3,1,2,3,66.7,1,2,0,2,9,13,4,0,"https://fbref.com/en/players/5a7301ae/Leander-Dendoncker"
2023,"Wolves","Premier League","Morgan Gibbs-White","ENG","FW,MF","22",2000,2,3,1,3,0,0,2,3,66.7,1,2,0,2,1,4,3,0,"https://fbref.com/en/players/32f60ed8/Morgan-Gibbs-White"
2023,"Wolves","Premier League","João Gomes","BRA","MF","21",2001,7.3,29,13,14,14,1,13,23,56.5,10,12,3,9,4,33,11,0,"https://fbref.com/en/players/8b57ad2c/Joao-Gomes"
2023,"Wolves","Premier League","Toti Gomes","POR","DF","23",1999,10.9,15,9,11,4,0,9,13,69.2,4,16,8,8,11,26,51,0,"https://fbref.com/en/players/f0caab96/Toti-Gomes"
2023,"Wolves","Premier League","Gonçalo Guedes","POR","FW,MF","25",1996,7.9,8,6,4,3,1,5,8,62.5,3,4,0,4,1,9,2,0,"https://fbref.com/en/players/e6bc67d7/Goncalo-Guedes"
2023,"Wolves","Premier League","Hwang Hee-chan","KOR","FW,MF","26",1996,12.6,20,9,7,8,5,6,19,31.6,13,18,2,16,5,25,5,0,"https://fbref.com/en/players/169fd162/Hwang-Hee-chan"
2023,"Wolves","Premier League","Joseph Hodge","IRL","MF","19",2002,1.9,5,2,1,3,1,3,4,75,1,5,0,5,0,5,2,1,"https://fbref.com/en/players/bd8a5d95/Joseph-Hodge"
2023,"Wolves","Premier League","Raúl Jiménez","MEX","FW","31",1991,9.4,9,6,3,5,1,3,6,50,3,9,0,9,0,9,8,0,"https://fbref.com/en/players/b561db50/Raul-Jimenez"
2023,"Wolves","Premier League","Sasa Kalajdzic","AUT","FW","25",1997,0.5,0,0,0,0,0,0,0,NA,0,0,0,0,1,1,0,0,"https://fbref.com/en/players/15f24fe7/Sasa-Kalajdzic"
2023,"Wolves","Premier League","Max Kilman","ENG","DF","25",1997,36.7,36,20,26,9,1,16,30,53.3,14,70,42,28,19,55,164,1,"https://fbref.com/en/players/d0f72bf1/Max-Kilman"
2023,"Wolves","Premier League","Dexter Lembikisa","JAM","DF","18",2003,0.3,0,0,0,0,0,0,0,NA,0,0,0,0,0,0,0,0,"https://fbref.com/en/players/0bdda685/Dexter-Lembikisa"
2023,"Wolves","Premier League","Mario Lemina","GAB","MF","28",1993,14.4,38,24,22,13,3,20,38,52.6,18,26,8,18,14,52,24,1,"https://fbref.com/en/players/2b471f99/Mario-Lemina"
2023,"Wolves","Premier League","João Moutinho","POR","MF","35",1986,19.8,51,30,24,21,6,19,46,41.3,27,22,6,16,18,69,20,0,"https://fbref.com/en/players/f5a00fa4/Joao-Moutinho"
2023,"Wolves","Premier League","Pedro Neto","POR","FW,MF","22",2000,10.7,11,6,4,2,5,7,17,41.2,10,5,1,4,4,15,4,0,"https://fbref.com/en/players/7ba2eaa9/Pedro-Neto"
2023,"Wolves","Premier League","Rúben Neves","POR","MF","25",1997,33.5,79,43,31,33,15,32,74,43.2,42,59,22,37,50,129,85,1,"https://fbref.com/en/players/44bfb6c5/Ruben-Neves"
2023,"Wolves","Premier League","Matheus Nunes","POR","MF","23",1998,27.4,67,43,36,22,9,28,61,45.9,33,35,4,31,16,83,35,2,"https://fbref.com/en/players/e6af02e0/Matheus-Nunes"
2023,"Wolves","Premier League","Daniel Podence","POR","FW,MF","26",1995,19.7,27,17,13,9,5,6,31,19.4,25,19,0,19,7,34,6,0,"https://fbref.com/en/players/7fcc71d8/Daniel-Podence"
2023,"Wolves","Premier League","Connor Ronan","IRL","MF","24",1998,0,0,0,0,0,0,0,0,NA,0,0,0,0,0,0,0,0,"https://fbref.com/en/players/1b804500/Connor-Ronan"
2023,"Wolves","Premier League","José Sá","POR","GK","29",1993,36,1,0,1,0,0,1,1,100,0,0,0,0,0,1,10,6,"https://fbref.com/en/players/903b6e8b/Jose-Sa"
2023,"Wolves","Premier League","Pablo Sarabia","ESP","FW,MF","30",1992,8.5,12,6,4,5,3,6,15,40,9,7,0,7,2,14,4,0,"https://fbref.com/en/players/9744ff80/Pablo-Sarabia"
2023,"Wolves","Premier League","Nélson Semedo","POR","DF","28",1993,29.2,71,42,48,19,4,33,64,51.6,31,42,15,27,29,100,83,2,"https://fbref.com/en/players/d04b94db/Nelson-Semedo"
2023,"Wolves","Premier League","Adama Traoré","ESP","FW,MF","26",1996,16.6,14,7,7,4,3,4,9,44.4,5,8,1,7,3,17,17,0,"https://fbref.com/en/players/9a28eba4/Adama-Traore"
2023,"Wolves","Premier League","Boubacar Traoré","MLI","MF","20",2001,4.6,12,5,4,5,3,3,7,42.9,4,4,2,2,7,19,1,0,"https://fbref.com/en/players/999ceb5f/Boubacar-Traore"
